InventoryId,ScheduleId,CarrierCode,Dep_Key,FlightNumber,AircraftType,DepartureDate,DepartureDateTime,ArrivalDateTime,DepartureAirport,ArrivalAirport,TotalCapacity,TotalInventory,BookedInventory,Oversold,AvailableInventory,FirstClass,BusinessClass,PremiumEconomyClass,EconomyClass,FC_TotalInventory,FC_BookedInventory,FC_Oversold,FC_AvailableInventory,BC_TotalInventory,BC_BookedInventory,BC_Oversold,BC_AvailableInventory,PC_TotalInventory,PC_BookedInventory,PC_Oversold,PC_AvailableInventory,EC_TotalInventory,EC_BookedInventory,EC_Oversold,EC_AvailableInventory,FC_CD,BC_CD,PC_CD,EC_CD
INV-ZZ-2774494,SCH-ZZ-3400127,ZZ,ZZ20240505AMDHYD2223.0,2223.0,Boeing 777,05/05/2024,2024-05-05 10:52:00,2024-05-05 19:30:00,AMD,HYD,425.0,491,251,-174,240,42,85,127,170,46,24,18,22,100,51,34,49,152,78,49,74,199,102,68,97,"{'F': 25, 'P': 17}","{'C': 34, 'J': 26, 'Z': 26}","{'Q': 38, 'R': 25, 'S': 13, 'T': 13, 'H': 25, 'M': 13}","{'Y': 13, 'A': 13, 'B': 6, 'D': 6, 'E': 6, 'G': 13, 'I': 6, 'K': 13, 'L': 6, 'N': 6, 'O': 6, 'U': 13, 'V': 6, 'W': 6, 'X': 6}"
INV-ZZ-8029879,SCH-ZZ-3400127,ZZ,ZZ20240506AMDHYD2223.0,2223.0,Boeing 777,05/06/2024,2024-05-06 10:52:00,2024-05-06 19:30:00,AMD,HYD,425.0,506,266,-159,240,42,85,127,170,46,24,18,22,96,50,35,46,152,80,47,72,202,106,64,96,"{'F': 25, 'P': 17}","{'C': 34, 'J': 26, 'Z': 26}","{'Q': 38, 'R': 25, 'S': 13, 'T': 13, 'H': 25, 'M': 13}","{'Y': 13, 'A': 13, 'B': 6, 'D': 6, 'E': 6, 'G': 13, 'I': 6, 'K': 13, 'L': 6, 'N': 6, 'O': 6, 'U': 13, 'V': 6, 'W': 6, 'X': 6}"
INV-ZZ-6852033,SCH-ZZ-3400127,ZZ,ZZ20240507AMDHYD2223.0,2223.0,Boeing 777,05/07/2024,2024-05-07 10:52:00,2024-05-07 19:30:00,AMD,HYD,425.0,479,277,-148,202,42,85,127,170,49,28,14,21,94,54,31,40,144,83,44,61,197,114,56,83,"{'F': 25, 'P': 17}","{'C': 34, 'J': 26, 'Z': 26}","{'Q': 38, 'R': 25, 'S': 13, 'T': 13, 'H': 25, 'M': 13}","{'Y': 13, 'A': 13, 'B': 6, 'D': 6, 'E': 6, 'G': 13, 'I': 6, 'K': 13, 'L': 6, 'N': 6, 'O': 6, 'U': 13, 'V': 6, 'W': 6, 'X': 6}"
INV-ZZ-7065859,SCH-ZZ-3400127,ZZ,ZZ20240508AMDHYD2223.0,2223.0,Boeing 777,05/08/2024,2024-05-08 10:52:00,2024-05-08 19:30:00,AMD,HYD,425.0,476,254,-171,222,42,85,127,170,49,26,16,23,95,51,34,44,142,76,51,66,192,103,67,89,"{'F': 25, 'P': 17}","{'C': 34, 'J': 26, 'Z': 26}","{'Q': 38, 'R': 25, 'S': 13, 'T': 13, 'H': 25, 'M': 13}","{'Y': 13, 'A': 13, 'B': 6, 'D': 6, 'E': 6, 'G': 13, 'I': 6, 'K': 13, 'L': 6, 'N': 6, 'O': 6, 'U': 13, 'V': 6, 'W': 6, 'X': 6}"
INV-ZZ-1595392,SCH-ZZ-3400127,ZZ,ZZ20240512AMDHYD2223.0,2223.0,Boeing 777,05/12/2024,2024-05-12 10:52:00,2024-05-12 19:30:00,AMD,HYD,425.0,485,264,-161,221,42,85,127,170,48,26,16,22,98,53,32,45,145,79,48,66,197,107,63,90,"{'F': 25, 'P': 17}","{'C': 34, 'J': 26, 'Z': 26}","{'Q': 38, 'R': 25, 'S': 13, 'T': 13, 'H': 25, 'M': 13}","{'Y': 13, 'A': 13, 'B': 6, 'D': 6, 'E': 6, 'G': 13, 'I': 6, 'K': 13, 'L': 6, 'N': 6, 'O': 6, 'U': 13, 'V': 6, 'W': 6, 'X': 6}"
INV-ZZ-2946425,SCH-ZZ-3400127,ZZ,ZZ20240513AMDHYD2223.0,2223.0,Boeing 777,05/13/2024,2024-05-13 10:52:00,2024-05-13 19:30:00,AMD,HYD,425.0,503,253,-172,250,42,85,127,170,47,24,18,23,95,48,37,47,148,75,52,73,187,94,76,93,"{'F': 25, 'P': 17}","{'C': 34, 'J': 26, 'Z': 26}","{'Q': 38, 'R': 25, 'S': 13, 'T': 13, 'H': 25, 'M': 13}","{'Y': 13, 'A': 13, 'B': 6, 'D': 6, 'E': 6, 'G': 13, 'I': 6, 'K': 13, 'L': 6, 'N': 6, 'O': 6, 'U': 13, 'V': 6, 'W': 6, 'X': 6}"
INV-ZZ-4457881,SCH-ZZ-3400127,ZZ,ZZ20240514AMDHYD2223.0,2223.0,Boeing 777,05/14/2024,2024-05-14 10:52:00,2024-05-14 19:30:00,AMD,HYD,425.0,491,278,-147,213,42,85,127,170,50,28,14,22,99,56,29,43,152,86,41,66,188,107,63,81,"{'F': 25, 'P': 17}","{'C': 34, 'J': 26, 'Z': 26}","{'Q': 38, 'R': 25, 'S': 13, 'T': 13, 'H': 25, 'M': 13}","{'Y': 13, 'A': 13, 'B': 6, 'D': 6, 'E': 6, 'G': 13, 'I': 6, 'K': 13, 'L': 6, 'N': 6, 'O': 6, 'U': 13, 'V': 6, 'W': 6, 'X': 6}"
INV-ZZ-4268320,SCH-ZZ-3400127,ZZ,ZZ20240515AMDHYD2223.0,2223.0,Boeing 777,05/15/2024,2024-05-15 10:52:00,2024-05-15 19:30:00,AMD,HYD,425.0,508,269,-156,239,42,85,127,170,49,26,16,23,98,52,33,46,140,74,53,66,198,105,65,93,"{'F': 25, 'P': 17}","{'C': 34, 'J': 26, 'Z': 26}","{'Q': 38, 'R': 25, 'S': 13, 'T': 13, 'H': 25, 'M': 13}","{'Y': 13, 'A': 13, 'B': 6, 'D': 6, 'E': 6, 'G': 13, 'I': 6, 'K': 13, 'L': 6, 'N': 6, 'O': 6, 'U': 13, 'V': 6, 'W': 6, 'X': 6}"
INV-ZZ-8140596,SCH-ZZ-3400127,ZZ,ZZ20240519AMDHYD2223.0,2223.0,Boeing 777,05/19/2024,2024-05-19 10:52:00,2024-05-19 19:30:00,AMD,HYD,425.0,473,236,-189,237,42,85,127,170,49,24,18,25,98,49,36,49,150,75,52,75,188,94,76,94,"{'F': 25, 'P': 17}","{'C': 34, 'J': 26, 'Z': 26}","{'Q': 38, 'R': 25, 'S': 13, 'T': 13, 'H': 25, 'M': 13}","{'Y': 13, 'A': 13, 'B': 6, 'D': 6, 'E': 6, 'G': 13, 'I': 6, 'K': 13, 'L': 6, 'N': 6, 'O': 6, 'U': 13, 'V': 6, 'W': 6, 'X': 6}"
INV-ZZ-1617071,SCH-ZZ-3400127,ZZ,ZZ20240520AMDHYD2223.0,2223.0,Boeing 777,05/20/2024,2024-05-20 10:52:00,2024-05-20 19:30:00,AMD,HYD,425.0,501,253,-172,248,42,85,127,170,47,24,18,23,99,50,35,49,140,71,56,69,201,101,69,100,"{'F': 25, 'P': 17}","{'C': 34, 'J': 26, 'Z': 26}","{'Q': 38, 'R': 25, 'S': 13, 'T': 13, 'H': 25, 'M': 13}","{'Y': 13, 'A': 13, 'B': 6, 'D': 6, 'E': 6, 'G': 13, 'I': 6, 'K': 13, 'L': 6, 'N': 6, 'O': 6, 'U': 13, 'V': 6, 'W': 6, 'X': 6}"
INV-ZZ-4593004,SCH-ZZ-3400127,ZZ,ZZ20240521AMDHYD2223.0,2223.0,Boeing 777,05/21/2024,2024-05-21 10:52:00,2024-05-21 19:30:00,AMD,HYD,425.0,500,254,-171,246,42,85,127,170,47,24,18,23,99,50,35,49,149,76,51,73,199,101,69,98,"{'F': 25, 'P': 17}","{'C': 34, 'J': 26, 'Z': 26}","{'Q': 38, 'R': 25, 'S': 13, 'T': 13, 'H': 25, 'M': 13}","{'Y': 13, 'A': 13, 'B': 6, 'D': 6, 'E': 6, 'G': 13, 'I': 6, 'K': 13, 'L': 6, 'N': 6, 'O': 6, 'U': 13, 'V': 6, 'W': 6, 'X': 6}"
INV-ZZ-5954450,SCH-ZZ-3400127,ZZ,ZZ20240522AMDHYD2223.0,2223.0,Boeing 777,05/22/2024,2024-05-22 10:52:00,2024-05-22 19:30:00,AMD,HYD,425.0,501,234,-191,267,42,85,127,170,48,22,20,26,98,46,39,52,148,69,58,79,201,94,76,107,"{'F': 25, 'P': 17}","{'C': 34, 'J': 26, 'Z': 26}","{'Q': 38, 'R': 25, 'S': 13, 'T': 13, 'H': 25, 'M': 13}","{'Y': 13, 'A': 13, 'B': 6, 'D': 6, 'E': 6, 'G': 13, 'I': 6, 'K': 13, 'L': 6, 'N': 6, 'O': 6, 'U': 13, 'V': 6, 'W': 6, 'X': 6}"
INV-ZZ-5984671,SCH-ZZ-3400127,ZZ,ZZ20240526AMDHYD2223.0,2223.0,Boeing 777,05/26/2024,2024-05-26 10:52:00,2024-05-26 19:30:00,AMD,HYD,425.0,479,220,-205,259,42,85,127,170,50,23,19,27,96,44,41,52,140,64,63,76,197,90,80,107,"{'F': 25, 'P': 17}","{'C': 34, 'J': 26, 'Z': 26}","{'Q': 38, 'R': 25, 'S': 13, 'T': 13, 'H': 25, 'M': 13}","{'Y': 13, 'A': 13, 'B': 6, 'D': 6, 'E': 6, 'G': 13, 'I': 6, 'K': 13, 'L': 6, 'N': 6, 'O': 6, 'U': 13, 'V': 6, 'W': 6, 'X': 6}"
INV-ZZ-1992356,SCH-ZZ-3400127,ZZ,ZZ20240527AMDHYD2223.0,2223.0,Boeing 777,05/27/2024,2024-05-27 10:52:00,2024-05-27 19:30:00,AMD,HYD,425.0,470,248,-177,222,42,85,127,170,49,26,16,23,96,51,34,45,151,80,47,71,195,103,67,92,"{'F': 25, 'P': 17}","{'C': 34, 'J': 26, 'Z': 26}","{'Q': 38, 'R': 25, 'S': 13, 'T': 13, 'H': 25, 'M': 13}","{'Y': 13, 'A': 13, 'B': 6, 'D': 6, 'E': 6, 'G': 13, 'I': 6, 'K': 13, 'L': 6, 'N': 6, 'O': 6, 'U': 13, 'V': 6, 'W': 6, 'X': 6}"
INV-ZZ-5501386,SCH-ZZ-3400127,ZZ,ZZ20240528AMDHYD2223.0,2223.0,Boeing 777,05/28/2024,2024-05-28 10:52:00,2024-05-28 19:30:00,AMD,HYD,425.0,487,249,-176,238,42,85,127,170,47,24,18,23,98,50,35,48,151,77,50,74,193,99,71,94,"{'F': 25, 'P': 17}","{'C': 34, 'J': 26, 'Z': 26}","{'Q': 38, 'R': 25, 'S': 13, 'T': 13, 'H': 25, 'M': 13}","{'Y': 13, 'A': 13, 'B': 6, 'D': 6, 'E': 6, 'G': 13, 'I': 6, 'K': 13, 'L': 6, 'N': 6, 'O': 6, 'U': 13, 'V': 6, 'W': 6, 'X': 6}"
INV-ZZ-2354255,SCH-ZZ-3400127,ZZ,ZZ20240529AMDHYD2223.0,2223.0,Boeing 777,05/29/2024,2024-05-29 10:52:00,2024-05-29 19:30:00,AMD,HYD,425.0,484,252,-173,232,42,85,127,170,47,24,18,23,94,49,36,45,147,77,50,70,194,101,69,93,"{'F': 25, 'P': 17}","{'C': 34, 'J': 26, 'Z': 26}","{'Q': 38, 'R': 25, 'S': 13, 'T': 13, 'H': 25, 'M': 13}","{'Y': 13, 'A': 13, 'B': 6, 'D': 6, 'E': 6, 'G': 13, 'I': 6, 'K': 13, 'L': 6, 'N': 6, 'O': 6, 'U': 13, 'V': 6, 'W': 6, 'X': 6}"
INV-ZZ-4023564,SCH-ZZ-3400127,ZZ,ZZ20240602AMDHYD2223.0,2223.0,Boeing 777,06/02/2024,2024-06-02 10:52:00,2024-06-02 19:30:00,AMD,HYD,425.0,496,228,-197,268,42,85,127,170,48,22,20,26,98,45,40,53,152,70,57,82,192,88,82,104,"{'F': 25, 'P': 17}","{'C': 34, 'J': 26, 'Z': 26}","{'Q': 38, 'R': 25, 'S': 13, 'T': 13, 'H': 25, 'M': 13}","{'Y': 13, 'A': 13, 'B': 6, 'D': 6, 'E': 6, 'G': 13, 'I': 6, 'K': 13, 'L': 6, 'N': 6, 'O': 6, 'U': 13, 'V': 6, 'W': 6, 'X': 6}"
INV-ZZ-1796152,SCH-ZZ-3400127,ZZ,ZZ20240603AMDHYD2223.0,2223.0,Boeing 777,06/03/2024,2024-06-03 10:52:00,2024-06-03 19:30:00,AMD,HYD,425.0,507,224,-201,283,42,85,127,170,49,22,20,27,95,42,43,53,148,66,61,82,196,87,83,109,"{'F': 25, 'P': 17}","{'C': 34, 'J': 26, 'Z': 26}","{'Q': 38, 'R': 25, 'S': 13, 'T': 13, 'H': 25, 'M': 13}","{'Y': 13, 'A': 13, 'B': 6, 'D': 6, 'E': 6, 'G': 13, 'I': 6, 'K': 13, 'L': 6, 'N': 6, 'O': 6, 'U': 13, 'V': 6, 'W': 6, 'X': 6}"
INV-ZZ-9027725,SCH-ZZ-3400127,ZZ,ZZ20240604AMDHYD2223.0,2223.0,Boeing 777,06/04/2024,2024-06-04 10:52:00,2024-06-04 19:30:00,AMD,HYD,425.0,482,214,-211,268,42,85,127,170,48,21,21,27,98,43,42,55,150,66,61,84,192,85,85,107,"{'F': 25, 'P': 17}","{'C': 34, 'J': 26, 'Z': 26}","{'Q': 38, 'R': 25, 'S': 13, 'T': 13, 'H': 25, 'M': 13}","{'Y': 13, 'A': 13, 'B': 6, 'D': 6, 'E': 6, 'G': 13, 'I': 6, 'K': 13, 'L': 6, 'N': 6, 'O': 6, 'U': 13, 'V': 6, 'W': 6, 'X': 6}"
INV-ZZ-2014595,SCH-ZZ-3400127,ZZ,ZZ20240605AMDHYD2223.0,2223.0,Boeing 777,06/05/2024,2024-06-05 10:52:00,2024-06-05 19:30:00,AMD,HYD,425.0,486,234,-191,252,42,85,127,170,47,23,19,24,97,47,38,50,143,69,58,74,199,96,74,103,"{'F': 25, 'P': 17}","{'C': 34, 'J': 26, 'Z': 26}","{'Q': 38, 'R': 25, 'S': 13, 'T': 13, 'H': 25, 'M': 13}","{'Y': 13, 'A': 13, 'B': 6, 'D': 6, 'E': 6, 'G': 13, 'I': 6, 'K': 13, 'L': 6, 'N': 6, 'O': 6, 'U': 13, 'V': 6, 'W': 6, 'X': 6}"
INV-ZZ-2141857,SCH-ZZ-3400127,ZZ,ZZ20240609AMDHYD2223.0,2223.0,Boeing 777,06/09/2024,2024-06-09 10:52:00,2024-06-09 19:30:00,AMD,HYD,425.0,485,206,-219,279,42,85,127,170,49,21,21,28,99,42,43,57,148,63,64,85,192,82,88,110,"{'F': 25, 'P': 17}","{'C': 34, 'J': 26, 'Z': 26}","{'Q': 38, 'R': 25, 'S': 13, 'T': 13, 'H': 25, 'M': 13}","{'Y': 13, 'A': 13, 'B': 6, 'D': 6, 'E': 6, 'G': 13, 'I': 6, 'K': 13, 'L': 6, 'N': 6, 'O': 6, 'U': 13, 'V': 6, 'W': 6, 'X': 6}"
INV-ZZ-5971833,SCH-ZZ-3400127,ZZ,ZZ20240610AMDHYD2223.0,2223.0,Boeing 777,06/10/2024,2024-06-10 10:52:00,2024-06-10 19:30:00,AMD,HYD,425.0,476,204,-221,272,42,85,127,170,48,21,21,27,96,41,44,55,146,63,64,83,192,82,88,110,"{'F': 25, 'P': 17}","{'C': 34, 'J': 26, 'Z': 26}","{'Q': 38, 'R': 25, 'S': 13, 'T': 13, 'H': 25, 'M': 13}","{'Y': 13, 'A': 13, 'B': 6, 'D': 6, 'E': 6, 'G': 13, 'I': 6, 'K': 13, 'L': 6, 'N': 6, 'O': 6, 'U': 13, 'V': 6, 'W': 6, 'X': 6}"
INV-ZZ-3384608,SCH-ZZ-3400127,ZZ,ZZ20240611AMDHYD2223.0,2223.0,Boeing 777,06/11/2024,2024-06-11 10:52:00,2024-06-11 19:30:00,AMD,HYD,425.0,484,213,-212,271,42,85,127,170,47,21,21,26,97,43,42,54,147,65,62,82,190,84,86,106,"{'F': 25, 'P': 17}","{'C': 34, 'J': 26, 'Z': 26}","{'Q': 38, 'R': 25, 'S': 13, 'T': 13, 'H': 25, 'M': 13}","{'Y': 13, 'A': 13, 'B': 6, 'D': 6, 'E': 6, 'G': 13, 'I': 6, 'K': 13, 'L': 6, 'N': 6, 'O': 6, 'U': 13, 'V': 6, 'W': 6, 'X': 6}"
INV-ZZ-1676817,SCH-ZZ-3400127,ZZ,ZZ20240612AMDHYD2223.0,2223.0,Boeing 777,06/12/2024,2024-06-12 10:52:00,2024-06-12 19:30:00,AMD,HYD,425.0,476,201,-224,275,42,85,127,170,47,20,22,27,94,40,45,54,143,60,67,83,203,86,84,117,"{'F': 25, 'P': 17}","{'C': 34, 'J': 26, 'Z': 26}","{'Q': 38, 'R': 25, 'S': 13, 'T': 13, 'H': 25, 'M': 13}","{'Y': 13, 'A': 13, 'B': 6, 'D': 6, 'E': 6, 'G': 13, 'I': 6, 'K': 13, 'L': 6, 'N': 6, 'O': 6, 'U': 13, 'V': 6, 'W': 6, 'X': 6}"
INV-ZZ-8324457,SCH-ZZ-3400127,ZZ,ZZ20240616AMDHYD2223.0,2223.0,Boeing 777,06/16/2024,2024-06-16 10:52:00,2024-06-16 19:30:00,AMD,HYD,425.0,477,196,-229,281,42,85,127,170,47,19,23,28,95,39,46,56,149,61,66,88,193,79,91,114,"{'F': 25, 'P': 17}","{'C': 34, 'J': 26, 'Z': 26}","{'Q': 38, 'R': 25, 'S': 13, 'T': 13, 'H': 25, 'M': 13}","{'Y': 13, 'A': 13, 'B': 6, 'D': 6, 'E': 6, 'G': 13, 'I': 6, 'K': 13, 'L': 6, 'N': 6, 'O': 6, 'U': 13, 'V': 6, 'W': 6, 'X': 6}"
INV-ZZ-2400044,SCH-ZZ-3400127,ZZ,ZZ20240617AMDHYD2223.0,2223.0,Boeing 777,06/17/2024,2024-06-17 10:52:00,2024-06-17 19:30:00,AMD,HYD,425.0,473,201,-224,272,42,85,127,170,47,20,22,27,94,40,45,54,151,64,63,87,204,87,83,117,"{'F': 25, 'P': 17}","{'C': 34, 'J': 26, 'Z': 26}","{'Q': 38, 'R': 25, 'S': 13, 'T': 13, 'H': 25, 'M': 13}","{'Y': 13, 'A': 13, 'B': 6, 'D': 6, 'E': 6, 'G': 13, 'I': 6, 'K': 13, 'L': 6, 'N': 6, 'O': 6, 'U': 13, 'V': 6, 'W': 6, 'X': 6}"
INV-ZZ-5183618,SCH-ZZ-6095474,ZZ,ZZ20240407HYDAMD3723.0,3723.0,Airbus A320 Neo,04/07/2024,2024-04-07 20:40:00,2024-04-08 12:24:00,HYD,AMD,180.0,201,123,-57,78,18,36,54,72,20,12,6,8,43,26,10,17,63,39,15,24,82,50,22,32,"{'F': 11, 'P': 7}","{'C': 14, 'J': 11, 'Z': 11}","{'Q': 16, 'R': 11, 'S': 5, 'T': 5, 'H': 11, 'M': 5}","{'Y': 5, 'A': 5, 'B': 3, 'D': 3, 'E': 3, 'G': 5, 'I': 3, 'K': 5, 'L': 3, 'N': 3, 'O': 3, 'U': 5, 'V': 3, 'W': 3, 'X': 3}"
INV-ZZ-8561943,SCH-ZZ-6095474,ZZ,ZZ20240410HYDAMD3723.0,3723.0,Airbus A320 Neo,04/10/2024,2024-04-10 20:40:00,2024-04-11 12:24:00,HYD,AMD,180.0,202,131,-49,71,18,36,54,72,21,14,4,7,43,28,8,15,64,41,13,23,82,53,19,29,"{'F': 11, 'P': 7}","{'C': 14, 'J': 11, 'Z': 11}","{'Q': 16, 'R': 11, 'S': 5, 'T': 5, 'H': 11, 'M': 5}","{'Y': 5, 'A': 5, 'B': 3, 'D': 3, 'E': 3, 'G': 5, 'I': 3, 'K': 5, 'L': 3, 'N': 3, 'O': 3, 'U': 5, 'V': 3, 'W': 3, 'X': 3}"
INV-ZZ-1703048,SCH-ZZ-6095474,ZZ,ZZ20240411HYDAMD3723.0,3723.0,Airbus A320 Neo,04/11/2024,2024-04-11 20:40:00,2024-04-12 12:24:00,HYD,AMD,180.0,206,118,-62,88,18,36,54,72,20,11,7,9,43,25,11,18,63,36,18,27,82,47,25,35,"{'F': 11, 'P': 7}","{'C': 14, 'J': 11, 'Z': 11}","{'Q': 16, 'R': 11, 'S': 5, 'T': 5, 'H': 11, 'M': 5}","{'Y': 5, 'A': 5, 'B': 3, 'D': 3, 'E': 3, 'G': 5, 'I': 3, 'K': 5, 'L': 3, 'N': 3, 'O': 3, 'U': 5, 'V': 3, 'W': 3, 'X': 3}"
INV-ZZ-1835306,SCH-ZZ-6095474,ZZ,ZZ20240413HYDAMD3723.0,3723.0,Airbus A320 Neo,04/13/2024,2024-04-13 20:40:00,2024-04-14 12:24:00,HYD,AMD,180.0,202,121,-59,81,18,36,54,72,20,12,6,8,40,24,12,16,60,36,18,24,81,49,23,32,"{'F': 11, 'P': 7}","{'C': 14, 'J': 11, 'Z': 11}","{'Q': 16, 'R': 11, 'S': 5, 'T': 5, 'H': 11, 'M': 5}","{'Y': 5, 'A': 5, 'B': 3, 'D': 3, 'E': 3, 'G': 5, 'I': 3, 'K': 5, 'L': 3, 'N': 3, 'O': 3, 'U': 5, 'V': 3, 'W': 3, 'X': 3}"
INV-ZZ-1644109,SCH-ZZ-6095474,ZZ,ZZ20240414HYDAMD3723.0,3723.0,Airbus A320 Neo,04/14/2024,2024-04-14 20:40:00,2024-04-15 12:24:00,HYD,AMD,180.0,201,124,-56,77,18,36,54,72,21,13,5,8,42,26,10,16,63,39,15,24,81,50,22,31,"{'F': 11, 'P': 7}","{'C': 14, 'J': 11, 'Z': 11}","{'Q': 16, 'R': 11, 'S': 5, 'T': 5, 'H': 11, 'M': 5}","{'Y': 5, 'A': 5, 'B': 3, 'D': 3, 'E': 3, 'G': 5, 'I': 3, 'K': 5, 'L': 3, 'N': 3, 'O': 3, 'U': 5, 'V': 3, 'W': 3, 'X': 3}"
INV-ZZ-6221422,SCH-ZZ-6095474,ZZ,ZZ20240417HYDAMD3723.0,3723.0,Airbus A320 Neo,04/17/2024,2024-04-17 20:40:00,2024-04-18 12:24:00,HYD,AMD,180.0,199,115,-65,84,18,36,54,72,21,12,6,9,41,24,12,17,63,36,18,27,81,47,25,34,"{'F': 11, 'P': 7}","{'C': 14, 'J': 11, 'Z': 11}","{'Q': 16, 'R': 11, 'S': 5, 'T': 5, 'H': 11, 'M': 5}","{'Y': 5, 'A': 5, 'B': 3, 'D': 3, 'E': 3, 'G': 5, 'I': 3, 'K': 5, 'L': 3, 'N': 3, 'O': 3, 'U': 5, 'V': 3, 'W': 3, 'X': 3}"
INV-ZZ-1535659,SCH-ZZ-6095474,ZZ,ZZ20240418HYDAMD3723.0,3723.0,Airbus A320 Neo,04/18/2024,2024-04-18 20:40:00,2024-04-19 12:24:00,HYD,AMD,180.0,199,116,-64,83,18,36,54,72,20,12,6,8,42,24,12,18,61,36,18,25,82,48,24,34,"{'F': 11, 'P': 7}","{'C': 14, 'J': 11, 'Z': 11}","{'Q': 16, 'R': 11, 'S': 5, 'T': 5, 'H': 11, 'M': 5}","{'Y': 5, 'A': 5, 'B': 3, 'D': 3, 'E': 3, 'G': 5, 'I': 3, 'K': 5, 'L': 3, 'N': 3, 'O': 3, 'U': 5, 'V': 3, 'W': 3, 'X': 3}"
INV-ZZ-9961664,SCH-ZZ-6095474,ZZ,ZZ20240420HYDAMD3723.0,3723.0,Airbus A320 Neo,04/20/2024,2024-04-20 20:40:00,2024-04-21 12:24:00,HYD,AMD,180.0,215,117,-63,98,18,36,54,72,21,11,7,10,41,22,14,19,65,35,19,30,82,45,27,37,"{'F': 11, 'P': 7}","{'C': 14, 'J': 11, 'Z': 11}","{'Q': 16, 'R': 11, 'S': 5, 'T': 5, 'H': 11, 'M': 5}","{'Y': 5, 'A': 5, 'B': 3, 'D': 3, 'E': 3, 'G': 5, 'I': 3, 'K': 5, 'L': 3, 'N': 3, 'O': 3, 'U': 5, 'V': 3, 'W': 3, 'X': 3}"
INV-ZZ-6246289,SCH-ZZ-6095474,ZZ,ZZ20240421HYDAMD3723.0,3723.0,Airbus A320 Neo,04/21/2024,2024-04-21 20:40:00,2024-04-22 12:24:00,HYD,AMD,180.0,211,129,-51,82,18,36,54,72,21,13,5,8,41,25,11,16,60,37,17,23,82,50,22,32,"{'F': 11, 'P': 7}","{'C': 14, 'J': 11, 'Z': 11}","{'Q': 16, 'R': 11, 'S': 5, 'T': 5, 'H': 11, 'M': 5}","{'Y': 5, 'A': 5, 'B': 3, 'D': 3, 'E': 3, 'G': 5, 'I': 3, 'K': 5, 'L': 3, 'N': 3, 'O': 3, 'U': 5, 'V': 3, 'W': 3, 'X': 3}"
INV-ZZ-1701449,SCH-ZZ-6095474,ZZ,ZZ20240424HYDAMD3723.0,3723.0,Airbus A320 Neo,04/24/2024,2024-04-24 20:40:00,2024-04-25 12:24:00,HYD,AMD,180.0,214,118,-62,96,18,36,54,72,20,11,7,9,42,23,13,19,62,34,20,28,81,45,27,36,"{'F': 11, 'P': 7}","{'C': 14, 'J': 11, 'Z': 11}","{'Q': 16, 'R': 11, 'S': 5, 'T': 5, 'H': 11, 'M': 5}","{'Y': 5, 'A': 5, 'B': 3, 'D': 3, 'E': 3, 'G': 5, 'I': 3, 'K': 5, 'L': 3, 'N': 3, 'O': 3, 'U': 5, 'V': 3, 'W': 3, 'X': 3}"
INV-ZZ-6584575,SCH-ZZ-6095474,ZZ,ZZ20240425HYDAMD3723.0,3723.0,Airbus A320 Neo,04/25/2024,2024-04-25 20:40:00,2024-04-26 12:24:00,HYD,AMD,180.0,206,110,-70,96,18,36,54,72,21,11,7,10,42,22,14,20,62,33,21,29,85,45,27,40,"{'F': 11, 'P': 7}","{'C': 14, 'J': 11, 'Z': 11}","{'Q': 16, 'R': 11, 'S': 5, 'T': 5, 'H': 11, 'M': 5}","{'Y': 5, 'A': 5, 'B': 3, 'D': 3, 'E': 3, 'G': 5, 'I': 3, 'K': 5, 'L': 3, 'N': 3, 'O': 3, 'U': 5, 'V': 3, 'W': 3, 'X': 3}"
INV-ZZ-9541445,SCH-ZZ-6095474,ZZ,ZZ20240427HYDAMD3723.0,3723.0,Airbus A320 Neo,04/27/2024,2024-04-27 20:40:00,2024-04-28 12:24:00,HYD,AMD,180.0,203,119,-61,84,18,36,54,72,21,12,6,9,42,25,11,17,64,38,16,26,81,48,24,33,"{'F': 11, 'P': 7}","{'C': 14, 'J': 11, 'Z': 11}","{'Q': 16, 'R': 11, 'S': 5, 'T': 5, 'H': 11, 'M': 5}","{'Y': 5, 'A': 5, 'B': 3, 'D': 3, 'E': 3, 'G': 5, 'I': 3, 'K': 5, 'L': 3, 'N': 3, 'O': 3, 'U': 5, 'V': 3, 'W': 3, 'X': 3}"
INV-ZZ-1585088,SCH-ZZ-6095474,ZZ,ZZ20240428HYDAMD3723.0,3723.0,Airbus A320 Neo,04/28/2024,2024-04-28 20:40:00,2024-04-29 12:24:00,HYD,AMD,180.0,200,116,-64,84,18,36,54,72,21,12,6,9,40,23,13,17,62,36,18,26,83,48,24,35,"{'F': 11, 'P': 7}","{'C': 14, 'J': 11, 'Z': 11}","{'Q': 16, 'R': 11, 'S': 5, 'T': 5, 'H': 11, 'M': 5}","{'Y': 5, 'A': 5, 'B': 3, 'D': 3, 'E': 3, 'G': 5, 'I': 3, 'K': 5, 'L': 3, 'N': 3, 'O': 3, 'U': 5, 'V': 3, 'W': 3, 'X': 3}"
INV-ZZ-8250797,SCH-ZZ-6095474,ZZ,ZZ20240501HYDAMD3723.0,3723.0,Airbus A320 Neo,05/01/2024,2024-05-01 20:40:00,2024-05-02 12:24:00,HYD,AMD,180.0,209,121,-59,88,18,36,54,72,21,12,6,9,40,23,13,17,64,37,17,27,81,47,25,34,"{'F': 11, 'P': 7}","{'C': 14, 'J': 11, 'Z': 11}","{'Q': 16, 'R': 11, 'S': 5, 'T': 5, 'H': 11, 'M': 5}","{'Y': 5, 'A': 5, 'B': 3, 'D': 3, 'E': 3, 'G': 5, 'I': 3, 'K': 5, 'L': 3, 'N': 3, 'O': 3, 'U': 5, 'V': 3, 'W': 3, 'X': 3}"
INV-ZZ-1225790,SCH-ZZ-6095474,ZZ,ZZ20240502HYDAMD3723.0,3723.0,Airbus A320 Neo,05/02/2024,2024-05-02 20:40:00,2024-05-03 12:24:00,HYD,AMD,180.0,214,120,-60,94,18,36,54,72,21,12,6,9,41,23,13,18,62,35,19,27,82,46,26,36,"{'F': 11, 'P': 7}","{'C': 14, 'J': 11, 'Z': 11}","{'Q': 16, 'R': 11, 'S': 5, 'T': 5, 'H': 11, 'M': 5}","{'Y': 5, 'A': 5, 'B': 3, 'D': 3, 'E': 3, 'G': 5, 'I': 3, 'K': 5, 'L': 3, 'N': 3, 'O': 3, 'U': 5, 'V': 3, 'W': 3, 'X': 3}"
INV-ZZ-9333293,SCH-ZZ-6095474,ZZ,ZZ20240504HYDAMD3723.0,3723.0,Airbus A320 Neo,05/04/2024,2024-05-04 20:40:00,2024-05-05 12:24:00,HYD,AMD,180.0,206,121,-59,85,18,36,54,72,21,12,6,9,40,23,13,17,64,38,16,26,86,50,22,36,"{'F': 11, 'P': 7}","{'C': 14, 'J': 11, 'Z': 11}","{'Q': 16, 'R': 11, 'S': 5, 'T': 5, 'H': 11, 'M': 5}","{'Y': 5, 'A': 5, 'B': 3, 'D': 3, 'E': 3, 'G': 5, 'I': 3, 'K': 5, 'L': 3, 'N': 3, 'O': 3, 'U': 5, 'V': 3, 'W': 3, 'X': 3}"
INV-ZZ-9341601,SCH-ZZ-6095474,ZZ,ZZ20240505HYDAMD3723.0,3723.0,Airbus A320 Neo,05/05/2024,2024-05-05 20:40:00,2024-05-06 12:24:00,HYD,AMD,180.0,206,104,-76,102,18,36,54,72,22,11,7,11,43,22,14,21,63,32,22,31,79,40,32,39,"{'F': 11, 'P': 7}","{'C': 14, 'J': 11, 'Z': 11}","{'Q': 16, 'R': 11, 'S': 5, 'T': 5, 'H': 11, 'M': 5}","{'Y': 5, 'A': 5, 'B': 3, 'D': 3, 'E': 3, 'G': 5, 'I': 3, 'K': 5, 'L': 3, 'N': 3, 'O': 3, 'U': 5, 'V': 3, 'W': 3, 'X': 3}"
INV-ZZ-1129237,SCH-ZZ-6095474,ZZ,ZZ20240508HYDAMD3723.0,3723.0,Airbus A320 Neo,05/08/2024,2024-05-08 20:40:00,2024-05-09 12:24:00,HYD,AMD,180.0,204,109,-71,95,18,36,54,72,20,11,7,9,42,22,14,20,64,34,20,30,85,45,27,40,"{'F': 11, 'P': 7}","{'C': 14, 'J': 11, 'Z': 11}","{'Q': 16, 'R': 11, 'S': 5, 'T': 5, 'H': 11, 'M': 5}","{'Y': 5, 'A': 5, 'B': 3, 'D': 3, 'E': 3, 'G': 5, 'I': 3, 'K': 5, 'L': 3, 'N': 3, 'O': 3, 'U': 5, 'V': 3, 'W': 3, 'X': 3}"
INV-ZZ-3646764,SCH-ZZ-6095474,ZZ,ZZ20240509HYDAMD3723.0,3723.0,Airbus A320 Neo,05/09/2024,2024-05-09 20:40:00,2024-05-10 12:24:00,HYD,AMD,180.0,215,116,-64,99,18,36,54,72,20,11,7,9,42,23,13,19,62,33,21,29,80,43,29,37,"{'F': 11, 'P': 7}","{'C': 14, 'J': 11, 'Z': 11}","{'Q': 16, 'R': 11, 'S': 5, 'T': 5, 'H': 11, 'M': 5}","{'Y': 5, 'A': 5, 'B': 3, 'D': 3, 'E': 3, 'G': 5, 'I': 3, 'K': 5, 'L': 3, 'N': 3, 'O': 3, 'U': 5, 'V': 3, 'W': 3, 'X': 3}"
INV-ZZ-4518400,SCH-ZZ-6095474,ZZ,ZZ20240511HYDAMD3723.0,3723.0,Airbus A320 Neo,05/11/2024,2024-05-11 20:40:00,2024-05-12 12:24:00,HYD,AMD,180.0,208,114,-66,94,18,36,54,72,20,11,7,9,40,22,14,18,61,33,21,28,86,47,25,39,"{'F': 11, 'P': 7}","{'C': 14, 'J': 11, 'Z': 11}","{'Q': 16, 'R': 11, 'S': 5, 'T': 5, 'H': 11, 'M': 5}","{'Y': 5, 'A': 5, 'B': 3, 'D': 3, 'E': 3, 'G': 5, 'I': 3, 'K': 5, 'L': 3, 'N': 3, 'O': 3, 'U': 5, 'V': 3, 'W': 3, 'X': 3}"
INV-ZZ-6567308,SCH-ZZ-6095474,ZZ,ZZ20240512HYDAMD3723.0,3723.0,Airbus A320 Neo,05/12/2024,2024-05-12 20:40:00,2024-05-13 12:24:00,HYD,AMD,180.0,205,114,-66,91,18,36,54,72,21,12,6,9,43,24,12,19,62,35,19,27,82,46,26,36,"{'F': 11, 'P': 7}","{'C': 14, 'J': 11, 'Z': 11}","{'Q': 16, 'R': 11, 'S': 5, 'T': 5, 'H': 11, 'M': 5}","{'Y': 5, 'A': 5, 'B': 3, 'D': 3, 'E': 3, 'G': 5, 'I': 3, 'K': 5, 'L': 3, 'N': 3, 'O': 3, 'U': 5, 'V': 3, 'W': 3, 'X': 3}"
INV-ZZ-5788104,SCH-ZZ-6095474,ZZ,ZZ20240515HYDAMD3723.0,3723.0,Airbus A320 Neo,05/15/2024,2024-05-15 20:40:00,2024-05-16 12:24:00,HYD,AMD,180.0,202,113,-67,89,18,36,54,72,20,11,7,9,43,24,12,19,63,35,19,28,81,45,27,36,"{'F': 11, 'P': 7}","{'C': 14, 'J': 11, 'Z': 11}","{'Q': 16, 'R': 11, 'S': 5, 'T': 5, 'H': 11, 'M': 5}","{'Y': 5, 'A': 5, 'B': 3, 'D': 3, 'E': 3, 'G': 5, 'I': 3, 'K': 5, 'L': 3, 'N': 3, 'O': 3, 'U': 5, 'V': 3, 'W': 3, 'X': 3}"
INV-ZZ-8327613,SCH-ZZ-6095474,ZZ,ZZ20240516HYDAMD3723.0,3723.0,Airbus A320 Neo,05/16/2024,2024-05-16 20:40:00,2024-05-17 12:24:00,HYD,AMD,180.0,211,109,-71,102,18,36,54,72,21,11,7,10,42,22,14,20,62,32,22,30,84,43,29,41,"{'F': 11, 'P': 7}","{'C': 14, 'J': 11, 'Z': 11}","{'Q': 16, 'R': 11, 'S': 5, 'T': 5, 'H': 11, 'M': 5}","{'Y': 5, 'A': 5, 'B': 3, 'D': 3, 'E': 3, 'G': 5, 'I': 3, 'K': 5, 'L': 3, 'N': 3, 'O': 3, 'U': 5, 'V': 3, 'W': 3, 'X': 3}"
INV-ZZ-6297563,SCH-ZZ-6095474,ZZ,ZZ20240518HYDAMD3723.0,3723.0,Airbus A320 Neo,05/18/2024,2024-05-18 20:40:00,2024-05-19 12:24:00,HYD,AMD,180.0,208,112,-68,96,18,36,54,72,21,11,7,10,40,22,14,18,63,34,20,29,84,45,27,39,"{'F': 11, 'P': 7}","{'C': 14, 'J': 11, 'Z': 11}","{'Q': 16, 'R': 11, 'S': 5, 'T': 5, 'H': 11, 'M': 5}","{'Y': 5, 'A': 5, 'B': 3, 'D': 3, 'E': 3, 'G': 5, 'I': 3, 'K': 5, 'L': 3, 'N': 3, 'O': 3, 'U': 5, 'V': 3, 'W': 3, 'X': 3}"
INV-ZZ-2307618,SCH-ZZ-6095474,ZZ,ZZ20240519HYDAMD3723.0,3723.0,Airbus A320 Neo,05/19/2024,2024-05-19 20:40:00,2024-05-20 12:24:00,HYD,AMD,180.0,198,103,-77,95,18,36,54,72,21,11,7,10,40,21,15,19,60,31,23,29,82,43,29,39,"{'F': 11, 'P': 7}","{'C': 14, 'J': 11, 'Z': 11}","{'Q': 16, 'R': 11, 'S': 5, 'T': 5, 'H': 11, 'M': 5}","{'Y': 5, 'A': 5, 'B': 3, 'D': 3, 'E': 3, 'G': 5, 'I': 3, 'K': 5, 'L': 3, 'N': 3, 'O': 3, 'U': 5, 'V': 3, 'W': 3, 'X': 3}"
INV-ZZ-9346309,SCH-ZZ-6095474,ZZ,ZZ20240522HYDAMD3723.0,3723.0,Airbus A320 Neo,05/22/2024,2024-05-22 20:40:00,2024-05-23 12:24:00,HYD,AMD,180.0,201,100,-80,101,18,36,54,72,21,10,8,11,43,21,15,22,61,30,24,31,79,39,33,40,"{'F': 11, 'P': 7}","{'C': 14, 'J': 11, 'Z': 11}","{'Q': 16, 'R': 11, 'S': 5, 'T': 5, 'H': 11, 'M': 5}","{'Y': 5, 'A': 5, 'B': 3, 'D': 3, 'E': 3, 'G': 5, 'I': 3, 'K': 5, 'L': 3, 'N': 3, 'O': 3, 'U': 5, 'V': 3, 'W': 3, 'X': 3}"
INV-ZZ-5822757,SCH-ZZ-4253453,ZZ,ZZ20240419AMDMAA4012.0,4012.0,Boeing 757,04/19/2024,2024-04-19 19:00:00,2024-04-19 22:08:00,AMD,MAA,209.0,244,134,-75,110,20,41,62,83,22,12,8,10,46,25,16,21,74,41,21,33,96,53,30,43,"{'F': 12, 'P': 8}","{'C': 16, 'J': 12, 'Z': 12}","{'Q': 19, 'R': 12, 'S': 6, 'T': 6, 'H': 12, 'M': 6}","{'Y': 6, 'A': 6, 'B': 3, 'D': 3, 'E': 3, 'G': 6, 'I': 3, 'K': 6, 'L': 3, 'N': 3, 'O': 3, 'U': 6, 'V': 3, 'W': 3, 'X': 3}"
INV-ZZ-8588399,SCH-ZZ-4253453,ZZ,ZZ20240420AMDMAA4012.0,4012.0,Boeing 757,04/20/2024,2024-04-20 19:00:00,2024-04-20 22:08:00,AMD,MAA,209.0,247,153,-56,94,20,41,62,83,23,14,6,9,49,30,11,19,72,45,17,27,94,58,25,36,"{'F': 12, 'P': 8}","{'C': 16, 'J': 12, 'Z': 12}","{'Q': 19, 'R': 12, 'S': 6, 'T': 6, 'H': 12, 'M': 6}","{'Y': 6, 'A': 6, 'B': 3, 'D': 3, 'E': 3, 'G': 6, 'I': 3, 'K': 6, 'L': 3, 'N': 3, 'O': 3, 'U': 6, 'V': 3, 'W': 3, 'X': 3}"
INV-ZZ-5712543,SCH-ZZ-4253453,ZZ,ZZ20240421AMDMAA4012.0,4012.0,Boeing 757,04/21/2024,2024-04-21 19:00:00,2024-04-21 22:08:00,AMD,MAA,209.0,237,147,-62,90,20,41,62,83,23,14,6,9,46,28,13,18,74,46,16,28,98,61,22,37,"{'F': 12, 'P': 8}","{'C': 16, 'J': 12, 'Z': 12}","{'Q': 19, 'R': 12, 'S': 6, 'T': 6, 'H': 12, 'M': 6}","{'Y': 6, 'A': 6, 'B': 3, 'D': 3, 'E': 3, 'G': 6, 'I': 3, 'K': 6, 'L': 3, 'N': 3, 'O': 3, 'U': 6, 'V': 3, 'W': 3, 'X': 3}"
INV-ZZ-1190771,SCH-ZZ-4253453,ZZ,ZZ20240424AMDMAA4012.0,4012.0,Boeing 757,04/24/2024,2024-04-24 19:00:00,2024-04-24 22:08:00,AMD,MAA,209.0,233,124,-85,109,20,41,62,83,22,12,8,10,47,25,16,22,69,37,25,32,93,50,33,43,"{'F': 12, 'P': 8}","{'C': 16, 'J': 12, 'Z': 12}","{'Q': 19, 'R': 12, 'S': 6, 'T': 6, 'H': 12, 'M': 6}","{'Y': 6, 'A': 6, 'B': 3, 'D': 3, 'E': 3, 'G': 6, 'I': 3, 'K': 6, 'L': 3, 'N': 3, 'O': 3, 'U': 6, 'V': 3, 'W': 3, 'X': 3}"
INV-ZZ-1296181,SCH-ZZ-4253453,ZZ,ZZ20240426AMDMAA4012.0,4012.0,Boeing 757,04/26/2024,2024-04-26 19:00:00,2024-04-26 22:08:00,AMD,MAA,209.0,249,134,-75,115,20,41,62,83,24,13,7,11,46,25,16,21,70,38,24,32,96,52,31,44,"{'F': 12, 'P': 8}","{'C': 16, 'J': 12, 'Z': 12}","{'Q': 19, 'R': 12, 'S': 6, 'T': 6, 'H': 12, 'M': 6}","{'Y': 6, 'A': 6, 'B': 3, 'D': 3, 'E': 3, 'G': 6, 'I': 3, 'K': 6, 'L': 3, 'N': 3, 'O': 3, 'U': 6, 'V': 3, 'W': 3, 'X': 3}"
INV-ZZ-9182893,SCH-ZZ-4253453,ZZ,ZZ20240427AMDMAA4012.0,4012.0,Boeing 757,04/27/2024,2024-04-27 19:00:00,2024-04-27 22:08:00,AMD,MAA,209.0,241,146,-63,95,20,41,62,83,24,15,5,9,49,30,11,19,70,42,20,28,99,60,23,39,"{'F': 12, 'P': 8}","{'C': 16, 'J': 12, 'Z': 12}","{'Q': 19, 'R': 12, 'S': 6, 'T': 6, 'H': 12, 'M': 6}","{'Y': 6, 'A': 6, 'B': 3, 'D': 3, 'E': 3, 'G': 6, 'I': 3, 'K': 6, 'L': 3, 'N': 3, 'O': 3, 'U': 6, 'V': 3, 'W': 3, 'X': 3}"
INV-ZZ-9192037,SCH-ZZ-4253453,ZZ,ZZ20240428AMDMAA4012.0,4012.0,Boeing 757,04/28/2024,2024-04-28 19:00:00,2024-04-28 22:08:00,AMD,MAA,209.0,250,147,-62,103,20,41,62,83,23,14,6,9,46,27,14,19,69,41,21,28,94,55,28,39,"{'F': 12, 'P': 8}","{'C': 16, 'J': 12, 'Z': 12}","{'Q': 19, 'R': 12, 'S': 6, 'T': 6, 'H': 12, 'M': 6}","{'Y': 6, 'A': 6, 'B': 3, 'D': 3, 'E': 3, 'G': 6, 'I': 3, 'K': 6, 'L': 3, 'N': 3, 'O': 3, 'U': 6, 'V': 3, 'W': 3, 'X': 3}"
INV-ZZ-7397800,SCH-ZZ-4253453,ZZ,ZZ20240501AMDMAA4012.0,4012.0,Boeing 757,05/01/2024,2024-05-01 19:00:00,2024-05-01 22:08:00,AMD,MAA,209.0,249,137,-72,112,20,41,62,83,22,12,8,10,48,26,15,22,73,40,22,33,98,54,29,44,"{'F': 12, 'P': 8}","{'C': 16, 'J': 12, 'Z': 12}","{'Q': 19, 'R': 12, 'S': 6, 'T': 6, 'H': 12, 'M': 6}","{'Y': 6, 'A': 6, 'B': 3, 'D': 3, 'E': 3, 'G': 6, 'I': 3, 'K': 6, 'L': 3, 'N': 3, 'O': 3, 'U': 6, 'V': 3, 'W': 3, 'X': 3}"
INV-ZZ-5084465,SCH-ZZ-4253453,ZZ,ZZ20240503AMDMAA4012.0,4012.0,Boeing 757,05/03/2024,2024-05-03 19:00:00,2024-05-03 22:08:00,AMD,MAA,209.0,231,127,-82,104,20,41,62,83,24,13,7,11,47,26,15,21,72,40,22,32,98,54,29,44,"{'F': 12, 'P': 8}","{'C': 16, 'J': 12, 'Z': 12}","{'Q': 19, 'R': 12, 'S': 6, 'T': 6, 'H': 12, 'M': 6}","{'Y': 6, 'A': 6, 'B': 3, 'D': 3, 'E': 3, 'G': 6, 'I': 3, 'K': 6, 'L': 3, 'N': 3, 'O': 3, 'U': 6, 'V': 3, 'W': 3, 'X': 3}"
INV-ZZ-7491504,SCH-ZZ-4253453,ZZ,ZZ20240504AMDMAA4012.0,4012.0,Boeing 757,05/04/2024,2024-05-04 19:00:00,2024-05-04 22:08:00,AMD,MAA,209.0,246,126,-83,120,20,41,62,83,23,12,8,11,48,25,16,23,69,35,27,34,98,50,33,48,"{'F': 12, 'P': 8}","{'C': 16, 'J': 12, 'Z': 12}","{'Q': 19, 'R': 12, 'S': 6, 'T': 6, 'H': 12, 'M': 6}","{'Y': 6, 'A': 6, 'B': 3, 'D': 3, 'E': 3, 'G': 6, 'I': 3, 'K': 6, 'L': 3, 'N': 3, 'O': 3, 'U': 6, 'V': 3, 'W': 3, 'X': 3}"
INV-ZZ-1333815,SCH-ZZ-4253453,ZZ,ZZ20240505AMDMAA4012.0,4012.0,Boeing 757,05/05/2024,2024-05-05 19:00:00,2024-05-05 22:08:00,AMD,MAA,209.0,246,142,-67,104,20,41,62,83,24,14,6,10,46,26,15,20,72,41,21,31,99,57,26,42,"{'F': 12, 'P': 8}","{'C': 16, 'J': 12, 'Z': 12}","{'Q': 19, 'R': 12, 'S': 6, 'T': 6, 'H': 12, 'M': 6}","{'Y': 6, 'A': 6, 'B': 3, 'D': 3, 'E': 3, 'G': 6, 'I': 3, 'K': 6, 'L': 3, 'N': 3, 'O': 3, 'U': 6, 'V': 3, 'W': 3, 'X': 3}"
INV-ZZ-9057003,SCH-ZZ-4253453,ZZ,ZZ20240508AMDMAA4012.0,4012.0,Boeing 757,05/08/2024,2024-05-08 19:00:00,2024-05-08 22:08:00,AMD,MAA,209.0,246,125,-84,121,20,41,62,83,23,12,8,11,46,23,18,23,72,37,25,35,97,49,34,48,"{'F': 12, 'P': 8}","{'C': 16, 'J': 12, 'Z': 12}","{'Q': 19, 'R': 12, 'S': 6, 'T': 6, 'H': 12, 'M': 6}","{'Y': 6, 'A': 6, 'B': 3, 'D': 3, 'E': 3, 'G': 6, 'I': 3, 'K': 6, 'L': 3, 'N': 3, 'O': 3, 'U': 6, 'V': 3, 'W': 3, 'X': 3}"
INV-ZZ-6970571,SCH-ZZ-4253453,ZZ,ZZ20240510AMDMAA4012.0,4012.0,Boeing 757,05/10/2024,2024-05-10 19:00:00,2024-05-10 22:08:00,AMD,MAA,209.0,240,133,-76,107,20,41,62,83,23,13,7,10,48,27,14,21,73,40,22,33,98,54,29,44,"{'F': 12, 'P': 8}","{'C': 16, 'J': 12, 'Z': 12}","{'Q': 19, 'R': 12, 'S': 6, 'T': 6, 'H': 12, 'M': 6}","{'Y': 6, 'A': 6, 'B': 3, 'D': 3, 'E': 3, 'G': 6, 'I': 3, 'K': 6, 'L': 3, 'N': 3, 'O': 3, 'U': 6, 'V': 3, 'W': 3, 'X': 3}"
INV-ZZ-4395668,SCH-ZZ-4253453,ZZ,ZZ20240511AMDMAA4012.0,4012.0,Boeing 757,05/11/2024,2024-05-11 19:00:00,2024-05-11 22:08:00,AMD,MAA,209.0,230,122,-87,108,20,41,62,83,24,13,7,11,45,24,17,21,72,38,24,34,98,52,31,46,"{'F': 12, 'P': 8}","{'C': 16, 'J': 12, 'Z': 12}","{'Q': 19, 'R': 12, 'S': 6, 'T': 6, 'H': 12, 'M': 6}","{'Y': 6, 'A': 6, 'B': 3, 'D': 3, 'E': 3, 'G': 6, 'I': 3, 'K': 6, 'L': 3, 'N': 3, 'O': 3, 'U': 6, 'V': 3, 'W': 3, 'X': 3}"
INV-ZZ-1032718,SCH-ZZ-4253453,ZZ,ZZ20240512AMDMAA4012.0,4012.0,Boeing 757,05/12/2024,2024-05-12 19:00:00,2024-05-12 22:08:00,AMD,MAA,209.0,247,137,-72,110,20,41,62,83,24,13,7,11,46,26,15,20,69,38,24,31,95,53,30,42,"{'F': 12, 'P': 8}","{'C': 16, 'J': 12, 'Z': 12}","{'Q': 19, 'R': 12, 'S': 6, 'T': 6, 'H': 12, 'M': 6}","{'Y': 6, 'A': 6, 'B': 3, 'D': 3, 'E': 3, 'G': 6, 'I': 3, 'K': 6, 'L': 3, 'N': 3, 'O': 3, 'U': 6, 'V': 3, 'W': 3, 'X': 3}"
INV-ZZ-8257896,SCH-ZZ-4253453,ZZ,ZZ20240515AMDMAA4012.0,4012.0,Boeing 757,05/15/2024,2024-05-15 19:00:00,2024-05-15 22:08:00,AMD,MAA,209.0,243,126,-83,117,20,41,62,83,23,12,8,11,49,25,16,24,72,37,25,35,92,48,35,44,"{'F': 12, 'P': 8}","{'C': 16, 'J': 12, 'Z': 12}","{'Q': 19, 'R': 12, 'S': 6, 'T': 6, 'H': 12, 'M': 6}","{'Y': 6, 'A': 6, 'B': 3, 'D': 3, 'E': 3, 'G': 6, 'I': 3, 'K': 6, 'L': 3, 'N': 3, 'O': 3, 'U': 6, 'V': 3, 'W': 3, 'X': 3}"
INV-ZZ-8113553,SCH-ZZ-4253453,ZZ,ZZ20240517AMDMAA4012.0,4012.0,Boeing 757,05/17/2024,2024-05-17 19:00:00,2024-05-17 22:08:00,AMD,MAA,209.0,242,133,-76,109,20,41,62,83,24,13,7,11,48,26,15,22,68,37,25,31,98,54,29,44,"{'F': 12, 'P': 8}","{'C': 16, 'J': 12, 'Z': 12}","{'Q': 19, 'R': 12, 'S': 6, 'T': 6, 'H': 12, 'M': 6}","{'Y': 6, 'A': 6, 'B': 3, 'D': 3, 'E': 3, 'G': 6, 'I': 3, 'K': 6, 'L': 3, 'N': 3, 'O': 3, 'U': 6, 'V': 3, 'W': 3, 'X': 3}"
INV-ZZ-6896420,SCH-ZZ-4253453,ZZ,ZZ20240518AMDMAA4012.0,4012.0,Boeing 757,05/18/2024,2024-05-18 19:00:00,2024-05-18 22:08:00,AMD,MAA,209.0,233,116,-93,117,20,41,62,83,23,11,9,12,49,24,17,25,70,35,27,35,99,49,34,50,"{'F': 12, 'P': 8}","{'C': 16, 'J': 12, 'Z': 12}","{'Q': 19, 'R': 12, 'S': 6, 'T': 6, 'H': 12, 'M': 6}","{'Y': 6, 'A': 6, 'B': 3, 'D': 3, 'E': 3, 'G': 6, 'I': 3, 'K': 6, 'L': 3, 'N': 3, 'O': 3, 'U': 6, 'V': 3, 'W': 3, 'X': 3}"
INV-ZZ-6653610,SCH-ZZ-4253453,ZZ,ZZ20240519AMDMAA4012.0,4012.0,Boeing 757,05/19/2024,2024-05-19 19:00:00,2024-05-19 22:08:00,AMD,MAA,209.0,230,117,-92,113,20,41,62,83,22,11,9,11,49,25,16,24,71,36,26,35,97,49,34,48,"{'F': 12, 'P': 8}","{'C': 16, 'J': 12, 'Z': 12}","{'Q': 19, 'R': 12, 'S': 6, 'T': 6, 'H': 12, 'M': 6}","{'Y': 6, 'A': 6, 'B': 3, 'D': 3, 'E': 3, 'G': 6, 'I': 3, 'K': 6, 'L': 3, 'N': 3, 'O': 3, 'U': 6, 'V': 3, 'W': 3, 'X': 3}"
INV-ZZ-6352197,SCH-ZZ-4253453,ZZ,ZZ20240522AMDMAA4012.0,4012.0,Boeing 757,05/22/2024,2024-05-22 19:00:00,2024-05-22 22:08:00,AMD,MAA,209.0,247,131,-78,116,20,41,62,83,22,12,8,10,47,25,16,22,73,39,23,34,99,52,31,47,"{'F': 12, 'P': 8}","{'C': 16, 'J': 12, 'Z': 12}","{'Q': 19, 'R': 12, 'S': 6, 'T': 6, 'H': 12, 'M': 6}","{'Y': 6, 'A': 6, 'B': 3, 'D': 3, 'E': 3, 'G': 6, 'I': 3, 'K': 6, 'L': 3, 'N': 3, 'O': 3, 'U': 6, 'V': 3, 'W': 3, 'X': 3}"
INV-ZZ-3529375,SCH-ZZ-4253453,ZZ,ZZ20240524AMDMAA4012.0,4012.0,Boeing 757,05/24/2024,2024-05-24 19:00:00,2024-05-24 22:08:00,AMD,MAA,209.0,242,116,-93,126,20,41,62,83,22,11,9,11,48,23,18,25,70,34,28,36,92,44,39,48,"{'F': 12, 'P': 8}","{'C': 16, 'J': 12, 'Z': 12}","{'Q': 19, 'R': 12, 'S': 6, 'T': 6, 'H': 12, 'M': 6}","{'Y': 6, 'A': 6, 'B': 3, 'D': 3, 'E': 3, 'G': 6, 'I': 3, 'K': 6, 'L': 3, 'N': 3, 'O': 3, 'U': 6, 'V': 3, 'W': 3, 'X': 3}"
INV-ZZ-5667878,SCH-ZZ-4253453,ZZ,ZZ20240525AMDMAA4012.0,4012.0,Boeing 757,05/25/2024,2024-05-25 19:00:00,2024-05-25 22:08:00,AMD,MAA,209.0,233,122,-87,111,20,41,62,83,23,12,8,11,49,26,15,23,71,37,25,34,92,48,35,44,"{'F': 12, 'P': 8}","{'C': 16, 'J': 12, 'Z': 12}","{'Q': 19, 'R': 12, 'S': 6, 'T': 6, 'H': 12, 'M': 6}","{'Y': 6, 'A': 6, 'B': 3, 'D': 3, 'E': 3, 'G': 6, 'I': 3, 'K': 6, 'L': 3, 'N': 3, 'O': 3, 'U': 6, 'V': 3, 'W': 3, 'X': 3}"
INV-ZZ-9510695,SCH-ZZ-4253453,ZZ,ZZ20240526AMDMAA4012.0,4012.0,Boeing 757,05/26/2024,2024-05-26 19:00:00,2024-05-26 22:08:00,AMD,MAA,209.0,246,123,-86,123,20,41,62,83,22,11,9,11,45,22,19,23,69,34,28,35,99,49,34,50,"{'F': 12, 'P': 8}","{'C': 16, 'J': 12, 'Z': 12}","{'Q': 19, 'R': 12, 'S': 6, 'T': 6, 'H': 12, 'M': 6}","{'Y': 6, 'A': 6, 'B': 3, 'D': 3, 'E': 3, 'G': 6, 'I': 3, 'K': 6, 'L': 3, 'N': 3, 'O': 3, 'U': 6, 'V': 3, 'W': 3, 'X': 3}"
INV-ZZ-7209027,SCH-ZZ-4253453,ZZ,ZZ20240529AMDMAA4012.0,4012.0,Boeing 757,05/29/2024,2024-05-29 19:00:00,2024-05-29 22:08:00,AMD,MAA,209.0,245,122,-87,123,20,41,62,83,23,11,9,12,46,23,18,23,70,35,27,35,97,48,35,49,"{'F': 12, 'P': 8}","{'C': 16, 'J': 12, 'Z': 12}","{'Q': 19, 'R': 12, 'S': 6, 'T': 6, 'H': 12, 'M': 6}","{'Y': 6, 'A': 6, 'B': 3, 'D': 3, 'E': 3, 'G': 6, 'I': 3, 'K': 6, 'L': 3, 'N': 3, 'O': 3, 'U': 6, 'V': 3, 'W': 3, 'X': 3}"
INV-ZZ-3586709,SCH-ZZ-4253453,ZZ,ZZ20240531AMDMAA4012.0,4012.0,Boeing 757,05/31/2024,2024-05-31 19:00:00,2024-05-31 22:08:00,AMD,MAA,209.0,249,119,-90,130,20,41,62,83,22,11,9,11,48,23,18,25,70,33,29,37,99,47,36,52,"{'F': 12, 'P': 8}","{'C': 16, 'J': 12, 'Z': 12}","{'Q': 19, 'R': 12, 'S': 6, 'T': 6, 'H': 12, 'M': 6}","{'Y': 6, 'A': 6, 'B': 3, 'D': 3, 'E': 3, 'G': 6, 'I': 3, 'K': 6, 'L': 3, 'N': 3, 'O': 3, 'U': 6, 'V': 3, 'W': 3, 'X': 3}"
INV-ZZ-9469228,SCH-ZZ-4253453,ZZ,ZZ20240601AMDMAA4012.0,4012.0,Boeing 757,06/01/2024,2024-06-01 19:00:00,2024-06-01 22:08:00,AMD,MAA,209.0,231,112,-97,119,20,41,62,83,23,11,9,12,48,23,18,25,71,34,28,37,95,46,37,49,"{'F': 12, 'P': 8}","{'C': 16, 'J': 12, 'Z': 12}","{'Q': 19, 'R': 12, 'S': 6, 'T': 6, 'H': 12, 'M': 6}","{'Y': 6, 'A': 6, 'B': 3, 'D': 3, 'E': 3, 'G': 6, 'I': 3, 'K': 6, 'L': 3, 'N': 3, 'O': 3, 'U': 6, 'V': 3, 'W': 3, 'X': 3}"
INV-ZZ-6685954,SCH-ZZ-4253453,ZZ,ZZ20240602AMDMAA4012.0,4012.0,Boeing 757,06/02/2024,2024-06-02 19:00:00,2024-06-02 22:08:00,AMD,MAA,209.0,249,119,-90,130,20,41,62,83,24,11,9,13,47,22,19,25,71,34,28,37,93,44,39,49,"{'F': 12, 'P': 8}","{'C': 16, 'J': 12, 'Z': 12}","{'Q': 19, 'R': 12, 'S': 6, 'T': 6, 'H': 12, 'M': 6}","{'Y': 6, 'A': 6, 'B': 3, 'D': 3, 'E': 3, 'G': 6, 'I': 3, 'K': 6, 'L': 3, 'N': 3, 'O': 3, 'U': 6, 'V': 3, 'W': 3, 'X': 3}"
INV-ZZ-6927237,SCH-ZZ-6036812,ZZ,ZZ20240513DELAMD2167.0,2167.0,Boeing 717,05/13/2024,2024-05-13 23:11:00,2024-05-14 00:42:00,DEL,AMD,100.0,118,66,-34,52,10,20,30,40,11,6,4,5,24,13,7,11,35,20,10,15,47,26,14,21,"{'F': 6, 'P': 4}","{'C': 8, 'J': 6, 'Z': 6}","{'Q': 9, 'R': 6, 'S': 3, 'T': 3, 'H': 6, 'M': 3}","{'Y': 3, 'A': 3, 'B': 2, 'D': 2, 'E': 2, 'G': 3, 'I': 2, 'K': 3, 'L': 2, 'N': 2, 'O': 2, 'U': 3, 'V': 2, 'W': 2, 'X': 2}"
INV-ZZ-7249945,SCH-ZZ-6036812,ZZ,ZZ20240516DELAMD2167.0,2167.0,Boeing 717,05/16/2024,2024-05-16 23:11:00,2024-05-17 00:42:00,DEL,AMD,100.0,111,59,-41,52,10,20,30,40,12,6,4,6,23,12,8,11,33,18,12,15,46,25,15,21,"{'F': 6, 'P': 4}","{'C': 8, 'J': 6, 'Z': 6}","{'Q': 9, 'R': 6, 'S': 3, 'T': 3, 'H': 6, 'M': 3}","{'Y': 3, 'A': 3, 'B': 2, 'D': 2, 'E': 2, 'G': 3, 'I': 2, 'K': 3, 'L': 2, 'N': 2, 'O': 2, 'U': 3, 'V': 2, 'W': 2, 'X': 2}"
INV-ZZ-5855237,SCH-ZZ-6036812,ZZ,ZZ20240517DELAMD2167.0,2167.0,Boeing 717,05/17/2024,2024-05-17 23:11:00,2024-05-18 00:42:00,DEL,AMD,100.0,118,56,-44,62,10,20,30,40,12,6,4,6,22,10,10,12,36,17,13,19,45,21,19,24,"{'F': 6, 'P': 4}","{'C': 8, 'J': 6, 'Z': 6}","{'Q': 9, 'R': 6, 'S': 3, 'T': 3, 'H': 6, 'M': 3}","{'Y': 3, 'A': 3, 'B': 2, 'D': 2, 'E': 2, 'G': 3, 'I': 2, 'K': 3, 'L': 2, 'N': 2, 'O': 2, 'U': 3, 'V': 2, 'W': 2, 'X': 2}"
INV-ZZ-4950060,SCH-ZZ-6036812,ZZ,ZZ20240520DELAMD2167.0,2167.0,Boeing 717,05/20/2024,2024-05-20 23:11:00,2024-05-21 00:42:00,DEL,AMD,100.0,111,57,-43,54,10,20,30,40,12,6,4,6,24,12,8,12,34,17,13,17,46,24,16,22,"{'F': 6, 'P': 4}","{'C': 8, 'J': 6, 'Z': 6}","{'Q': 9, 'R': 6, 'S': 3, 'T': 3, 'H': 6, 'M': 3}","{'Y': 3, 'A': 3, 'B': 2, 'D': 2, 'E': 2, 'G': 3, 'I': 2, 'K': 3, 'L': 2, 'N': 2, 'O': 2, 'U': 3, 'V': 2, 'W': 2, 'X': 2}"
INV-ZZ-2898003,SCH-ZZ-6036812,ZZ,ZZ20240523DELAMD2167.0,2167.0,Boeing 717,05/23/2024,2024-05-23 23:11:00,2024-05-24 00:42:00,DEL,AMD,100.0,111,58,-42,54,10,20,30,40,11,6,4,5,22,11,9,11,33,17,13,16,47,24,16,23,"{'F': 6, 'P': 4}","{'C': 8, 'J': 6, 'Z': 6}","{'Q': 9, 'R': 6, 'S': 3, 'T': 3, 'H': 6, 'M': 3}","{'Y': 3, 'A': 3, 'B': 2, 'D': 2, 'E': 2, 'G': 3, 'I': 2, 'K': 3, 'L': 2, 'N': 2, 'O': 2, 'U': 3, 'V': 2, 'W': 2, 'X': 2}"
INV-ZZ-3943192,SCH-ZZ-6036812,ZZ,ZZ20240524DELAMD2167.0,2167.0,Boeing 717,05/24/2024,2024-05-24 23:11:00,2024-05-25 00:42:00,DEL,AMD,100.0,113,54,-46,59,10,20,30,40,12,6,4,6,23,11,9,12,34,16,14,18,47,23,17,24,"{'F': 6, 'P': 4}","{'C': 8, 'J': 6, 'Z': 6}","{'Q': 9, 'R': 6, 'S': 3, 'T': 3, 'H': 6, 'M': 3}","{'Y': 3, 'A': 3, 'B': 2, 'D': 2, 'E': 2, 'G': 3, 'I': 2, 'K': 3, 'L': 2, 'N': 2, 'O': 2, 'U': 3, 'V': 2, 'W': 2, 'X': 2}"
INV-ZZ-4175343,SCH-ZZ-6036812,ZZ,ZZ20240527DELAMD2167.0,2167.0,Boeing 717,05/27/2024,2024-05-27 23:11:00,2024-05-28 00:42:00,DEL,AMD,100.0,117,55,-45,62,10,20,30,40,12,6,4,6,24,11,9,13,35,16,14,19,46,22,18,24,"{'F': 6, 'P': 4}","{'C': 8, 'J': 6, 'Z': 6}","{'Q': 9, 'R': 6, 'S': 3, 'T': 3, 'H': 6, 'M': 3}","{'Y': 3, 'A': 3, 'B': 2, 'D': 2, 'E': 2, 'G': 3, 'I': 2, 'K': 3, 'L': 2, 'N': 2, 'O': 2, 'U': 3, 'V': 2, 'W': 2, 'X': 2}"
INV-ZZ-9702935,SCH-ZZ-6036812,ZZ,ZZ20240530DELAMD2167.0,2167.0,Boeing 717,05/30/2024,2024-05-30 23:11:00,2024-05-31 00:42:00,DEL,AMD,100.0,112,53,-47,59,10,20,30,40,11,5,5,6,23,11,9,12,33,16,14,17,45,21,19,24,"{'F': 6, 'P': 4}","{'C': 8, 'J': 6, 'Z': 6}","{'Q': 9, 'R': 6, 'S': 3, 'T': 3, 'H': 6, 'M': 3}","{'Y': 3, 'A': 3, 'B': 2, 'D': 2, 'E': 2, 'G': 3, 'I': 2, 'K': 3, 'L': 2, 'N': 2, 'O': 2, 'U': 3, 'V': 2, 'W': 2, 'X': 2}"
INV-ZZ-9430442,SCH-ZZ-6036812,ZZ,ZZ20240531DELAMD2167.0,2167.0,Boeing 717,05/31/2024,2024-05-31 23:11:00,2024-06-01 00:42:00,DEL,AMD,100.0,119,60,-40,59,10,20,30,40,11,6,4,5,24,12,8,12,36,18,12,18,46,23,17,23,"{'F': 6, 'P': 4}","{'C': 8, 'J': 6, 'Z': 6}","{'Q': 9, 'R': 6, 'S': 3, 'T': 3, 'H': 6, 'M': 3}","{'Y': 3, 'A': 3, 'B': 2, 'D': 2, 'E': 2, 'G': 3, 'I': 2, 'K': 3, 'L': 2, 'N': 2, 'O': 2, 'U': 3, 'V': 2, 'W': 2, 'X': 2}"
INV-ZZ-3369566,SCH-ZZ-6036812,ZZ,ZZ20240603DELAMD2167.0,2167.0,Boeing 717,06/03/2024,2024-06-03 23:11:00,2024-06-04 00:42:00,DEL,AMD,100.0,110,50,-50,60,10,20,30,40,12,5,5,7,24,11,9,13,35,16,14,19,45,21,19,24,"{'F': 6, 'P': 4}","{'C': 8, 'J': 6, 'Z': 6}","{'Q': 9, 'R': 6, 'S': 3, 'T': 3, 'H': 6, 'M': 3}","{'Y': 3, 'A': 3, 'B': 2, 'D': 2, 'E': 2, 'G': 3, 'I': 2, 'K': 3, 'L': 2, 'N': 2, 'O': 2, 'U': 3, 'V': 2, 'W': 2, 'X': 2}"
INV-ZZ-3520896,SCH-ZZ-6036812,ZZ,ZZ20240606DELAMD2167.0,2167.0,Boeing 717,06/06/2024,2024-06-06 23:11:00,2024-06-07 00:42:00,DEL,AMD,100.0,113,49,-51,64,10,20,30,40,11,5,5,6,24,10,10,14,34,15,15,19,45,20,20,25,"{'F': 6, 'P': 4}","{'C': 8, 'J': 6, 'Z': 6}","{'Q': 9, 'R': 6, 'S': 3, 'T': 3, 'H': 6, 'M': 3}","{'Y': 3, 'A': 3, 'B': 2, 'D': 2, 'E': 2, 'G': 3, 'I': 2, 'K': 3, 'L': 2, 'N': 2, 'O': 2, 'U': 3, 'V': 2, 'W': 2, 'X': 2}"
INV-ZZ-8614368,SCH-ZZ-6036812,ZZ,ZZ20240607DELAMD2167.0,2167.0,Boeing 717,06/07/2024,2024-06-07 23:11:00,2024-06-08 00:42:00,DEL,AMD,100.0,112,50,-50,62,10,20,30,40,12,5,5,7,24,11,9,13,35,15,15,20,45,20,20,25,"{'F': 6, 'P': 4}","{'C': 8, 'J': 6, 'Z': 6}","{'Q': 9, 'R': 6, 'S': 3, 'T': 3, 'H': 6, 'M': 3}","{'Y': 3, 'A': 3, 'B': 2, 'D': 2, 'E': 2, 'G': 3, 'I': 2, 'K': 3, 'L': 2, 'N': 2, 'O': 2, 'U': 3, 'V': 2, 'W': 2, 'X': 2}"
INV-ZZ-4793029,SCH-ZZ-6036812,ZZ,ZZ20240610DELAMD2167.0,2167.0,Boeing 717,06/10/2024,2024-06-10 23:11:00,2024-06-11 00:42:00,DEL,AMD,100.0,113,53,-47,60,10,20,30,40,11,5,5,6,24,11,9,13,34,16,14,18,44,21,19,23,"{'F': 6, 'P': 4}","{'C': 8, 'J': 6, 'Z': 6}","{'Q': 9, 'R': 6, 'S': 3, 'T': 3, 'H': 6, 'M': 3}","{'Y': 3, 'A': 3, 'B': 2, 'D': 2, 'E': 2, 'G': 3, 'I': 2, 'K': 3, 'L': 2, 'N': 2, 'O': 2, 'U': 3, 'V': 2, 'W': 2, 'X': 2}"
INV-ZZ-5273775,SCH-ZZ-6036812,ZZ,ZZ20240613DELAMD2167.0,2167.0,Boeing 717,06/13/2024,2024-06-13 23:11:00,2024-06-14 00:42:00,DEL,AMD,100.0,114,53,-47,61,10,20,30,40,11,5,5,6,24,11,9,13,35,16,14,19,45,21,19,24,"{'F': 6, 'P': 4}","{'C': 8, 'J': 6, 'Z': 6}","{'Q': 9, 'R': 6, 'S': 3, 'T': 3, 'H': 6, 'M': 3}","{'Y': 3, 'A': 3, 'B': 2, 'D': 2, 'E': 2, 'G': 3, 'I': 2, 'K': 3, 'L': 2, 'N': 2, 'O': 2, 'U': 3, 'V': 2, 'W': 2, 'X': 2}"
INV-ZZ-2270538,SCH-ZZ-6036812,ZZ,ZZ20240614DELAMD2167.0,2167.0,Boeing 717,06/14/2024,2024-06-14 23:11:00,2024-06-15 00:42:00,DEL,AMD,100.0,115,52,-48,63,10,20,30,40,12,5,5,7,23,10,10,13,33,15,15,18,44,20,20,24,"{'F': 6, 'P': 4}","{'C': 8, 'J': 6, 'Z': 6}","{'Q': 9, 'R': 6, 'S': 3, 'T': 3, 'H': 6, 'M': 3}","{'Y': 3, 'A': 3, 'B': 2, 'D': 2, 'E': 2, 'G': 3, 'I': 2, 'K': 3, 'L': 2, 'N': 2, 'O': 2, 'U': 3, 'V': 2, 'W': 2, 'X': 2}"
INV-ZZ-7526675,SCH-ZZ-6036812,ZZ,ZZ20240617DELAMD2167.0,2167.0,Boeing 717,06/17/2024,2024-06-17 23:11:00,2024-06-18 00:42:00,DEL,AMD,100.0,115,52,-48,63,10,20,30,40,12,5,5,7,22,10,10,12,33,15,15,18,46,21,19,25,"{'F': 6, 'P': 4}","{'C': 8, 'J': 6, 'Z': 6}","{'Q': 9, 'R': 6, 'S': 3, 'T': 3, 'H': 6, 'M': 3}","{'Y': 3, 'A': 3, 'B': 2, 'D': 2, 'E': 2, 'G': 3, 'I': 2, 'K': 3, 'L': 2, 'N': 2, 'O': 2, 'U': 3, 'V': 2, 'W': 2, 'X': 2}"
INV-ZZ-4970407,SCH-ZZ-6036812,ZZ,ZZ20240620DELAMD2167.0,2167.0,Boeing 717,06/20/2024,2024-06-20 23:11:00,2024-06-21 00:42:00,DEL,AMD,100.0,115,48,-52,67,10,20,30,40,11,5,5,6,23,10,10,13,33,14,16,19,47,20,20,27,"{'F': 6, 'P': 4}","{'C': 8, 'J': 6, 'Z': 6}","{'Q': 9, 'R': 6, 'S': 3, 'T': 3, 'H': 6, 'M': 3}","{'Y': 3, 'A': 3, 'B': 2, 'D': 2, 'E': 2, 'G': 3, 'I': 2, 'K': 3, 'L': 2, 'N': 2, 'O': 2, 'U': 3, 'V': 2, 'W': 2, 'X': 2}"
INV-ZZ-4849275,SCH-ZZ-6036812,ZZ,ZZ20240621DELAMD2167.0,2167.0,Boeing 717,06/21/2024,2024-06-21 23:11:00,2024-06-22 00:42:00,DEL,AMD,100.0,117,49,-51,68,10,20,30,40,11,5,5,6,24,10,10,14,36,15,15,21,45,19,21,26,"{'F': 6, 'P': 4}","{'C': 8, 'J': 6, 'Z': 6}","{'Q': 9, 'R': 6, 'S': 3, 'T': 3, 'H': 6, 'M': 3}","{'Y': 3, 'A': 3, 'B': 2, 'D': 2, 'E': 2, 'G': 3, 'I': 2, 'K': 3, 'L': 2, 'N': 2, 'O': 2, 'U': 3, 'V': 2, 'W': 2, 'X': 2}"
INV-ZZ-1050287,SCH-ZZ-6036812,ZZ,ZZ20240624DELAMD2167.0,2167.0,Boeing 717,06/24/2024,2024-06-24 23:11:00,2024-06-25 00:42:00,DEL,AMD,100.0,114,48,-52,66,10,20,30,40,12,5,5,7,23,10,10,13,34,14,16,20,46,19,21,27,"{'F': 6, 'P': 4}","{'C': 8, 'J': 6, 'Z': 6}","{'Q': 9, 'R': 6, 'S': 3, 'T': 3, 'H': 6, 'M': 3}","{'Y': 3, 'A': 3, 'B': 2, 'D': 2, 'E': 2, 'G': 3, 'I': 2, 'K': 3, 'L': 2, 'N': 2, 'O': 2, 'U': 3, 'V': 2, 'W': 2, 'X': 2}"
INV-ZZ-8981364,SCH-ZZ-6036812,ZZ,ZZ20240627DELAMD2167.0,2167.0,Boeing 717,06/27/2024,2024-06-27 23:11:00,2024-06-28 00:42:00,DEL,AMD,100.0,112,45,-55,67,10,20,30,40,12,5,5,7,23,9,11,14,33,13,17,20,46,19,21,27,"{'F': 6, 'P': 4}","{'C': 8, 'J': 6, 'Z': 6}","{'Q': 9, 'R': 6, 'S': 3, 'T': 3, 'H': 6, 'M': 3}","{'Y': 3, 'A': 3, 'B': 2, 'D': 2, 'E': 2, 'G': 3, 'I': 2, 'K': 3, 'L': 2, 'N': 2, 'O': 2, 'U': 3, 'V': 2, 'W': 2, 'X': 2}"
INV-ZZ-6519240,SCH-ZZ-8346723,ZZ,ZZ20240417BLRHYD3027.0,3027.0,BAe 146,04/17/2024,2024-04-17 18:48:00,2024-04-18 02:58:00,BLR,HYD,91.0,102,60,-31,42,9,18,27,36,11,6,3,5,21,12,6,9,31,18,9,13,43,25,11,18,"{'F': 5, 'P': 4}","{'C': 7, 'J': 5, 'Z': 5}","{'Q': 8, 'R': 5, 'S': 3, 'T': 3, 'H': 5, 'M': 3}","{'Y': 3, 'A': 3, 'B': 1, 'D': 1, 'E': 1, 'G': 3, 'I': 1, 'K': 3, 'L': 1, 'N': 1, 'O': 1, 'U': 3, 'V': 1, 'W': 1, 'X': 1}"
INV-ZZ-6268317,SCH-ZZ-8346723,ZZ,ZZ20240418BLRHYD3027.0,3027.0,BAe 146,04/18/2024,2024-04-18 18:48:00,2024-04-19 02:58:00,BLR,HYD,91.0,101,63,-28,38,9,18,27,36,10,6,3,4,20,13,5,7,31,19,8,12,43,27,9,16,"{'F': 5, 'P': 4}","{'C': 7, 'J': 5, 'Z': 5}","{'Q': 8, 'R': 5, 'S': 3, 'T': 3, 'H': 5, 'M': 3}","{'Y': 3, 'A': 3, 'B': 1, 'D': 1, 'E': 1, 'G': 3, 'I': 1, 'K': 3, 'L': 1, 'N': 1, 'O': 1, 'U': 3, 'V': 1, 'W': 1, 'X': 1}"
INV-ZZ-1078045,SCH-ZZ-8346723,ZZ,ZZ20240419BLRHYD3027.0,3027.0,BAe 146,04/19/2024,2024-04-19 18:48:00,2024-04-20 02:58:00,BLR,HYD,91.0,106,60,-31,46,9,18,27,36,10,6,3,4,21,12,6,9,31,17,10,14,41,23,13,18,"{'F': 5, 'P': 4}","{'C': 7, 'J': 5, 'Z': 5}","{'Q': 8, 'R': 5, 'S': 3, 'T': 3, 'H': 5, 'M': 3}","{'Y': 3, 'A': 3, 'B': 1, 'D': 1, 'E': 1, 'G': 3, 'I': 1, 'K': 3, 'L': 1, 'N': 1, 'O': 1, 'U': 3, 'V': 1, 'W': 1, 'X': 1}"
INV-ZZ-3057117,SCH-ZZ-8346723,ZZ,ZZ20240424BLRHYD3027.0,3027.0,BAe 146,04/24/2024,2024-04-24 18:48:00,2024-04-25 02:58:00,BLR,HYD,91.0,107,60,-31,47,9,18,27,36,11,6,3,5,22,12,6,10,32,18,9,14,42,24,12,18,"{'F': 5, 'P': 4}","{'C': 7, 'J': 5, 'Z': 5}","{'Q': 8, 'R': 5, 'S': 3, 'T': 3, 'H': 5, 'M': 3}","{'Y': 3, 'A': 3, 'B': 1, 'D': 1, 'E': 1, 'G': 3, 'I': 1, 'K': 3, 'L': 1, 'N': 1, 'O': 1, 'U': 3, 'V': 1, 'W': 1, 'X': 1}"
INV-ZZ-2798091,SCH-ZZ-8346723,ZZ,ZZ20240425BLRHYD3027.0,3027.0,BAe 146,04/25/2024,2024-04-25 18:48:00,2024-04-26 02:58:00,BLR,HYD,91.0,100,53,-38,47,9,18,27,36,10,5,4,5,21,11,7,10,32,17,10,15,43,23,13,20,"{'F': 5, 'P': 4}","{'C': 7, 'J': 5, 'Z': 5}","{'Q': 8, 'R': 5, 'S': 3, 'T': 3, 'H': 5, 'M': 3}","{'Y': 3, 'A': 3, 'B': 1, 'D': 1, 'E': 1, 'G': 3, 'I': 1, 'K': 3, 'L': 1, 'N': 1, 'O': 1, 'U': 3, 'V': 1, 'W': 1, 'X': 1}"
INV-ZZ-9324665,SCH-ZZ-8346723,ZZ,ZZ20240426BLRHYD3027.0,3027.0,BAe 146,04/26/2024,2024-04-26 18:48:00,2024-04-27 02:58:00,BLR,HYD,91.0,103,59,-32,44,9,18,27,36,10,6,3,4,20,11,7,9,32,18,9,14,40,23,13,17,"{'F': 5, 'P': 4}","{'C': 7, 'J': 5, 'Z': 5}","{'Q': 8, 'R': 5, 'S': 3, 'T': 3, 'H': 5, 'M': 3}","{'Y': 3, 'A': 3, 'B': 1, 'D': 1, 'E': 1, 'G': 3, 'I': 1, 'K': 3, 'L': 1, 'N': 1, 'O': 1, 'U': 3, 'V': 1, 'W': 1, 'X': 1}"
INV-ZZ-2960204,SCH-ZZ-8346723,ZZ,ZZ20240501BLRHYD3027.0,3027.0,BAe 146,05/01/2024,2024-05-01 18:48:00,2024-05-02 02:58:00,BLR,HYD,91.0,108,58,-34,50,9,18,27,36,10,5,4,5,20,11,7,9,31,17,10,14,41,22,14,19,"{'F': 5, 'P': 4}","{'C': 7, 'J': 5, 'Z': 5}","{'Q': 8, 'R': 5, 'S': 3, 'T': 3, 'H': 5, 'M': 3}","{'Y': 3, 'A': 3, 'B': 1, 'D': 1, 'E': 1, 'G': 3, 'I': 1, 'K': 3, 'L': 1, 'N': 1, 'O': 1, 'U': 3, 'V': 1, 'W': 1, 'X': 1}"
INV-ZZ-8230417,SCH-ZZ-8346723,ZZ,ZZ20240502BLRHYD3027.0,3027.0,BAe 146,05/02/2024,2024-05-02 18:48:00,2024-05-03 02:58:00,BLR,HYD,91.0,107,57,-34,50,9,18,27,36,10,5,4,5,20,11,7,9,32,17,10,15,43,23,13,20,"{'F': 5, 'P': 4}","{'C': 7, 'J': 5, 'Z': 5}","{'Q': 8, 'R': 5, 'S': 3, 'T': 3, 'H': 5, 'M': 3}","{'Y': 3, 'A': 3, 'B': 1, 'D': 1, 'E': 1, 'G': 3, 'I': 1, 'K': 3, 'L': 1, 'N': 1, 'O': 1, 'U': 3, 'V': 1, 'W': 1, 'X': 1}"
INV-ZZ-6020989,SCH-ZZ-8346723,ZZ,ZZ20240503BLRHYD3027.0,3027.0,BAe 146,05/03/2024,2024-05-03 18:48:00,2024-05-04 02:58:00,BLR,HYD,91.0,105,61,-30,44,9,18,27,36,10,6,3,4,20,12,6,8,31,18,9,13,41,24,12,17,"{'F': 5, 'P': 4}","{'C': 7, 'J': 5, 'Z': 5}","{'Q': 8, 'R': 5, 'S': 3, 'T': 3, 'H': 5, 'M': 3}","{'Y': 3, 'A': 3, 'B': 1, 'D': 1, 'E': 1, 'G': 3, 'I': 1, 'K': 3, 'L': 1, 'N': 1, 'O': 1, 'U': 3, 'V': 1, 'W': 1, 'X': 1}"
INV-ZZ-8076572,SCH-ZZ-8346723,ZZ,ZZ20240508BLRHYD3027.0,3027.0,BAe 146,05/08/2024,2024-05-08 18:48:00,2024-05-09 02:58:00,BLR,HYD,91.0,105,57,-34,48,9,18,27,36,10,5,4,5,20,11,7,9,31,17,10,14,43,23,13,20,"{'F': 5, 'P': 4}","{'C': 7, 'J': 5, 'Z': 5}","{'Q': 8, 'R': 5, 'S': 3, 'T': 3, 'H': 5, 'M': 3}","{'Y': 3, 'A': 3, 'B': 1, 'D': 1, 'E': 1, 'G': 3, 'I': 1, 'K': 3, 'L': 1, 'N': 1, 'O': 1, 'U': 3, 'V': 1, 'W': 1, 'X': 1}"
INV-ZZ-4625808,SCH-ZZ-8346723,ZZ,ZZ20240509BLRHYD3027.0,3027.0,BAe 146,05/09/2024,2024-05-09 18:48:00,2024-05-10 02:58:00,BLR,HYD,91.0,106,54,-37,52,9,18,27,36,10,5,4,5,21,11,7,10,32,16,11,16,42,21,15,21,"{'F': 5, 'P': 4}","{'C': 7, 'J': 5, 'Z': 5}","{'Q': 8, 'R': 5, 'S': 3, 'T': 3, 'H': 5, 'M': 3}","{'Y': 3, 'A': 3, 'B': 1, 'D': 1, 'E': 1, 'G': 3, 'I': 1, 'K': 3, 'L': 1, 'N': 1, 'O': 1, 'U': 3, 'V': 1, 'W': 1, 'X': 1}"
INV-ZZ-6914909,SCH-ZZ-8346723,ZZ,ZZ20240510BLRHYD3027.0,3027.0,BAe 146,05/10/2024,2024-05-10 18:48:00,2024-05-11 02:58:00,BLR,HYD,91.0,107,56,-35,51,9,18,27,36,11,6,3,5,21,11,7,10,30,16,11,14,43,22,14,21,"{'F': 5, 'P': 4}","{'C': 7, 'J': 5, 'Z': 5}","{'Q': 8, 'R': 5, 'S': 3, 'T': 3, 'H': 5, 'M': 3}","{'Y': 3, 'A': 3, 'B': 1, 'D': 1, 'E': 1, 'G': 3, 'I': 1, 'K': 3, 'L': 1, 'N': 1, 'O': 1, 'U': 3, 'V': 1, 'W': 1, 'X': 1}"
INV-ZZ-6253561,SCH-ZZ-8346723,ZZ,ZZ20240515BLRHYD3027.0,3027.0,BAe 146,05/15/2024,2024-05-15 18:48:00,2024-05-16 02:58:00,BLR,HYD,91.0,107,60,-31,47,9,18,27,36,10,6,3,4,21,12,6,9,32,18,9,14,41,23,13,18,"{'F': 5, 'P': 4}","{'C': 7, 'J': 5, 'Z': 5}","{'Q': 8, 'R': 5, 'S': 3, 'T': 3, 'H': 5, 'M': 3}","{'Y': 3, 'A': 3, 'B': 1, 'D': 1, 'E': 1, 'G': 3, 'I': 1, 'K': 3, 'L': 1, 'N': 1, 'O': 1, 'U': 3, 'V': 1, 'W': 1, 'X': 1}"
INV-ZZ-3044078,SCH-ZZ-8346723,ZZ,ZZ20240516BLRHYD3027.0,3027.0,BAe 146,05/16/2024,2024-05-16 18:48:00,2024-05-17 02:58:00,BLR,HYD,91.0,106,55,-36,51,9,18,27,36,10,5,4,5,20,10,8,10,31,16,11,15,40,21,15,19,"{'F': 5, 'P': 4}","{'C': 7, 'J': 5, 'Z': 5}","{'Q': 8, 'R': 5, 'S': 3, 'T': 3, 'H': 5, 'M': 3}","{'Y': 3, 'A': 3, 'B': 1, 'D': 1, 'E': 1, 'G': 3, 'I': 1, 'K': 3, 'L': 1, 'N': 1, 'O': 1, 'U': 3, 'V': 1, 'W': 1, 'X': 1}"
INV-ZZ-4758929,SCH-ZZ-8346723,ZZ,ZZ20240517BLRHYD3027.0,3027.0,BAe 146,05/17/2024,2024-05-17 18:48:00,2024-05-18 02:58:00,BLR,HYD,91.0,107,52,-39,55,9,18,27,36,10,5,4,5,20,10,8,10,31,15,12,16,43,21,15,22,"{'F': 5, 'P': 4}","{'C': 7, 'J': 5, 'Z': 5}","{'Q': 8, 'R': 5, 'S': 3, 'T': 3, 'H': 5, 'M': 3}","{'Y': 3, 'A': 3, 'B': 1, 'D': 1, 'E': 1, 'G': 3, 'I': 1, 'K': 3, 'L': 1, 'N': 1, 'O': 1, 'U': 3, 'V': 1, 'W': 1, 'X': 1}"
INV-ZZ-5742444,SCH-ZZ-8346723,ZZ,ZZ20240522BLRHYD3027.0,3027.0,BAe 146,05/22/2024,2024-05-22 18:48:00,2024-05-23 02:58:00,BLR,HYD,91.0,104,51,-40,53,9,18,27,36,10,5,4,5,21,10,8,11,31,15,12,16,41,20,16,21,"{'F': 5, 'P': 4}","{'C': 7, 'J': 5, 'Z': 5}","{'Q': 8, 'R': 5, 'S': 3, 'T': 3, 'H': 5, 'M': 3}","{'Y': 3, 'A': 3, 'B': 1, 'D': 1, 'E': 1, 'G': 3, 'I': 1, 'K': 3, 'L': 1, 'N': 1, 'O': 1, 'U': 3, 'V': 1, 'W': 1, 'X': 1}"
INV-ZZ-4541543,SCH-ZZ-8346723,ZZ,ZZ20240523BLRHYD3027.0,3027.0,BAe 146,05/23/2024,2024-05-23 18:48:00,2024-05-24 02:58:00,BLR,HYD,91.0,100,47,-44,53,9,18,27,36,10,5,4,5,21,10,8,11,32,15,12,17,42,20,16,22,"{'F': 5, 'P': 4}","{'C': 7, 'J': 5, 'Z': 5}","{'Q': 8, 'R': 5, 'S': 3, 'T': 3, 'H': 5, 'M': 3}","{'Y': 3, 'A': 3, 'B': 1, 'D': 1, 'E': 1, 'G': 3, 'I': 1, 'K': 3, 'L': 1, 'N': 1, 'O': 1, 'U': 3, 'V': 1, 'W': 1, 'X': 1}"
INV-ZZ-7541312,SCH-ZZ-8346723,ZZ,ZZ20240524BLRHYD3027.0,3027.0,BAe 146,05/24/2024,2024-05-24 18:48:00,2024-05-25 02:58:00,BLR,HYD,91.0,106,49,-42,57,9,18,27,36,11,5,4,6,20,9,9,11,31,14,13,17,43,20,16,23,"{'F': 5, 'P': 4}","{'C': 7, 'J': 5, 'Z': 5}","{'Q': 8, 'R': 5, 'S': 3, 'T': 3, 'H': 5, 'M': 3}","{'Y': 3, 'A': 3, 'B': 1, 'D': 1, 'E': 1, 'G': 3, 'I': 1, 'K': 3, 'L': 1, 'N': 1, 'O': 1, 'U': 3, 'V': 1, 'W': 1, 'X': 1}"
INV-ZZ-3758978,SCH-ZZ-8346723,ZZ,ZZ20240529BLRHYD3027.0,3027.0,BAe 146,05/29/2024,2024-05-29 18:48:00,2024-05-30 02:58:00,BLR,HYD,91.0,105,55,-36,50,9,18,27,36,10,5,4,5,22,12,6,10,32,17,10,15,40,21,15,19,"{'F': 5, 'P': 4}","{'C': 7, 'J': 5, 'Z': 5}","{'Q': 8, 'R': 5, 'S': 3, 'T': 3, 'H': 5, 'M': 3}","{'Y': 3, 'A': 3, 'B': 1, 'D': 1, 'E': 1, 'G': 3, 'I': 1, 'K': 3, 'L': 1, 'N': 1, 'O': 1, 'U': 3, 'V': 1, 'W': 1, 'X': 1}"
INV-ZZ-9399965,SCH-ZZ-8346723,ZZ,ZZ20240530BLRHYD3027.0,3027.0,BAe 146,05/30/2024,2024-05-30 18:48:00,2024-05-31 02:58:00,BLR,HYD,91.0,109,54,-37,55,9,18,27,36,10,5,4,5,21,10,8,11,30,15,12,15,43,21,15,22,"{'F': 5, 'P': 4}","{'C': 7, 'J': 5, 'Z': 5}","{'Q': 8, 'R': 5, 'S': 3, 'T': 3, 'H': 5, 'M': 3}","{'Y': 3, 'A': 3, 'B': 1, 'D': 1, 'E': 1, 'G': 3, 'I': 1, 'K': 3, 'L': 1, 'N': 1, 'O': 1, 'U': 3, 'V': 1, 'W': 1, 'X': 1}"
INV-ZZ-4666534,SCH-ZZ-8346723,ZZ,ZZ20240531BLRHYD3027.0,3027.0,BAe 146,05/31/2024,2024-05-31 18:48:00,2024-06-01 02:58:00,BLR,HYD,91.0,105,50,-41,55,9,18,27,36,10,5,4,5,20,10,8,10,32,15,12,17,43,21,15,22,"{'F': 5, 'P': 4}","{'C': 7, 'J': 5, 'Z': 5}","{'Q': 8, 'R': 5, 'S': 3, 'T': 3, 'H': 5, 'M': 3}","{'Y': 3, 'A': 3, 'B': 1, 'D': 1, 'E': 1, 'G': 3, 'I': 1, 'K': 3, 'L': 1, 'N': 1, 'O': 1, 'U': 3, 'V': 1, 'W': 1, 'X': 1}"
INV-ZZ-6984919,SCH-ZZ-9117133,ZZ,ZZ20240403BLRCCU2504.0,2504.0,Boeing 777,04/03/2024,2024-04-03 15:35:00,2024-04-03 18:17:00,BLR,CCU,425.0,481,295,-130,186,42,85,127,170,49,30,12,19,96,59,26,37,142,87,40,55,192,118,52,74,"{'F': 25, 'P': 17}","{'C': 34, 'J': 26, 'Z': 26}","{'Q': 38, 'R': 25, 'S': 13, 'T': 13, 'H': 25, 'M': 13}","{'Y': 13, 'A': 13, 'B': 6, 'D': 6, 'E': 6, 'G': 13, 'I': 6, 'K': 13, 'L': 6, 'N': 6, 'O': 6, 'U': 13, 'V': 6, 'W': 6, 'X': 6}"
INV-ZZ-8199494,SCH-ZZ-9117133,ZZ,ZZ20240404BLRCCU2504.0,2504.0,Boeing 777,04/04/2024,2024-04-04 15:35:00,2024-04-04 18:17:00,BLR,CCU,425.0,486,305,-120,181,42,85,127,170,47,29,13,18,98,61,24,37,142,89,38,53,201,126,44,75,"{'F': 25, 'P': 17}","{'C': 34, 'J': 26, 'Z': 26}","{'Q': 38, 'R': 25, 'S': 13, 'T': 13, 'H': 25, 'M': 13}","{'Y': 13, 'A': 13, 'B': 6, 'D': 6, 'E': 6, 'G': 13, 'I': 6, 'K': 13, 'L': 6, 'N': 6, 'O': 6, 'U': 13, 'V': 6, 'W': 6, 'X': 6}"
INV-ZZ-6107518,SCH-ZZ-9117133,ZZ,ZZ20240408BLRCCU2504.0,2504.0,Boeing 777,04/08/2024,2024-04-08 15:35:00,2024-04-08 18:17:00,BLR,CCU,425.0,492,318,-107,174,42,85,127,170,48,31,11,17,95,61,24,34,146,94,33,52,189,122,48,67,"{'F': 25, 'P': 17}","{'C': 34, 'J': 26, 'Z': 26}","{'Q': 38, 'R': 25, 'S': 13, 'T': 13, 'H': 25, 'M': 13}","{'Y': 13, 'A': 13, 'B': 6, 'D': 6, 'E': 6, 'G': 13, 'I': 6, 'K': 13, 'L': 6, 'N': 6, 'O': 6, 'U': 13, 'V': 6, 'W': 6, 'X': 6}"
INV-ZZ-1151782,SCH-ZZ-9117133,ZZ,ZZ20240409BLRCCU2504.0,2504.0,Boeing 777,04/09/2024,2024-04-09 15:35:00,2024-04-09 18:17:00,BLR,CCU,425.0,496,305,-120,191,42,85,127,170,46,28,14,18,100,62,23,38,141,87,40,54,192,118,52,74,"{'F': 25, 'P': 17}","{'C': 34, 'J': 26, 'Z': 26}","{'Q': 38, 'R': 25, 'S': 13, 'T': 13, 'H': 25, 'M': 13}","{'Y': 13, 'A': 13, 'B': 6, 'D': 6, 'E': 6, 'G': 13, 'I': 6, 'K': 13, 'L': 6, 'N': 6, 'O': 6, 'U': 13, 'V': 6, 'W': 6, 'X': 6}"
INV-ZZ-2312764,SCH-ZZ-9117133,ZZ,ZZ20240410BLRCCU2504.0,2504.0,Boeing 777,04/10/2024,2024-04-10 15:35:00,2024-04-10 18:17:00,BLR,CCU,425.0,504,298,-127,206,42,85,127,170,49,29,13,20,94,56,29,38,141,83,44,58,190,113,57,77,"{'F': 25, 'P': 17}","{'C': 34, 'J': 26, 'Z': 26}","{'Q': 38, 'R': 25, 'S': 13, 'T': 13, 'H': 25, 'M': 13}","{'Y': 13, 'A': 13, 'B': 6, 'D': 6, 'E': 6, 'G': 13, 'I': 6, 'K': 13, 'L': 6, 'N': 6, 'O': 6, 'U': 13, 'V': 6, 'W': 6, 'X': 6}"
INV-ZZ-3345831,SCH-ZZ-9117133,ZZ,ZZ20240411BLRCCU2504.0,2504.0,Boeing 777,04/11/2024,2024-04-11 15:35:00,2024-04-11 18:17:00,BLR,CCU,425.0,473,310,-115,163,42,85,127,170,49,32,10,17,97,64,21,33,151,99,28,52,197,129,41,68,"{'F': 25, 'P': 17}","{'C': 34, 'J': 26, 'Z': 26}","{'Q': 38, 'R': 25, 'S': 13, 'T': 13, 'H': 25, 'M': 13}","{'Y': 13, 'A': 13, 'B': 6, 'D': 6, 'E': 6, 'G': 13, 'I': 6, 'K': 13, 'L': 6, 'N': 6, 'O': 6, 'U': 13, 'V': 6, 'W': 6, 'X': 6}"
INV-ZZ-9897581,SCH-ZZ-9117133,ZZ,ZZ20240415BLRCCU2504.0,2504.0,Boeing 777,04/15/2024,2024-04-15 15:35:00,2024-04-15 18:17:00,BLR,CCU,425.0,476,278,-147,198,42,85,127,170,49,29,13,20,97,57,28,40,147,86,41,61,188,110,60,78,"{'F': 25, 'P': 17}","{'C': 34, 'J': 26, 'Z': 26}","{'Q': 38, 'R': 25, 'S': 13, 'T': 13, 'H': 25, 'M': 13}","{'Y': 13, 'A': 13, 'B': 6, 'D': 6, 'E': 6, 'G': 13, 'I': 6, 'K': 13, 'L': 6, 'N': 6, 'O': 6, 'U': 13, 'V': 6, 'W': 6, 'X': 6}"
INV-ZZ-2145247,SCH-ZZ-9117133,ZZ,ZZ20240416BLRCCU2504.0,2504.0,Boeing 777,04/16/2024,2024-04-16 15:35:00,2024-04-16 18:17:00,BLR,CCU,425.0,468,293,-132,175,42,85,127,170,47,29,13,18,94,59,26,35,143,90,37,53,202,126,44,76,"{'F': 25, 'P': 17}","{'C': 34, 'J': 26, 'Z': 26}","{'Q': 38, 'R': 25, 'S': 13, 'T': 13, 'H': 25, 'M': 13}","{'Y': 13, 'A': 13, 'B': 6, 'D': 6, 'E': 6, 'G': 13, 'I': 6, 'K': 13, 'L': 6, 'N': 6, 'O': 6, 'U': 13, 'V': 6, 'W': 6, 'X': 6}"
INV-ZZ-8537090,SCH-ZZ-9117133,ZZ,ZZ20240417BLRCCU2504.0,2504.0,Boeing 777,04/17/2024,2024-04-17 15:35:00,2024-04-17 18:17:00,BLR,CCU,425.0,497,287,-138,210,42,85,127,170,47,27,15,20,99,57,28,42,145,84,43,61,199,115,55,84,"{'F': 25, 'P': 17}","{'C': 34, 'J': 26, 'Z': 26}","{'Q': 38, 'R': 25, 'S': 13, 'T': 13, 'H': 25, 'M': 13}","{'Y': 13, 'A': 13, 'B': 6, 'D': 6, 'E': 6, 'G': 13, 'I': 6, 'K': 13, 'L': 6, 'N': 6, 'O': 6, 'U': 13, 'V': 6, 'W': 6, 'X': 6}"
INV-ZZ-9452188,SCH-ZZ-9117133,ZZ,ZZ20240418BLRCCU2504.0,2504.0,Boeing 777,04/18/2024,2024-04-18 15:35:00,2024-04-18 18:17:00,BLR,CCU,425.0,490,281,-144,209,42,85,127,170,48,27,15,21,100,57,28,43,140,80,47,60,201,115,55,86,"{'F': 25, 'P': 17}","{'C': 34, 'J': 26, 'Z': 26}","{'Q': 38, 'R': 25, 'S': 13, 'T': 13, 'H': 25, 'M': 13}","{'Y': 13, 'A': 13, 'B': 6, 'D': 6, 'E': 6, 'G': 13, 'I': 6, 'K': 13, 'L': 6, 'N': 6, 'O': 6, 'U': 13, 'V': 6, 'W': 6, 'X': 6}"
INV-ZZ-7992152,SCH-ZZ-9117133,ZZ,ZZ20240422BLRCCU2504.0,2504.0,Boeing 777,04/22/2024,2024-04-22 15:35:00,2024-04-22 18:17:00,BLR,CCU,425.0,491,265,-160,226,42,85,127,170,48,26,16,22,99,53,32,46,148,80,47,68,201,109,61,92,"{'F': 25, 'P': 17}","{'C': 34, 'J': 26, 'Z': 26}","{'Q': 38, 'R': 25, 'S': 13, 'T': 13, 'H': 25, 'M': 13}","{'Y': 13, 'A': 13, 'B': 6, 'D': 6, 'E': 6, 'G': 13, 'I': 6, 'K': 13, 'L': 6, 'N': 6, 'O': 6, 'U': 13, 'V': 6, 'W': 6, 'X': 6}"
INV-ZZ-3983574,SCH-ZZ-9117133,ZZ,ZZ20240423BLRCCU2504.0,2504.0,Boeing 777,04/23/2024,2024-04-23 15:35:00,2024-04-23 18:17:00,BLR,CCU,425.0,507,276,-149,231,42,85,127,170,50,27,15,23,102,55,30,47,150,82,45,68,197,107,63,90,"{'F': 25, 'P': 17}","{'C': 34, 'J': 26, 'Z': 26}","{'Q': 38, 'R': 25, 'S': 13, 'T': 13, 'H': 25, 'M': 13}","{'Y': 13, 'A': 13, 'B': 6, 'D': 6, 'E': 6, 'G': 13, 'I': 6, 'K': 13, 'L': 6, 'N': 6, 'O': 6, 'U': 13, 'V': 6, 'W': 6, 'X': 6}"
INV-ZZ-6235385,SCH-ZZ-9117133,ZZ,ZZ20240424BLRCCU2504.0,2504.0,Boeing 777,04/24/2024,2024-04-24 15:35:00,2024-04-24 18:17:00,BLR,CCU,425.0,470,258,-167,212,42,85,127,170,50,27,15,23,100,55,30,45,140,77,50,63,197,108,62,89,"{'F': 25, 'P': 17}","{'C': 34, 'J': 26, 'Z': 26}","{'Q': 38, 'R': 25, 'S': 13, 'T': 13, 'H': 25, 'M': 13}","{'Y': 13, 'A': 13, 'B': 6, 'D': 6, 'E': 6, 'G': 13, 'I': 6, 'K': 13, 'L': 6, 'N': 6, 'O': 6, 'U': 13, 'V': 6, 'W': 6, 'X': 6}"
INV-ZZ-7240010,SCH-ZZ-9117133,ZZ,ZZ20240425BLRCCU2504.0,2504.0,Boeing 777,04/25/2024,2024-04-25 15:35:00,2024-04-25 18:17:00,BLR,CCU,425.0,473,291,-134,182,42,85,127,170,50,31,11,19,96,59,26,37,146,90,37,56,200,123,47,77,"{'F': 25, 'P': 17}","{'C': 34, 'J': 26, 'Z': 26}","{'Q': 38, 'R': 25, 'S': 13, 'T': 13, 'H': 25, 'M': 13}","{'Y': 13, 'A': 13, 'B': 6, 'D': 6, 'E': 6, 'G': 13, 'I': 6, 'K': 13, 'L': 6, 'N': 6, 'O': 6, 'U': 13, 'V': 6, 'W': 6, 'X': 6}"
INV-ZZ-5234157,SCH-ZZ-9117133,ZZ,ZZ20240429BLRCCU2504.0,2504.0,Boeing 777,04/29/2024,2024-04-29 15:35:00,2024-04-29 18:17:00,BLR,CCU,425.0,473,249,-176,224,42,85,127,170,47,25,17,22,99,52,33,47,151,79,48,72,188,99,71,89,"{'F': 25, 'P': 17}","{'C': 34, 'J': 26, 'Z': 26}","{'Q': 38, 'R': 25, 'S': 13, 'T': 13, 'H': 25, 'M': 13}","{'Y': 13, 'A': 13, 'B': 6, 'D': 6, 'E': 6, 'G': 13, 'I': 6, 'K': 13, 'L': 6, 'N': 6, 'O': 6, 'U': 13, 'V': 6, 'W': 6, 'X': 6}"
INV-ZZ-3882771,SCH-ZZ-9117133,ZZ,ZZ20240430BLRCCU2504.0,2504.0,Boeing 777,04/30/2024,2024-04-30 15:35:00,2024-04-30 18:17:00,BLR,CCU,425.0,490,257,-168,233,42,85,127,170,48,25,17,23,97,51,34,46,141,74,53,67,193,101,69,92,"{'F': 25, 'P': 17}","{'C': 34, 'J': 26, 'Z': 26}","{'Q': 38, 'R': 25, 'S': 13, 'T': 13, 'H': 25, 'M': 13}","{'Y': 13, 'A': 13, 'B': 6, 'D': 6, 'E': 6, 'G': 13, 'I': 6, 'K': 13, 'L': 6, 'N': 6, 'O': 6, 'U': 13, 'V': 6, 'W': 6, 'X': 6}"
INV-ZZ-2580421,SCH-ZZ-9117133,ZZ,ZZ20240501BLRCCU2504.0,2504.0,Boeing 777,05/01/2024,2024-05-01 15:35:00,2024-05-01 18:17:00,BLR,CCU,425.0,490,256,-169,234,42,85,127,170,49,26,16,23,99,52,33,47,140,73,54,67,199,104,66,95,"{'F': 25, 'P': 17}","{'C': 34, 'J': 26, 'Z': 26}","{'Q': 38, 'R': 25, 'S': 13, 'T': 13, 'H': 25, 'M': 13}","{'Y': 13, 'A': 13, 'B': 6, 'D': 6, 'E': 6, 'G': 13, 'I': 6, 'K': 13, 'L': 6, 'N': 6, 'O': 6, 'U': 13, 'V': 6, 'W': 6, 'X': 6}"
INV-ZZ-5617329,SCH-ZZ-9117133,ZZ,ZZ20240502BLRCCU2504.0,2504.0,Boeing 777,05/02/2024,2024-05-02 15:35:00,2024-05-02 18:17:00,BLR,CCU,425.0,500,299,-126,201,42,85,127,170,48,29,13,19,96,57,28,39,140,84,43,56,200,120,50,80,"{'F': 25, 'P': 17}","{'C': 34, 'J': 26, 'Z': 26}","{'Q': 38, 'R': 25, 'S': 13, 'T': 13, 'H': 25, 'M': 13}","{'Y': 13, 'A': 13, 'B': 6, 'D': 6, 'E': 6, 'G': 13, 'I': 6, 'K': 13, 'L': 6, 'N': 6, 'O': 6, 'U': 13, 'V': 6, 'W': 6, 'X': 6}"
INV-ZZ-7461285,SCH-ZZ-9117133,ZZ,ZZ20240506BLRCCU2504.0,2504.0,Boeing 777,05/06/2024,2024-05-06 15:35:00,2024-05-06 18:17:00,BLR,CCU,425.0,507,273,-152,234,42,85,127,170,50,27,15,23,96,52,33,44,150,81,46,69,197,106,64,91,"{'F': 25, 'P': 17}","{'C': 34, 'J': 26, 'Z': 26}","{'Q': 38, 'R': 25, 'S': 13, 'T': 13, 'H': 25, 'M': 13}","{'Y': 13, 'A': 13, 'B': 6, 'D': 6, 'E': 6, 'G': 13, 'I': 6, 'K': 13, 'L': 6, 'N': 6, 'O': 6, 'U': 13, 'V': 6, 'W': 6, 'X': 6}"
INV-ZZ-8239384,SCH-ZZ-9117133,ZZ,ZZ20240507BLRCCU2504.0,2504.0,Boeing 777,05/07/2024,2024-05-07 15:35:00,2024-05-07 18:17:00,BLR,CCU,425.0,491,274,-151,217,42,85,127,170,47,26,16,21,98,55,30,43,144,80,47,64,197,110,60,87,"{'F': 25, 'P': 17}","{'C': 34, 'J': 26, 'Z': 26}","{'Q': 38, 'R': 25, 'S': 13, 'T': 13, 'H': 25, 'M': 13}","{'Y': 13, 'A': 13, 'B': 6, 'D': 6, 'E': 6, 'G': 13, 'I': 6, 'K': 13, 'L': 6, 'N': 6, 'O': 6, 'U': 13, 'V': 6, 'W': 6, 'X': 6}"
INV-ZZ-9772852,SCH-ZZ-9117133,ZZ,ZZ20240508BLRCCU2504.0,2504.0,Boeing 777,05/08/2024,2024-05-08 15:35:00,2024-05-08 18:17:00,BLR,CCU,425.0,501,259,-166,242,42,85,127,170,50,26,16,24,98,51,34,47,145,75,52,70,198,102,68,96,"{'F': 25, 'P': 17}","{'C': 34, 'J': 26, 'Z': 26}","{'Q': 38, 'R': 25, 'S': 13, 'T': 13, 'H': 25, 'M': 13}","{'Y': 13, 'A': 13, 'B': 6, 'D': 6, 'E': 6, 'G': 13, 'I': 6, 'K': 13, 'L': 6, 'N': 6, 'O': 6, 'U': 13, 'V': 6, 'W': 6, 'X': 6}"
INV-ZZ-6333236,SCH-ZZ-9117133,ZZ,ZZ20240509BLRCCU2504.0,2504.0,Boeing 777,05/09/2024,2024-05-09 15:35:00,2024-05-09 18:17:00,BLR,CCU,425.0,480,273,-152,207,42,85,127,170,47,27,15,20,95,54,31,41,150,85,42,65,199,113,57,86,"{'F': 25, 'P': 17}","{'C': 34, 'J': 26, 'Z': 26}","{'Q': 38, 'R': 25, 'S': 13, 'T': 13, 'H': 25, 'M': 13}","{'Y': 13, 'A': 13, 'B': 6, 'D': 6, 'E': 6, 'G': 13, 'I': 6, 'K': 13, 'L': 6, 'N': 6, 'O': 6, 'U': 13, 'V': 6, 'W': 6, 'X': 6}"
INV-ZZ-7565112,SCH-ZZ-9117133,ZZ,ZZ20240513BLRCCU2504.0,2504.0,Boeing 777,05/13/2024,2024-05-13 15:35:00,2024-05-13 18:17:00,BLR,CCU,425.0,507,254,-171,253,42,85,127,170,50,25,17,25,100,50,35,50,143,72,55,71,194,97,73,97,"{'F': 25, 'P': 17}","{'C': 34, 'J': 26, 'Z': 26}","{'Q': 38, 'R': 25, 'S': 13, 'T': 13, 'H': 25, 'M': 13}","{'Y': 13, 'A': 13, 'B': 6, 'D': 6, 'E': 6, 'G': 13, 'I': 6, 'K': 13, 'L': 6, 'N': 6, 'O': 6, 'U': 13, 'V': 6, 'W': 6, 'X': 6}"
INV-ZZ-2409735,SCH-ZZ-9117133,ZZ,ZZ20240514BLRCCU2504.0,2504.0,Boeing 777,05/14/2024,2024-05-14 15:35:00,2024-05-14 18:17:00,BLR,CCU,425.0,486,258,-167,228,42,85,127,170,48,25,17,23,99,53,32,46,145,77,50,68,203,108,62,95,"{'F': 25, 'P': 17}","{'C': 34, 'J': 26, 'Z': 26}","{'Q': 38, 'R': 25, 'S': 13, 'T': 13, 'H': 25, 'M': 13}","{'Y': 13, 'A': 13, 'B': 6, 'D': 6, 'E': 6, 'G': 13, 'I': 6, 'K': 13, 'L': 6, 'N': 6, 'O': 6, 'U': 13, 'V': 6, 'W': 6, 'X': 6}"
INV-ZZ-2325954,SCH-ZZ-9117133,ZZ,ZZ20240515BLRCCU2504.0,2504.0,Boeing 777,05/15/2024,2024-05-15 15:35:00,2024-05-15 18:17:00,BLR,CCU,425.0,469,253,-172,216,42,85,127,170,50,27,15,23,95,51,34,44,148,80,47,68,195,105,65,90,"{'F': 25, 'P': 17}","{'C': 34, 'J': 26, 'Z': 26}","{'Q': 38, 'R': 25, 'S': 13, 'T': 13, 'H': 25, 'M': 13}","{'Y': 13, 'A': 13, 'B': 6, 'D': 6, 'E': 6, 'G': 13, 'I': 6, 'K': 13, 'L': 6, 'N': 6, 'O': 6, 'U': 13, 'V': 6, 'W': 6, 'X': 6}"
INV-ZZ-4004890,SCH-ZZ-9117133,ZZ,ZZ20240516BLRCCU2504.0,2504.0,Boeing 777,05/16/2024,2024-05-16 15:35:00,2024-05-16 18:17:00,BLR,CCU,425.0,489,258,-167,231,42,85,127,170,49,26,16,23,102,54,31,48,147,78,49,69,199,105,65,94,"{'F': 25, 'P': 17}","{'C': 34, 'J': 26, 'Z': 26}","{'Q': 38, 'R': 25, 'S': 13, 'T': 13, 'H': 25, 'M': 13}","{'Y': 13, 'A': 13, 'B': 6, 'D': 6, 'E': 6, 'G': 13, 'I': 6, 'K': 13, 'L': 6, 'N': 6, 'O': 6, 'U': 13, 'V': 6, 'W': 6, 'X': 6}"
INV-ZZ-5095224,SCH-ZZ-9748991,ZZ,ZZ20240414MAABOM3117.0,3117.0,ATR 72,04/14/2024,2024-04-14 15:49:00,2024-04-14 21:43:00,MAA,BOM,72.0,81,49,-23,32,7,14,21,28,8,5,2,3,16,10,4,6,24,15,6,9,31,19,9,12,"{'F': 4, 'P': 3}","{'C': 6, 'J': 4, 'Z': 4}","{'Q': 6, 'R': 4, 'S': 2, 'T': 2, 'H': 4, 'M': 2}","{'Y': 2, 'A': 2, 'B': 1, 'D': 1, 'E': 1, 'G': 2, 'I': 1, 'K': 2, 'L': 1, 'N': 1, 'O': 1, 'U': 2, 'V': 1, 'W': 1, 'X': 1}"
INV-ZZ-2936293,SCH-ZZ-9748991,ZZ,ZZ20240416MAABOM3117.0,3117.0,ATR 72,04/16/2024,2024-04-16 15:49:00,2024-04-16 21:43:00,MAA,BOM,72.0,82,52,-20,30,7,14,21,28,8,5,2,3,16,10,4,6,24,15,6,9,33,21,7,12,"{'F': 4, 'P': 3}","{'C': 6, 'J': 4, 'Z': 4}","{'Q': 6, 'R': 4, 'S': 2, 'T': 2, 'H': 4, 'M': 2}","{'Y': 2, 'A': 2, 'B': 1, 'D': 1, 'E': 1, 'G': 2, 'I': 1, 'K': 2, 'L': 1, 'N': 1, 'O': 1, 'U': 2, 'V': 1, 'W': 1, 'X': 1}"
INV-ZZ-1274007,SCH-ZZ-9748991,ZZ,ZZ20240418MAABOM3117.0,3117.0,ATR 72,04/18/2024,2024-04-18 15:49:00,2024-04-18 21:43:00,MAA,BOM,72.0,80,46,-26,34,7,14,21,28,8,5,2,3,16,9,5,7,25,14,7,11,31,18,10,13,"{'F': 4, 'P': 3}","{'C': 6, 'J': 4, 'Z': 4}","{'Q': 6, 'R': 4, 'S': 2, 'T': 2, 'H': 4, 'M': 2}","{'Y': 2, 'A': 2, 'B': 1, 'D': 1, 'E': 1, 'G': 2, 'I': 1, 'K': 2, 'L': 1, 'N': 1, 'O': 1, 'U': 2, 'V': 1, 'W': 1, 'X': 1}"
INV-ZZ-4699908,SCH-ZZ-9748991,ZZ,ZZ20240421MAABOM3117.0,3117.0,ATR 72,04/21/2024,2024-04-21 15:49:00,2024-04-21 21:43:00,MAA,BOM,72.0,86,51,-21,35,7,14,21,28,8,5,2,3,16,9,5,7,24,14,7,10,32,19,9,13,"{'F': 4, 'P': 3}","{'C': 6, 'J': 4, 'Z': 4}","{'Q': 6, 'R': 4, 'S': 2, 'T': 2, 'H': 4, 'M': 2}","{'Y': 2, 'A': 2, 'B': 1, 'D': 1, 'E': 1, 'G': 2, 'I': 1, 'K': 2, 'L': 1, 'N': 1, 'O': 1, 'U': 2, 'V': 1, 'W': 1, 'X': 1}"
INV-ZZ-8136713,SCH-ZZ-9748991,ZZ,ZZ20240423MAABOM3117.0,3117.0,ATR 72,04/23/2024,2024-04-23 15:49:00,2024-04-23 21:43:00,MAA,BOM,72.0,81,50,-22,31,7,14,21,28,8,5,2,3,16,10,4,6,24,15,6,9,32,20,8,12,"{'F': 4, 'P': 3}","{'C': 6, 'J': 4, 'Z': 4}","{'Q': 6, 'R': 4, 'S': 2, 'T': 2, 'H': 4, 'M': 2}","{'Y': 2, 'A': 2, 'B': 1, 'D': 1, 'E': 1, 'G': 2, 'I': 1, 'K': 2, 'L': 1, 'N': 1, 'O': 1, 'U': 2, 'V': 1, 'W': 1, 'X': 1}"
INV-ZZ-3889333,SCH-ZZ-9748991,ZZ,ZZ20240425MAABOM3117.0,3117.0,ATR 72,04/25/2024,2024-04-25 15:49:00,2024-04-25 21:43:00,MAA,BOM,72.0,85,47,-25,38,7,14,21,28,8,4,3,4,15,8,6,7,25,14,7,11,32,18,10,14,"{'F': 4, 'P': 3}","{'C': 6, 'J': 4, 'Z': 4}","{'Q': 6, 'R': 4, 'S': 2, 'T': 2, 'H': 4, 'M': 2}","{'Y': 2, 'A': 2, 'B': 1, 'D': 1, 'E': 1, 'G': 2, 'I': 1, 'K': 2, 'L': 1, 'N': 1, 'O': 1, 'U': 2, 'V': 1, 'W': 1, 'X': 1}"
INV-ZZ-5493219,SCH-ZZ-9748991,ZZ,ZZ20240428MAABOM3117.0,3117.0,ATR 72,04/28/2024,2024-04-28 15:49:00,2024-04-28 21:43:00,MAA,BOM,72.0,85,46,-26,39,7,14,21,28,8,4,3,4,16,9,5,7,24,13,8,11,31,17,11,14,"{'F': 4, 'P': 3}","{'C': 6, 'J': 4, 'Z': 4}","{'Q': 6, 'R': 4, 'S': 2, 'T': 2, 'H': 4, 'M': 2}","{'Y': 2, 'A': 2, 'B': 1, 'D': 1, 'E': 1, 'G': 2, 'I': 1, 'K': 2, 'L': 1, 'N': 1, 'O': 1, 'U': 2, 'V': 1, 'W': 1, 'X': 1}"
INV-ZZ-5268263,SCH-ZZ-9748991,ZZ,ZZ20240430MAABOM3117.0,3117.0,ATR 72,04/30/2024,2024-04-30 15:49:00,2024-04-30 21:43:00,MAA,BOM,72.0,83,46,-26,37,7,14,21,28,8,4,3,4,16,9,5,7,25,14,7,11,31,17,11,14,"{'F': 4, 'P': 3}","{'C': 6, 'J': 4, 'Z': 4}","{'Q': 6, 'R': 4, 'S': 2, 'T': 2, 'H': 4, 'M': 2}","{'Y': 2, 'A': 2, 'B': 1, 'D': 1, 'E': 1, 'G': 2, 'I': 1, 'K': 2, 'L': 1, 'N': 1, 'O': 1, 'U': 2, 'V': 1, 'W': 1, 'X': 1}"
INV-ZZ-3973163,SCH-ZZ-9748991,ZZ,ZZ20240502MAABOM3117.0,3117.0,ATR 72,05/02/2024,2024-05-02 15:49:00,2024-05-02 21:43:00,MAA,BOM,72.0,81,49,-23,32,7,14,21,28,8,5,2,3,17,10,4,7,24,14,7,10,32,19,9,13,"{'F': 4, 'P': 3}","{'C': 6, 'J': 4, 'Z': 4}","{'Q': 6, 'R': 4, 'S': 2, 'T': 2, 'H': 4, 'M': 2}","{'Y': 2, 'A': 2, 'B': 1, 'D': 1, 'E': 1, 'G': 2, 'I': 1, 'K': 2, 'L': 1, 'N': 1, 'O': 1, 'U': 2, 'V': 1, 'W': 1, 'X': 1}"
INV-ZZ-2557520,SCH-ZZ-9748991,ZZ,ZZ20240505MAABOM3117.0,3117.0,ATR 72,05/05/2024,2024-05-05 15:49:00,2024-05-05 21:43:00,MAA,BOM,72.0,79,43,-29,36,7,14,21,28,8,4,3,4,17,9,5,8,24,13,8,11,32,17,11,15,"{'F': 4, 'P': 3}","{'C': 6, 'J': 4, 'Z': 4}","{'Q': 6, 'R': 4, 'S': 2, 'T': 2, 'H': 4, 'M': 2}","{'Y': 2, 'A': 2, 'B': 1, 'D': 1, 'E': 1, 'G': 2, 'I': 1, 'K': 2, 'L': 1, 'N': 1, 'O': 1, 'U': 2, 'V': 1, 'W': 1, 'X': 1}"
INV-ZZ-8507268,SCH-ZZ-9748991,ZZ,ZZ20240507MAABOM3117.0,3117.0,ATR 72,05/07/2024,2024-05-07 15:49:00,2024-05-07 21:43:00,MAA,BOM,72.0,80,45,-27,35,7,14,21,28,8,4,3,4,17,9,5,8,24,13,8,11,32,18,10,14,"{'F': 4, 'P': 3}","{'C': 6, 'J': 4, 'Z': 4}","{'Q': 6, 'R': 4, 'S': 2, 'T': 2, 'H': 4, 'M': 2}","{'Y': 2, 'A': 2, 'B': 1, 'D': 1, 'E': 1, 'G': 2, 'I': 1, 'K': 2, 'L': 1, 'N': 1, 'O': 1, 'U': 2, 'V': 1, 'W': 1, 'X': 1}"
INV-ZZ-2439677,SCH-ZZ-9748991,ZZ,ZZ20240509MAABOM3117.0,3117.0,ATR 72,05/09/2024,2024-05-09 15:49:00,2024-05-09 21:43:00,MAA,BOM,72.0,80,44,-28,36,7,14,21,28,8,4,3,4,17,9,5,8,24,13,8,11,33,18,10,15,"{'F': 4, 'P': 3}","{'C': 6, 'J': 4, 'Z': 4}","{'Q': 6, 'R': 4, 'S': 2, 'T': 2, 'H': 4, 'M': 2}","{'Y': 2, 'A': 2, 'B': 1, 'D': 1, 'E': 1, 'G': 2, 'I': 1, 'K': 2, 'L': 1, 'N': 1, 'O': 1, 'U': 2, 'V': 1, 'W': 1, 'X': 1}"
INV-ZZ-8302858,SCH-ZZ-9748991,ZZ,ZZ20240512MAABOM3117.0,3117.0,ATR 72,05/12/2024,2024-05-12 15:49:00,2024-05-12 21:43:00,MAA,BOM,72.0,84,46,-26,38,7,14,21,28,8,4,3,4,16,9,5,7,23,13,8,10,32,18,10,14,"{'F': 4, 'P': 3}","{'C': 6, 'J': 4, 'Z': 4}","{'Q': 6, 'R': 4, 'S': 2, 'T': 2, 'H': 4, 'M': 2}","{'Y': 2, 'A': 2, 'B': 1, 'D': 1, 'E': 1, 'G': 2, 'I': 1, 'K': 2, 'L': 1, 'N': 1, 'O': 1, 'U': 2, 'V': 1, 'W': 1, 'X': 1}"
INV-ZZ-5202636,SCH-ZZ-9748991,ZZ,ZZ20240514MAABOM3117.0,3117.0,ATR 72,05/14/2024,2024-05-14 15:49:00,2024-05-14 21:43:00,MAA,BOM,72.0,81,39,-33,42,7,14,21,28,8,4,3,4,16,8,6,8,24,12,9,12,32,16,12,16,"{'F': 4, 'P': 3}","{'C': 6, 'J': 4, 'Z': 4}","{'Q': 6, 'R': 4, 'S': 2, 'T': 2, 'H': 4, 'M': 2}","{'Y': 2, 'A': 2, 'B': 1, 'D': 1, 'E': 1, 'G': 2, 'I': 1, 'K': 2, 'L': 1, 'N': 1, 'O': 1, 'U': 2, 'V': 1, 'W': 1, 'X': 1}"
INV-ZZ-2894018,SCH-ZZ-9748991,ZZ,ZZ20240516MAABOM3117.0,3117.0,ATR 72,05/16/2024,2024-05-16 15:49:00,2024-05-16 21:43:00,MAA,BOM,72.0,85,46,-26,39,7,14,21,28,8,4,3,4,17,9,5,8,25,14,7,11,32,17,11,15,"{'F': 4, 'P': 3}","{'C': 6, 'J': 4, 'Z': 4}","{'Q': 6, 'R': 4, 'S': 2, 'T': 2, 'H': 4, 'M': 2}","{'Y': 2, 'A': 2, 'B': 1, 'D': 1, 'E': 1, 'G': 2, 'I': 1, 'K': 2, 'L': 1, 'N': 1, 'O': 1, 'U': 2, 'V': 1, 'W': 1, 'X': 1}"
INV-ZZ-8818475,SCH-ZZ-9748991,ZZ,ZZ20240519MAABOM3117.0,3117.0,ATR 72,05/19/2024,2024-05-19 15:49:00,2024-05-19 21:43:00,MAA,BOM,72.0,85,46,-26,39,7,14,21,28,8,4,3,4,16,9,5,7,23,12,9,11,31,17,11,14,"{'F': 4, 'P': 3}","{'C': 6, 'J': 4, 'Z': 4}","{'Q': 6, 'R': 4, 'S': 2, 'T': 2, 'H': 4, 'M': 2}","{'Y': 2, 'A': 2, 'B': 1, 'D': 1, 'E': 1, 'G': 2, 'I': 1, 'K': 2, 'L': 1, 'N': 1, 'O': 1, 'U': 2, 'V': 1, 'W': 1, 'X': 1}"
INV-ZZ-2501834,SCH-ZZ-9748991,ZZ,ZZ20240521MAABOM3117.0,3117.0,ATR 72,05/21/2024,2024-05-21 15:49:00,2024-05-21 21:43:00,MAA,BOM,72.0,84,43,-29,41,7,14,21,28,8,4,3,4,16,8,6,8,25,13,8,12,33,17,11,16,"{'F': 4, 'P': 3}","{'C': 6, 'J': 4, 'Z': 4}","{'Q': 6, 'R': 4, 'S': 2, 'T': 2, 'H': 4, 'M': 2}","{'Y': 2, 'A': 2, 'B': 1, 'D': 1, 'E': 1, 'G': 2, 'I': 1, 'K': 2, 'L': 1, 'N': 1, 'O': 1, 'U': 2, 'V': 1, 'W': 1, 'X': 1}"
INV-ZZ-4277207,SCH-ZZ-9748991,ZZ,ZZ20240523MAABOM3117.0,3117.0,ATR 72,05/23/2024,2024-05-23 15:49:00,2024-05-23 21:43:00,MAA,BOM,72.0,85,45,-27,40,7,14,21,28,8,4,3,4,15,8,6,7,24,13,8,11,32,17,11,15,"{'F': 4, 'P': 3}","{'C': 6, 'J': 4, 'Z': 4}","{'Q': 6, 'R': 4, 'S': 2, 'T': 2, 'H': 4, 'M': 2}","{'Y': 2, 'A': 2, 'B': 1, 'D': 1, 'E': 1, 'G': 2, 'I': 1, 'K': 2, 'L': 1, 'N': 1, 'O': 1, 'U': 2, 'V': 1, 'W': 1, 'X': 1}"
INV-ZZ-5108363,SCH-ZZ-9748991,ZZ,ZZ20240526MAABOM3117.0,3117.0,ATR 72,05/26/2024,2024-05-26 15:49:00,2024-05-26 21:43:00,MAA,BOM,72.0,79,37,-35,42,7,14,21,28,8,4,3,4,16,7,7,9,23,11,10,12,33,15,13,18,"{'F': 4, 'P': 3}","{'C': 6, 'J': 4, 'Z': 4}","{'Q': 6, 'R': 4, 'S': 2, 'T': 2, 'H': 4, 'M': 2}","{'Y': 2, 'A': 2, 'B': 1, 'D': 1, 'E': 1, 'G': 2, 'I': 1, 'K': 2, 'L': 1, 'N': 1, 'O': 1, 'U': 2, 'V': 1, 'W': 1, 'X': 1}"
INV-ZZ-5721568,SCH-ZZ-9748991,ZZ,ZZ20240528MAABOM3117.0,3117.0,ATR 72,05/28/2024,2024-05-28 15:49:00,2024-05-28 21:43:00,MAA,BOM,72.0,79,41,-31,38,7,14,21,28,8,4,3,4,16,8,6,8,24,12,9,12,33,17,11,16,"{'F': 4, 'P': 3}","{'C': 6, 'J': 4, 'Z': 4}","{'Q': 6, 'R': 4, 'S': 2, 'T': 2, 'H': 4, 'M': 2}","{'Y': 2, 'A': 2, 'B': 1, 'D': 1, 'E': 1, 'G': 2, 'I': 1, 'K': 2, 'L': 1, 'N': 1, 'O': 1, 'U': 2, 'V': 1, 'W': 1, 'X': 1}"
INV-ZZ-2193719,SCH-ZZ-5842607,ZZ,ZZ20240517MAAHYD4704.0,4704.0,Boeing 717,05/17/2024,2024-05-17 02:22:00,2024-05-18 01:47:00,MAA,HYD,100.0,118,62,-38,56,10,20,30,40,12,6,4,6,22,12,8,10,36,19,11,17,46,24,16,22,"{'F': 6, 'P': 4}","{'C': 8, 'J': 6, 'Z': 6}","{'Q': 9, 'R': 6, 'S': 3, 'T': 3, 'H': 6, 'M': 3}","{'Y': 3, 'A': 3, 'B': 2, 'D': 2, 'E': 2, 'G': 3, 'I': 2, 'K': 3, 'L': 2, 'N': 2, 'O': 2, 'U': 3, 'V': 2, 'W': 2, 'X': 2}"
INV-ZZ-2579392,SCH-ZZ-5842607,ZZ,ZZ20240519MAAHYD4704.0,4704.0,Boeing 717,05/19/2024,2024-05-19 02:22:00,2024-05-20 01:47:00,MAA,HYD,100.0,116,64,-36,52,10,20,30,40,11,6,4,5,23,13,7,10,35,19,11,16,47,26,14,21,"{'F': 6, 'P': 4}","{'C': 8, 'J': 6, 'Z': 6}","{'Q': 9, 'R': 6, 'S': 3, 'T': 3, 'H': 6, 'M': 3}","{'Y': 3, 'A': 3, 'B': 2, 'D': 2, 'E': 2, 'G': 3, 'I': 2, 'K': 3, 'L': 2, 'N': 2, 'O': 2, 'U': 3, 'V': 2, 'W': 2, 'X': 2}"
INV-ZZ-5652595,SCH-ZZ-5842607,ZZ,ZZ20240520MAAHYD4704.0,4704.0,Boeing 717,05/20/2024,2024-05-20 02:22:00,2024-05-21 01:47:00,MAA,HYD,100.0,110,52,-48,58,10,20,30,40,12,6,4,6,23,11,9,12,36,17,13,19,48,23,17,25,"{'F': 6, 'P': 4}","{'C': 8, 'J': 6, 'Z': 6}","{'Q': 9, 'R': 6, 'S': 3, 'T': 3, 'H': 6, 'M': 3}","{'Y': 3, 'A': 3, 'B': 2, 'D': 2, 'E': 2, 'G': 3, 'I': 2, 'K': 3, 'L': 2, 'N': 2, 'O': 2, 'U': 3, 'V': 2, 'W': 2, 'X': 2}"
INV-ZZ-6698312,SCH-ZZ-5842607,ZZ,ZZ20240524MAAHYD4704.0,4704.0,Boeing 717,05/24/2024,2024-05-24 02:22:00,2024-05-25 01:47:00,MAA,HYD,100.0,113,52,-48,61,10,20,30,40,11,5,5,6,23,11,9,12,35,16,14,19,46,21,19,25,"{'F': 6, 'P': 4}","{'C': 8, 'J': 6, 'Z': 6}","{'Q': 9, 'R': 6, 'S': 3, 'T': 3, 'H': 6, 'M': 3}","{'Y': 3, 'A': 3, 'B': 2, 'D': 2, 'E': 2, 'G': 3, 'I': 2, 'K': 3, 'L': 2, 'N': 2, 'O': 2, 'U': 3, 'V': 2, 'W': 2, 'X': 2}"
INV-ZZ-3217115,SCH-ZZ-5842607,ZZ,ZZ20240526MAAHYD4704.0,4704.0,Boeing 717,05/26/2024,2024-05-26 02:22:00,2024-05-27 01:47:00,MAA,HYD,100.0,119,58,-42,61,10,20,30,40,12,6,4,6,22,11,9,11,33,16,14,17,46,22,18,24,"{'F': 6, 'P': 4}","{'C': 8, 'J': 6, 'Z': 6}","{'Q': 9, 'R': 6, 'S': 3, 'T': 3, 'H': 6, 'M': 3}","{'Y': 3, 'A': 3, 'B': 2, 'D': 2, 'E': 2, 'G': 3, 'I': 2, 'K': 3, 'L': 2, 'N': 2, 'O': 2, 'U': 3, 'V': 2, 'W': 2, 'X': 2}"
INV-ZZ-4230733,SCH-ZZ-5842607,ZZ,ZZ20240527MAAHYD4704.0,4704.0,Boeing 717,05/27/2024,2024-05-27 02:22:00,2024-05-28 01:47:00,MAA,HYD,100.0,117,57,-43,60,10,20,30,40,11,5,5,6,22,11,9,11,34,17,13,17,45,22,18,23,"{'F': 6, 'P': 4}","{'C': 8, 'J': 6, 'Z': 6}","{'Q': 9, 'R': 6, 'S': 3, 'T': 3, 'H': 6, 'M': 3}","{'Y': 3, 'A': 3, 'B': 2, 'D': 2, 'E': 2, 'G': 3, 'I': 2, 'K': 3, 'L': 2, 'N': 2, 'O': 2, 'U': 3, 'V': 2, 'W': 2, 'X': 2}"
INV-ZZ-7869580,SCH-ZZ-5842607,ZZ,ZZ20240531MAAHYD4704.0,4704.0,Boeing 717,05/31/2024,2024-05-31 02:22:00,2024-06-01 01:47:00,MAA,HYD,100.0,118,54,-46,64,10,20,30,40,11,5,5,6,22,10,10,12,33,15,15,18,46,21,19,25,"{'F': 6, 'P': 4}","{'C': 8, 'J': 6, 'Z': 6}","{'Q': 9, 'R': 6, 'S': 3, 'T': 3, 'H': 6, 'M': 3}","{'Y': 3, 'A': 3, 'B': 2, 'D': 2, 'E': 2, 'G': 3, 'I': 2, 'K': 3, 'L': 2, 'N': 2, 'O': 2, 'U': 3, 'V': 2, 'W': 2, 'X': 2}"
INV-ZZ-3615141,SCH-ZZ-5842607,ZZ,ZZ20240602MAAHYD4704.0,4704.0,Boeing 717,06/02/2024,2024-06-02 02:22:00,2024-06-03 01:47:00,MAA,HYD,100.0,110,51,-49,59,10,20,30,40,12,6,4,6,23,11,9,12,33,15,15,18,47,22,18,25,"{'F': 6, 'P': 4}","{'C': 8, 'J': 6, 'Z': 6}","{'Q': 9, 'R': 6, 'S': 3, 'T': 3, 'H': 6, 'M': 3}","{'Y': 3, 'A': 3, 'B': 2, 'D': 2, 'E': 2, 'G': 3, 'I': 2, 'K': 3, 'L': 2, 'N': 2, 'O': 2, 'U': 3, 'V': 2, 'W': 2, 'X': 2}"
INV-ZZ-4393671,SCH-ZZ-5842607,ZZ,ZZ20240603MAAHYD4704.0,4704.0,Boeing 717,06/03/2024,2024-06-03 02:22:00,2024-06-04 01:47:00,MAA,HYD,100.0,112,50,-50,62,10,20,30,40,12,5,5,7,23,10,10,13,34,15,15,19,45,20,20,25,"{'F': 6, 'P': 4}","{'C': 8, 'J': 6, 'Z': 6}","{'Q': 9, 'R': 6, 'S': 3, 'T': 3, 'H': 6, 'M': 3}","{'Y': 3, 'A': 3, 'B': 2, 'D': 2, 'E': 2, 'G': 3, 'I': 2, 'K': 3, 'L': 2, 'N': 2, 'O': 2, 'U': 3, 'V': 2, 'W': 2, 'X': 2}"
INV-ZZ-3615401,SCH-ZZ-5842607,ZZ,ZZ20240607MAAHYD4704.0,4704.0,Boeing 717,06/07/2024,2024-06-07 02:22:00,2024-06-08 01:47:00,MAA,HYD,100.0,116,57,-43,59,10,20,30,40,12,6,4,6,23,11,9,12,35,17,13,18,46,23,17,23,"{'F': 6, 'P': 4}","{'C': 8, 'J': 6, 'Z': 6}","{'Q': 9, 'R': 6, 'S': 3, 'T': 3, 'H': 6, 'M': 3}","{'Y': 3, 'A': 3, 'B': 2, 'D': 2, 'E': 2, 'G': 3, 'I': 2, 'K': 3, 'L': 2, 'N': 2, 'O': 2, 'U': 3, 'V': 2, 'W': 2, 'X': 2}"
INV-ZZ-5337938,SCH-ZZ-5842607,ZZ,ZZ20240609MAAHYD4704.0,4704.0,Boeing 717,06/09/2024,2024-06-09 02:22:00,2024-06-10 01:47:00,MAA,HYD,100.0,115,53,-47,62,10,20,30,40,11,5,5,6,23,11,9,12,35,16,14,19,45,21,19,24,"{'F': 6, 'P': 4}","{'C': 8, 'J': 6, 'Z': 6}","{'Q': 9, 'R': 6, 'S': 3, 'T': 3, 'H': 6, 'M': 3}","{'Y': 3, 'A': 3, 'B': 2, 'D': 2, 'E': 2, 'G': 3, 'I': 2, 'K': 3, 'L': 2, 'N': 2, 'O': 2, 'U': 3, 'V': 2, 'W': 2, 'X': 2}"
INV-ZZ-9755353,SCH-ZZ-5842607,ZZ,ZZ20240610MAAHYD4704.0,4704.0,Boeing 717,06/10/2024,2024-06-10 02:22:00,2024-06-11 01:47:00,MAA,HYD,100.0,116,54,-46,62,10,20,30,40,11,5,5,6,24,11,9,13,34,16,14,18,48,23,17,25,"{'F': 6, 'P': 4}","{'C': 8, 'J': 6, 'Z': 6}","{'Q': 9, 'R': 6, 'S': 3, 'T': 3, 'H': 6, 'M': 3}","{'Y': 3, 'A': 3, 'B': 2, 'D': 2, 'E': 2, 'G': 3, 'I': 2, 'K': 3, 'L': 2, 'N': 2, 'O': 2, 'U': 3, 'V': 2, 'W': 2, 'X': 2}"
INV-ZZ-9708773,SCH-ZZ-5842607,ZZ,ZZ20240614MAAHYD4704.0,4704.0,Boeing 717,06/14/2024,2024-06-14 02:22:00,2024-06-15 01:47:00,MAA,HYD,100.0,116,53,-47,63,10,20,30,40,12,6,4,6,22,10,10,12,34,16,14,18,48,22,18,26,"{'F': 6, 'P': 4}","{'C': 8, 'J': 6, 'Z': 6}","{'Q': 9, 'R': 6, 'S': 3, 'T': 3, 'H': 6, 'M': 3}","{'Y': 3, 'A': 3, 'B': 2, 'D': 2, 'E': 2, 'G': 3, 'I': 2, 'K': 3, 'L': 2, 'N': 2, 'O': 2, 'U': 3, 'V': 2, 'W': 2, 'X': 2}"
INV-ZZ-7404333,SCH-ZZ-5842607,ZZ,ZZ20240616MAAHYD4704.0,4704.0,Boeing 717,06/16/2024,2024-06-16 02:22:00,2024-06-17 01:47:00,MAA,HYD,100.0,112,46,-54,66,10,20,30,40,12,5,5,7,23,9,11,14,34,14,16,20,45,19,21,26,"{'F': 6, 'P': 4}","{'C': 8, 'J': 6, 'Z': 6}","{'Q': 9, 'R': 6, 'S': 3, 'T': 3, 'H': 6, 'M': 3}","{'Y': 3, 'A': 3, 'B': 2, 'D': 2, 'E': 2, 'G': 3, 'I': 2, 'K': 3, 'L': 2, 'N': 2, 'O': 2, 'U': 3, 'V': 2, 'W': 2, 'X': 2}"
INV-ZZ-2264677,SCH-ZZ-5842607,ZZ,ZZ20240617MAAHYD4704.0,4704.0,Boeing 717,06/17/2024,2024-06-17 02:22:00,2024-06-18 01:47:00,MAA,HYD,100.0,115,49,-51,66,10,20,30,40,12,5,5,7,23,10,10,13,34,14,16,20,48,20,20,28,"{'F': 6, 'P': 4}","{'C': 8, 'J': 6, 'Z': 6}","{'Q': 9, 'R': 6, 'S': 3, 'T': 3, 'H': 6, 'M': 3}","{'Y': 3, 'A': 3, 'B': 2, 'D': 2, 'E': 2, 'G': 3, 'I': 2, 'K': 3, 'L': 2, 'N': 2, 'O': 2, 'U': 3, 'V': 2, 'W': 2, 'X': 2}"
INV-ZZ-4333163,SCH-ZZ-5842607,ZZ,ZZ20240621MAAHYD4704.0,4704.0,Boeing 717,06/21/2024,2024-06-21 02:22:00,2024-06-22 01:47:00,MAA,HYD,100.0,118,47,-53,71,10,20,30,40,11,4,6,7,24,10,10,14,34,14,16,20,46,18,22,28,"{'F': 6, 'P': 4}","{'C': 8, 'J': 6, 'Z': 6}","{'Q': 9, 'R': 6, 'S': 3, 'T': 3, 'H': 6, 'M': 3}","{'Y': 3, 'A': 3, 'B': 2, 'D': 2, 'E': 2, 'G': 3, 'I': 2, 'K': 3, 'L': 2, 'N': 2, 'O': 2, 'U': 3, 'V': 2, 'W': 2, 'X': 2}"
INV-ZZ-5514123,SCH-ZZ-5842607,ZZ,ZZ20240623MAAHYD4704.0,4704.0,Boeing 717,06/23/2024,2024-06-23 02:22:00,2024-06-24 01:47:00,MAA,HYD,100.0,115,49,-51,66,10,20,30,40,11,5,5,6,24,10,10,14,36,15,15,21,46,20,20,26,"{'F': 6, 'P': 4}","{'C': 8, 'J': 6, 'Z': 6}","{'Q': 9, 'R': 6, 'S': 3, 'T': 3, 'H': 6, 'M': 3}","{'Y': 3, 'A': 3, 'B': 2, 'D': 2, 'E': 2, 'G': 3, 'I': 2, 'K': 3, 'L': 2, 'N': 2, 'O': 2, 'U': 3, 'V': 2, 'W': 2, 'X': 2}"
INV-ZZ-1764790,SCH-ZZ-5842607,ZZ,ZZ20240624MAAHYD4704.0,4704.0,Boeing 717,06/24/2024,2024-06-24 02:22:00,2024-06-25 01:47:00,MAA,HYD,100.0,119,52,-48,67,10,20,30,40,11,5,5,6,22,10,10,12,33,14,16,19,45,20,20,25,"{'F': 6, 'P': 4}","{'C': 8, 'J': 6, 'Z': 6}","{'Q': 9, 'R': 6, 'S': 3, 'T': 3, 'H': 6, 'M': 3}","{'Y': 3, 'A': 3, 'B': 2, 'D': 2, 'E': 2, 'G': 3, 'I': 2, 'K': 3, 'L': 2, 'N': 2, 'O': 2, 'U': 3, 'V': 2, 'W': 2, 'X': 2}"
INV-ZZ-1918061,SCH-ZZ-5842607,ZZ,ZZ20240628MAAHYD4704.0,4704.0,Boeing 717,06/28/2024,2024-06-28 02:22:00,2024-06-29 01:47:00,MAA,HYD,100.0,115,44,-56,71,10,20,30,40,12,5,5,7,22,8,12,14,35,13,17,22,44,17,23,27,"{'F': 6, 'P': 4}","{'C': 8, 'J': 6, 'Z': 6}","{'Q': 9, 'R': 6, 'S': 3, 'T': 3, 'H': 6, 'M': 3}","{'Y': 3, 'A': 3, 'B': 2, 'D': 2, 'E': 2, 'G': 3, 'I': 2, 'K': 3, 'L': 2, 'N': 2, 'O': 2, 'U': 3, 'V': 2, 'W': 2, 'X': 2}"
INV-ZZ-9611257,SCH-ZZ-5842607,ZZ,ZZ20240630MAAHYD4704.0,4704.0,Boeing 717,06/30/2024,2024-06-30 02:22:00,2024-07-01 01:47:00,MAA,HYD,100.0,116,47,-53,69,10,20,30,40,11,4,6,7,23,9,11,14,34,14,16,20,48,20,20,28,"{'F': 6, 'P': 4}","{'C': 8, 'J': 6, 'Z': 6}","{'Q': 9, 'R': 6, 'S': 3, 'T': 3, 'H': 6, 'M': 3}","{'Y': 3, 'A': 3, 'B': 2, 'D': 2, 'E': 2, 'G': 3, 'I': 2, 'K': 3, 'L': 2, 'N': 2, 'O': 2, 'U': 3, 'V': 2, 'W': 2, 'X': 2}"
INV-ZZ-4779458,SCH-ZZ-5716505,ZZ,ZZ20240427HYDAMD4335.0,4335.0,Airbus A321-200,04/27/2024,2024-04-27 14:19:00,2024-04-28 11:51:00,HYD,AMD,200.0,220,126,-74,94,20,40,60,80,23,13,7,10,47,27,13,20,71,41,19,30,93,53,27,40,"{'F': 12, 'P': 8}","{'C': 16, 'J': 12, 'Z': 12}","{'Q': 18, 'R': 12, 'S': 6, 'T': 6, 'H': 12, 'M': 6}","{'Y': 6, 'A': 6, 'B': 3, 'D': 3, 'E': 3, 'G': 6, 'I': 3, 'K': 6, 'L': 3, 'N': 3, 'O': 3, 'U': 6, 'V': 3, 'W': 3, 'X': 3}"
INV-ZZ-4939533,SCH-ZZ-5716505,ZZ,ZZ20240429HYDAMD4335.0,4335.0,Airbus A321-200,04/29/2024,2024-04-29 14:19:00,2024-04-30 11:51:00,HYD,AMD,200.0,228,134,-66,94,20,40,60,80,23,14,6,9,47,28,12,19,71,42,18,29,94,55,25,39,"{'F': 12, 'P': 8}","{'C': 16, 'J': 12, 'Z': 12}","{'Q': 18, 'R': 12, 'S': 6, 'T': 6, 'H': 12, 'M': 6}","{'Y': 6, 'A': 6, 'B': 3, 'D': 3, 'E': 3, 'G': 6, 'I': 3, 'K': 6, 'L': 3, 'N': 3, 'O': 3, 'U': 6, 'V': 3, 'W': 3, 'X': 3}"
INV-ZZ-4716996,SCH-ZZ-5716505,ZZ,ZZ20240430HYDAMD4335.0,4335.0,Airbus A321-200,04/30/2024,2024-04-30 14:19:00,2024-05-01 11:51:00,HYD,AMD,200.0,232,129,-71,103,20,40,60,80,23,13,7,10,46,25,15,21,72,40,20,32,89,49,31,40,"{'F': 12, 'P': 8}","{'C': 16, 'J': 12, 'Z': 12}","{'Q': 18, 'R': 12, 'S': 6, 'T': 6, 'H': 12, 'M': 6}","{'Y': 6, 'A': 6, 'B': 3, 'D': 3, 'E': 3, 'G': 6, 'I': 3, 'K': 6, 'L': 3, 'N': 3, 'O': 3, 'U': 6, 'V': 3, 'W': 3, 'X': 3}"
INV-ZZ-4622895,SCH-ZZ-5716505,ZZ,ZZ20240501HYDAMD4335.0,4335.0,Airbus A321-200,05/01/2024,2024-05-01 14:19:00,2024-05-02 11:51:00,HYD,AMD,200.0,230,136,-64,94,20,40,60,80,22,13,7,9,47,28,12,19,70,41,19,29,93,55,25,38,"{'F': 12, 'P': 8}","{'C': 16, 'J': 12, 'Z': 12}","{'Q': 18, 'R': 12, 'S': 6, 'T': 6, 'H': 12, 'M': 6}","{'Y': 6, 'A': 6, 'B': 3, 'D': 3, 'E': 3, 'G': 6, 'I': 3, 'K': 6, 'L': 3, 'N': 3, 'O': 3, 'U': 6, 'V': 3, 'W': 3, 'X': 3}"
INV-ZZ-1197368,SCH-ZZ-5716505,ZZ,ZZ20240503HYDAMD4335.0,4335.0,Airbus A321-200,05/03/2024,2024-05-03 14:19:00,2024-05-04 11:51:00,HYD,AMD,200.0,220,130,-70,90,20,40,60,80,22,13,7,9,45,27,13,18,70,41,19,29,92,55,25,37,"{'F': 12, 'P': 8}","{'C': 16, 'J': 12, 'Z': 12}","{'Q': 18, 'R': 12, 'S': 6, 'T': 6, 'H': 12, 'M': 6}","{'Y': 6, 'A': 6, 'B': 3, 'D': 3, 'E': 3, 'G': 6, 'I': 3, 'K': 6, 'L': 3, 'N': 3, 'O': 3, 'U': 6, 'V': 3, 'W': 3, 'X': 3}"
INV-ZZ-5800571,SCH-ZZ-5716505,ZZ,ZZ20240504HYDAMD4335.0,4335.0,Airbus A321-200,05/04/2024,2024-05-04 14:19:00,2024-05-05 11:51:00,HYD,AMD,200.0,226,117,-83,109,20,40,60,80,24,12,8,12,47,24,16,23,69,36,24,33,93,48,32,45,"{'F': 12, 'P': 8}","{'C': 16, 'J': 12, 'Z': 12}","{'Q': 18, 'R': 12, 'S': 6, 'T': 6, 'H': 12, 'M': 6}","{'Y': 6, 'A': 6, 'B': 3, 'D': 3, 'E': 3, 'G': 6, 'I': 3, 'K': 6, 'L': 3, 'N': 3, 'O': 3, 'U': 6, 'V': 3, 'W': 3, 'X': 3}"
INV-ZZ-9146206,SCH-ZZ-5716505,ZZ,ZZ20240506HYDAMD4335.0,4335.0,Airbus A321-200,05/06/2024,2024-05-06 14:19:00,2024-05-07 11:51:00,HYD,AMD,200.0,220,122,-78,98,20,40,60,80,23,13,7,10,48,27,13,21,67,37,23,30,91,50,30,41,"{'F': 12, 'P': 8}","{'C': 16, 'J': 12, 'Z': 12}","{'Q': 18, 'R': 12, 'S': 6, 'T': 6, 'H': 12, 'M': 6}","{'Y': 6, 'A': 6, 'B': 3, 'D': 3, 'E': 3, 'G': 6, 'I': 3, 'K': 6, 'L': 3, 'N': 3, 'O': 3, 'U': 6, 'V': 3, 'W': 3, 'X': 3}"
INV-ZZ-3596011,SCH-ZZ-5716505,ZZ,ZZ20240507HYDAMD4335.0,4335.0,Airbus A321-200,05/07/2024,2024-05-07 14:19:00,2024-05-08 11:51:00,HYD,AMD,200.0,237,127,-73,110,20,40,60,80,23,12,8,11,45,24,16,21,71,38,22,33,96,51,29,45,"{'F': 12, 'P': 8}","{'C': 16, 'J': 12, 'Z': 12}","{'Q': 18, 'R': 12, 'S': 6, 'T': 6, 'H': 12, 'M': 6}","{'Y': 6, 'A': 6, 'B': 3, 'D': 3, 'E': 3, 'G': 6, 'I': 3, 'K': 6, 'L': 3, 'N': 3, 'O': 3, 'U': 6, 'V': 3, 'W': 3, 'X': 3}"
INV-ZZ-6148464,SCH-ZZ-5716505,ZZ,ZZ20240508HYDAMD4335.0,4335.0,Airbus A321-200,05/08/2024,2024-05-08 14:19:00,2024-05-09 11:51:00,HYD,AMD,200.0,234,133,-67,101,20,40,60,80,23,13,7,10,45,26,14,19,67,38,22,29,93,53,27,40,"{'F': 12, 'P': 8}","{'C': 16, 'J': 12, 'Z': 12}","{'Q': 18, 'R': 12, 'S': 6, 'T': 6, 'H': 12, 'M': 6}","{'Y': 6, 'A': 6, 'B': 3, 'D': 3, 'E': 3, 'G': 6, 'I': 3, 'K': 6, 'L': 3, 'N': 3, 'O': 3, 'U': 6, 'V': 3, 'W': 3, 'X': 3}"
INV-ZZ-8657660,SCH-ZZ-5716505,ZZ,ZZ20240510HYDAMD4335.0,4335.0,Airbus A321-200,05/10/2024,2024-05-10 14:19:00,2024-05-11 11:51:00,HYD,AMD,200.0,229,131,-69,98,20,40,60,80,22,13,7,9,45,26,14,19,67,38,22,29,88,50,30,38,"{'F': 12, 'P': 8}","{'C': 16, 'J': 12, 'Z': 12}","{'Q': 18, 'R': 12, 'S': 6, 'T': 6, 'H': 12, 'M': 6}","{'Y': 6, 'A': 6, 'B': 3, 'D': 3, 'E': 3, 'G': 6, 'I': 3, 'K': 6, 'L': 3, 'N': 3, 'O': 3, 'U': 6, 'V': 3, 'W': 3, 'X': 3}"
INV-ZZ-9397043,SCH-ZZ-5716505,ZZ,ZZ20240511HYDAMD4335.0,4335.0,Airbus A321-200,05/11/2024,2024-05-11 14:19:00,2024-05-12 11:51:00,HYD,AMD,200.0,233,129,-71,104,20,40,60,80,23,13,7,10,44,24,16,20,70,39,21,31,91,50,30,41,"{'F': 12, 'P': 8}","{'C': 16, 'J': 12, 'Z': 12}","{'Q': 18, 'R': 12, 'S': 6, 'T': 6, 'H': 12, 'M': 6}","{'Y': 6, 'A': 6, 'B': 3, 'D': 3, 'E': 3, 'G': 6, 'I': 3, 'K': 6, 'L': 3, 'N': 3, 'O': 3, 'U': 6, 'V': 3, 'W': 3, 'X': 3}"
INV-ZZ-7400587,SCH-ZZ-5716505,ZZ,ZZ20240513HYDAMD4335.0,4335.0,Airbus A321-200,05/13/2024,2024-05-13 14:19:00,2024-05-14 11:51:00,HYD,AMD,200.0,225,122,-78,103,20,40,60,80,23,12,8,11,44,24,16,20,67,36,24,31,95,52,28,43,"{'F': 12, 'P': 8}","{'C': 16, 'J': 12, 'Z': 12}","{'Q': 18, 'R': 12, 'S': 6, 'T': 6, 'H': 12, 'M': 6}","{'Y': 6, 'A': 6, 'B': 3, 'D': 3, 'E': 3, 'G': 6, 'I': 3, 'K': 6, 'L': 3, 'N': 3, 'O': 3, 'U': 6, 'V': 3, 'W': 3, 'X': 3}"
INV-ZZ-4958958,SCH-ZZ-5716505,ZZ,ZZ20240514HYDAMD4335.0,4335.0,Airbus A321-200,05/14/2024,2024-05-14 14:19:00,2024-05-15 11:51:00,HYD,AMD,200.0,223,109,-91,114,20,40,60,80,23,11,9,12,47,23,17,24,69,34,26,35,90,44,36,46,"{'F': 12, 'P': 8}","{'C': 16, 'J': 12, 'Z': 12}","{'Q': 18, 'R': 12, 'S': 6, 'T': 6, 'H': 12, 'M': 6}","{'Y': 6, 'A': 6, 'B': 3, 'D': 3, 'E': 3, 'G': 6, 'I': 3, 'K': 6, 'L': 3, 'N': 3, 'O': 3, 'U': 6, 'V': 3, 'W': 3, 'X': 3}"
INV-ZZ-1360503,SCH-ZZ-5716505,ZZ,ZZ20240515HYDAMD4335.0,4335.0,Airbus A321-200,05/15/2024,2024-05-15 14:19:00,2024-05-16 11:51:00,HYD,AMD,200.0,226,126,-74,100,20,40,60,80,23,13,7,10,45,25,15,20,69,38,22,31,88,49,31,39,"{'F': 12, 'P': 8}","{'C': 16, 'J': 12, 'Z': 12}","{'Q': 18, 'R': 12, 'S': 6, 'T': 6, 'H': 12, 'M': 6}","{'Y': 6, 'A': 6, 'B': 3, 'D': 3, 'E': 3, 'G': 6, 'I': 3, 'K': 6, 'L': 3, 'N': 3, 'O': 3, 'U': 6, 'V': 3, 'W': 3, 'X': 3}"
INV-ZZ-9364354,SCH-ZZ-5716505,ZZ,ZZ20240517HYDAMD4335.0,4335.0,Airbus A321-200,05/17/2024,2024-05-17 14:19:00,2024-05-18 11:51:00,HYD,AMD,200.0,220,114,-86,106,20,40,60,80,22,11,9,11,48,25,15,23,70,36,24,34,89,46,34,43,"{'F': 12, 'P': 8}","{'C': 16, 'J': 12, 'Z': 12}","{'Q': 18, 'R': 12, 'S': 6, 'T': 6, 'H': 12, 'M': 6}","{'Y': 6, 'A': 6, 'B': 3, 'D': 3, 'E': 3, 'G': 6, 'I': 3, 'K': 6, 'L': 3, 'N': 3, 'O': 3, 'U': 6, 'V': 3, 'W': 3, 'X': 3}"
INV-ZZ-7388012,SCH-ZZ-5716505,ZZ,ZZ20240518HYDAMD4335.0,4335.0,Airbus A321-200,05/18/2024,2024-05-18 14:19:00,2024-05-19 11:51:00,HYD,AMD,200.0,227,124,-76,103,20,40,60,80,23,13,7,10,47,26,14,21,69,38,22,31,96,52,28,44,"{'F': 12, 'P': 8}","{'C': 16, 'J': 12, 'Z': 12}","{'Q': 18, 'R': 12, 'S': 6, 'T': 6, 'H': 12, 'M': 6}","{'Y': 6, 'A': 6, 'B': 3, 'D': 3, 'E': 3, 'G': 6, 'I': 3, 'K': 6, 'L': 3, 'N': 3, 'O': 3, 'U': 6, 'V': 3, 'W': 3, 'X': 3}"
INV-ZZ-9016506,SCH-ZZ-5716505,ZZ,ZZ20240520HYDAMD4335.0,4335.0,Airbus A321-200,05/20/2024,2024-05-20 14:19:00,2024-05-21 11:51:00,HYD,AMD,200.0,233,126,-74,107,20,40,60,80,23,12,8,11,47,25,15,22,71,38,22,33,95,51,29,44,"{'F': 12, 'P': 8}","{'C': 16, 'J': 12, 'Z': 12}","{'Q': 18, 'R': 12, 'S': 6, 'T': 6, 'H': 12, 'M': 6}","{'Y': 6, 'A': 6, 'B': 3, 'D': 3, 'E': 3, 'G': 6, 'I': 3, 'K': 6, 'L': 3, 'N': 3, 'O': 3, 'U': 6, 'V': 3, 'W': 3, 'X': 3}"
INV-ZZ-9565992,SCH-ZZ-5716505,ZZ,ZZ20240521HYDAMD4335.0,4335.0,Airbus A321-200,05/21/2024,2024-05-21 14:19:00,2024-05-22 11:51:00,HYD,AMD,200.0,231,115,-85,116,20,40,60,80,23,11,9,12,46,23,17,23,69,34,26,35,94,47,33,47,"{'F': 12, 'P': 8}","{'C': 16, 'J': 12, 'Z': 12}","{'Q': 18, 'R': 12, 'S': 6, 'T': 6, 'H': 12, 'M': 6}","{'Y': 6, 'A': 6, 'B': 3, 'D': 3, 'E': 3, 'G': 6, 'I': 3, 'K': 6, 'L': 3, 'N': 3, 'O': 3, 'U': 6, 'V': 3, 'W': 3, 'X': 3}"
INV-ZZ-6918334,SCH-ZZ-5716505,ZZ,ZZ20240522HYDAMD4335.0,4335.0,Airbus A321-200,05/22/2024,2024-05-22 14:19:00,2024-05-23 11:51:00,HYD,AMD,200.0,226,105,-95,121,20,40,60,80,24,11,9,13,46,21,19,25,71,33,27,38,90,42,38,48,"{'F': 12, 'P': 8}","{'C': 16, 'J': 12, 'Z': 12}","{'Q': 18, 'R': 12, 'S': 6, 'T': 6, 'H': 12, 'M': 6}","{'Y': 6, 'A': 6, 'B': 3, 'D': 3, 'E': 3, 'G': 6, 'I': 3, 'K': 6, 'L': 3, 'N': 3, 'O': 3, 'U': 6, 'V': 3, 'W': 3, 'X': 3}"
INV-ZZ-7497477,SCH-ZZ-5716505,ZZ,ZZ20240524HYDAMD4335.0,4335.0,Airbus A321-200,05/24/2024,2024-05-24 14:19:00,2024-05-25 11:51:00,HYD,AMD,200.0,239,115,-85,124,20,40,60,80,24,12,8,12,47,23,17,24,66,32,28,34,94,45,35,49,"{'F': 12, 'P': 8}","{'C': 16, 'J': 12, 'Z': 12}","{'Q': 18, 'R': 12, 'S': 6, 'T': 6, 'H': 12, 'M': 6}","{'Y': 6, 'A': 6, 'B': 3, 'D': 3, 'E': 3, 'G': 6, 'I': 3, 'K': 6, 'L': 3, 'N': 3, 'O': 3, 'U': 6, 'V': 3, 'W': 3, 'X': 3}"
INV-ZZ-8026517,SCH-ZZ-5716505,ZZ,ZZ20240525HYDAMD4335.0,4335.0,Airbus A321-200,05/25/2024,2024-05-25 14:19:00,2024-05-26 11:51:00,HYD,AMD,200.0,239,116,-84,123,20,40,60,80,24,12,8,12,46,22,18,24,68,33,27,35,89,43,37,46,"{'F': 12, 'P': 8}","{'C': 16, 'J': 12, 'Z': 12}","{'Q': 18, 'R': 12, 'S': 6, 'T': 6, 'H': 12, 'M': 6}","{'Y': 6, 'A': 6, 'B': 3, 'D': 3, 'E': 3, 'G': 6, 'I': 3, 'K': 6, 'L': 3, 'N': 3, 'O': 3, 'U': 6, 'V': 3, 'W': 3, 'X': 3}"
INV-ZZ-1331467,SCH-ZZ-5716505,ZZ,ZZ20240527HYDAMD4335.0,4335.0,Airbus A321-200,05/27/2024,2024-05-27 14:19:00,2024-05-28 11:51:00,HYD,AMD,200.0,233,114,-86,119,20,40,60,80,22,11,9,11,45,22,18,23,72,35,25,37,88,43,37,45,"{'F': 12, 'P': 8}","{'C': 16, 'J': 12, 'Z': 12}","{'Q': 18, 'R': 12, 'S': 6, 'T': 6, 'H': 12, 'M': 6}","{'Y': 6, 'A': 6, 'B': 3, 'D': 3, 'E': 3, 'G': 6, 'I': 3, 'K': 6, 'L': 3, 'N': 3, 'O': 3, 'U': 6, 'V': 3, 'W': 3, 'X': 3}"
INV-ZZ-3737542,SCH-ZZ-5716505,ZZ,ZZ20240528HYDAMD4335.0,4335.0,Airbus A321-200,05/28/2024,2024-05-28 14:19:00,2024-05-29 11:51:00,HYD,AMD,200.0,227,105,-95,122,20,40,60,80,22,10,10,12,47,22,18,25,67,31,29,36,95,44,36,51,"{'F': 12, 'P': 8}","{'C': 16, 'J': 12, 'Z': 12}","{'Q': 18, 'R': 12, 'S': 6, 'T': 6, 'H': 12, 'M': 6}","{'Y': 6, 'A': 6, 'B': 3, 'D': 3, 'E': 3, 'G': 6, 'I': 3, 'K': 6, 'L': 3, 'N': 3, 'O': 3, 'U': 6, 'V': 3, 'W': 3, 'X': 3}"
INV-ZZ-4677291,SCH-ZZ-5716505,ZZ,ZZ20240529HYDAMD4335.0,4335.0,Airbus A321-200,05/29/2024,2024-05-29 14:19:00,2024-05-30 11:51:00,HYD,AMD,200.0,228,103,-97,125,20,40,60,80,23,10,10,13,46,21,19,25,71,32,28,39,89,40,40,49,"{'F': 12, 'P': 8}","{'C': 16, 'J': 12, 'Z': 12}","{'Q': 18, 'R': 12, 'S': 6, 'T': 6, 'H': 12, 'M': 6}","{'Y': 6, 'A': 6, 'B': 3, 'D': 3, 'E': 3, 'G': 6, 'I': 3, 'K': 6, 'L': 3, 'N': 3, 'O': 3, 'U': 6, 'V': 3, 'W': 3, 'X': 3}"
INV-ZZ-5773312,SCH-ZZ-5716505,ZZ,ZZ20240531HYDAMD4335.0,4335.0,Airbus A321-200,05/31/2024,2024-05-31 14:19:00,2024-06-01 11:51:00,HYD,AMD,200.0,226,112,-88,114,20,40,60,80,24,12,8,12,47,23,17,24,67,33,27,34,88,44,36,44,"{'F': 12, 'P': 8}","{'C': 16, 'J': 12, 'Z': 12}","{'Q': 18, 'R': 12, 'S': 6, 'T': 6, 'H': 12, 'M': 6}","{'Y': 6, 'A': 6, 'B': 3, 'D': 3, 'E': 3, 'G': 6, 'I': 3, 'K': 6, 'L': 3, 'N': 3, 'O': 3, 'U': 6, 'V': 3, 'W': 3, 'X': 3}"
INV-ZZ-1039674,SCH-ZZ-5716505,ZZ,ZZ20240601HYDAMD4335.0,4335.0,Airbus A321-200,06/01/2024,2024-06-01 14:19:00,2024-06-02 11:51:00,HYD,AMD,200.0,227,113,-87,114,20,40,60,80,22,11,9,11,45,22,18,23,69,34,26,35,89,44,36,45,"{'F': 12, 'P': 8}","{'C': 16, 'J': 12, 'Z': 12}","{'Q': 18, 'R': 12, 'S': 6, 'T': 6, 'H': 12, 'M': 6}","{'Y': 6, 'A': 6, 'B': 3, 'D': 3, 'E': 3, 'G': 6, 'I': 3, 'K': 6, 'L': 3, 'N': 3, 'O': 3, 'U': 6, 'V': 3, 'W': 3, 'X': 3}"
INV-ZZ-6556886,SCH-ZZ-5716505,ZZ,ZZ20240603HYDAMD4335.0,4335.0,Airbus A321-200,06/03/2024,2024-06-03 14:19:00,2024-06-04 11:51:00,HYD,AMD,200.0,225,113,-87,112,20,40,60,80,24,12,8,12,45,23,17,22,70,35,25,35,96,48,32,48,"{'F': 12, 'P': 8}","{'C': 16, 'J': 12, 'Z': 12}","{'Q': 18, 'R': 12, 'S': 6, 'T': 6, 'H': 12, 'M': 6}","{'Y': 6, 'A': 6, 'B': 3, 'D': 3, 'E': 3, 'G': 6, 'I': 3, 'K': 6, 'L': 3, 'N': 3, 'O': 3, 'U': 6, 'V': 3, 'W': 3, 'X': 3}"
INV-ZZ-3714984,SCH-ZZ-5716505,ZZ,ZZ20240604HYDAMD4335.0,4335.0,Airbus A321-200,06/04/2024,2024-06-04 14:19:00,2024-06-05 11:51:00,HYD,AMD,200.0,231,103,-97,128,20,40,60,80,24,11,9,13,47,21,19,26,70,31,29,39,91,41,39,50,"{'F': 12, 'P': 8}","{'C': 16, 'J': 12, 'Z': 12}","{'Q': 18, 'R': 12, 'S': 6, 'T': 6, 'H': 12, 'M': 6}","{'Y': 6, 'A': 6, 'B': 3, 'D': 3, 'E': 3, 'G': 6, 'I': 3, 'K': 6, 'L': 3, 'N': 3, 'O': 3, 'U': 6, 'V': 3, 'W': 3, 'X': 3}"
INV-ZZ-7008139,SCH-ZZ-5716505,ZZ,ZZ20240605HYDAMD4335.0,4335.0,Airbus A321-200,06/05/2024,2024-06-05 14:19:00,2024-06-06 11:51:00,HYD,AMD,200.0,226,106,-94,120,20,40,60,80,23,11,9,12,47,22,18,25,72,34,26,38,89,42,38,47,"{'F': 12, 'P': 8}","{'C': 16, 'J': 12, 'Z': 12}","{'Q': 18, 'R': 12, 'S': 6, 'T': 6, 'H': 12, 'M': 6}","{'Y': 6, 'A': 6, 'B': 3, 'D': 3, 'E': 3, 'G': 6, 'I': 3, 'K': 6, 'L': 3, 'N': 3, 'O': 3, 'U': 6, 'V': 3, 'W': 3, 'X': 3}"
INV-ZZ-7541659,SCH-ZZ-5716505,ZZ,ZZ20240607HYDAMD4335.0,4335.0,Airbus A321-200,06/07/2024,2024-06-07 14:19:00,2024-06-08 11:51:00,HYD,AMD,200.0,233,116,-84,117,20,40,60,80,23,11,9,12,45,22,18,23,72,36,24,36,89,44,36,45,"{'F': 12, 'P': 8}","{'C': 16, 'J': 12, 'Z': 12}","{'Q': 18, 'R': 12, 'S': 6, 'T': 6, 'H': 12, 'M': 6}","{'Y': 6, 'A': 6, 'B': 3, 'D': 3, 'E': 3, 'G': 6, 'I': 3, 'K': 6, 'L': 3, 'N': 3, 'O': 3, 'U': 6, 'V': 3, 'W': 3, 'X': 3}"
INV-ZZ-7788115,SCH-ZZ-5716505,ZZ,ZZ20240608HYDAMD4335.0,4335.0,Airbus A321-200,06/08/2024,2024-06-08 14:19:00,2024-06-09 11:51:00,HYD,AMD,200.0,228,101,-99,127,20,40,60,80,24,11,9,13,45,20,20,25,67,30,30,37,92,41,39,51,"{'F': 12, 'P': 8}","{'C': 16, 'J': 12, 'Z': 12}","{'Q': 18, 'R': 12, 'S': 6, 'T': 6, 'H': 12, 'M': 6}","{'Y': 6, 'A': 6, 'B': 3, 'D': 3, 'E': 3, 'G': 6, 'I': 3, 'K': 6, 'L': 3, 'N': 3, 'O': 3, 'U': 6, 'V': 3, 'W': 3, 'X': 3}"
INV-ZZ-1420620,SCH-ZZ-5716505,ZZ,ZZ20240610HYDAMD4335.0,4335.0,Airbus A321-200,06/10/2024,2024-06-10 14:19:00,2024-06-11 11:51:00,HYD,AMD,200.0,235,116,-84,119,20,40,60,80,23,11,9,12,47,23,17,24,67,33,27,34,92,45,35,47,"{'F': 12, 'P': 8}","{'C': 16, 'J': 12, 'Z': 12}","{'Q': 18, 'R': 12, 'S': 6, 'T': 6, 'H': 12, 'M': 6}","{'Y': 6, 'A': 6, 'B': 3, 'D': 3, 'E': 3, 'G': 6, 'I': 3, 'K': 6, 'L': 3, 'N': 3, 'O': 3, 'U': 6, 'V': 3, 'W': 3, 'X': 3}"
INV-ZZ-8047528,SCH-ZZ-5716505,ZZ,ZZ20240611HYDAMD4335.0,4335.0,Airbus A321-200,06/11/2024,2024-06-11 14:19:00,2024-06-12 11:51:00,HYD,AMD,200.0,233,102,-98,131,20,40,60,80,23,10,10,13,46,20,20,26,70,31,29,39,94,41,39,53,"{'F': 12, 'P': 8}","{'C': 16, 'J': 12, 'Z': 12}","{'Q': 18, 'R': 12, 'S': 6, 'T': 6, 'H': 12, 'M': 6}","{'Y': 6, 'A': 6, 'B': 3, 'D': 3, 'E': 3, 'G': 6, 'I': 3, 'K': 6, 'L': 3, 'N': 3, 'O': 3, 'U': 6, 'V': 3, 'W': 3, 'X': 3}"
INV-ZZ-9945394,SCH-ZZ-8848784,ZZ,ZZ20240504DELBOM3742.0,3742.0,Airbus A321 Neo,05/04/2024,2024-05-04 00:17:00,2024-05-04 05:08:00,DEL,BOM,220.0,251,130,-90,121,22,44,66,88,25,13,9,12,49,25,19,24,78,40,26,38,99,51,37,48,"{'F': 13, 'P': 9}","{'C': 18, 'J': 13, 'Z': 13}","{'Q': 20, 'R': 13, 'S': 7, 'T': 7, 'H': 13, 'M': 7}","{'Y': 7, 'A': 7, 'B': 3, 'D': 3, 'E': 3, 'G': 7, 'I': 3, 'K': 7, 'L': 3, 'N': 3, 'O': 3, 'U': 7, 'V': 3, 'W': 3, 'X': 3}"
INV-ZZ-7307992,SCH-ZZ-8848784,ZZ,ZZ20240511DELBOM3742.0,3742.0,Airbus A321 Neo,05/11/2024,2024-05-11 00:17:00,2024-05-11 05:08:00,DEL,BOM,220.0,249,132,-88,117,22,44,66,88,26,14,8,12,52,28,16,24,78,41,25,37,104,55,33,49,"{'F': 13, 'P': 9}","{'C': 18, 'J': 13, 'Z': 13}","{'Q': 20, 'R': 13, 'S': 7, 'T': 7, 'H': 13, 'M': 7}","{'Y': 7, 'A': 7, 'B': 3, 'D': 3, 'E': 3, 'G': 7, 'I': 3, 'K': 7, 'L': 3, 'N': 3, 'O': 3, 'U': 7, 'V': 3, 'W': 3, 'X': 3}"
INV-ZZ-4862678,SCH-ZZ-8848784,ZZ,ZZ20240518DELBOM3742.0,3742.0,Airbus A321 Neo,05/18/2024,2024-05-18 00:17:00,2024-05-18 05:08:00,DEL,BOM,220.0,262,143,-77,119,22,44,66,88,25,14,8,11,51,28,16,23,76,41,25,35,97,53,35,44,"{'F': 13, 'P': 9}","{'C': 18, 'J': 13, 'Z': 13}","{'Q': 20, 'R': 13, 'S': 7, 'T': 7, 'H': 13, 'M': 7}","{'Y': 7, 'A': 7, 'B': 3, 'D': 3, 'E': 3, 'G': 7, 'I': 3, 'K': 7, 'L': 3, 'N': 3, 'O': 3, 'U': 7, 'V': 3, 'W': 3, 'X': 3}"
INV-ZZ-5780442,SCH-ZZ-8848784,ZZ,ZZ20240525DELBOM3742.0,3742.0,Airbus A321 Neo,05/25/2024,2024-05-25 00:17:00,2024-05-25 05:08:00,DEL,BOM,220.0,246,125,-95,121,22,44,66,88,25,13,9,12,52,26,18,26,78,40,26,38,100,51,37,49,"{'F': 13, 'P': 9}","{'C': 18, 'J': 13, 'Z': 13}","{'Q': 20, 'R': 13, 'S': 7, 'T': 7, 'H': 13, 'M': 7}","{'Y': 7, 'A': 7, 'B': 3, 'D': 3, 'E': 3, 'G': 7, 'I': 3, 'K': 7, 'L': 3, 'N': 3, 'O': 3, 'U': 7, 'V': 3, 'W': 3, 'X': 3}"
INV-ZZ-8966591,SCH-ZZ-8848784,ZZ,ZZ20240601DELBOM3742.0,3742.0,Airbus A321 Neo,06/01/2024,2024-06-01 00:17:00,2024-06-01 05:08:00,DEL,BOM,220.0,255,118,-102,137,22,44,66,88,25,12,10,13,50,23,21,27,77,36,30,41,100,46,42,54,"{'F': 13, 'P': 9}","{'C': 18, 'J': 13, 'Z': 13}","{'Q': 20, 'R': 13, 'S': 7, 'T': 7, 'H': 13, 'M': 7}","{'Y': 7, 'A': 7, 'B': 3, 'D': 3, 'E': 3, 'G': 7, 'I': 3, 'K': 7, 'L': 3, 'N': 3, 'O': 3, 'U': 7, 'V': 3, 'W': 3, 'X': 3}"
INV-ZZ-6361763,SCH-ZZ-8848784,ZZ,ZZ20240608DELBOM3742.0,3742.0,Airbus A321 Neo,06/08/2024,2024-06-08 00:17:00,2024-06-08 05:08:00,DEL,BOM,220.0,258,126,-94,132,22,44,66,88,26,13,9,13,50,25,19,25,75,37,29,38,105,51,37,54,"{'F': 13, 'P': 9}","{'C': 18, 'J': 13, 'Z': 13}","{'Q': 20, 'R': 13, 'S': 7, 'T': 7, 'H': 13, 'M': 7}","{'Y': 7, 'A': 7, 'B': 3, 'D': 3, 'E': 3, 'G': 7, 'I': 3, 'K': 7, 'L': 3, 'N': 3, 'O': 3, 'U': 7, 'V': 3, 'W': 3, 'X': 3}"
INV-ZZ-2571410,SCH-ZZ-8848784,ZZ,ZZ20240615DELBOM3742.0,3742.0,Airbus A321 Neo,06/15/2024,2024-06-15 00:17:00,2024-06-15 05:08:00,DEL,BOM,220.0,263,114,-106,149,22,44,66,88,25,11,11,14,51,22,22,29,74,32,34,42,100,43,45,57,"{'F': 13, 'P': 9}","{'C': 18, 'J': 13, 'Z': 13}","{'Q': 20, 'R': 13, 'S': 7, 'T': 7, 'H': 13, 'M': 7}","{'Y': 7, 'A': 7, 'B': 3, 'D': 3, 'E': 3, 'G': 7, 'I': 3, 'K': 7, 'L': 3, 'N': 3, 'O': 3, 'U': 7, 'V': 3, 'W': 3, 'X': 3}"
INV-ZZ-8389900,SCH-ZZ-9337638,ZZ,ZZ20240422MAACCU4647.0,4647.0,Airbus A321-200,04/22/2024,2024-04-22 20:34:00,2024-04-23 17:02:00,MAA,CCU,200.0,220,126,-74,94,20,40,60,80,24,14,6,10,44,25,15,19,68,39,21,29,96,55,25,41,"{'F': 12, 'P': 8}","{'C': 16, 'J': 12, 'Z': 12}","{'Q': 18, 'R': 12, 'S': 6, 'T': 6, 'H': 12, 'M': 6}","{'Y': 6, 'A': 6, 'B': 3, 'D': 3, 'E': 3, 'G': 6, 'I': 3, 'K': 6, 'L': 3, 'N': 3, 'O': 3, 'U': 6, 'V': 3, 'W': 3, 'X': 3}"
INV-ZZ-7732668,SCH-ZZ-9337638,ZZ,ZZ20240423MAACCU4647.0,4647.0,Airbus A321-200,04/23/2024,2024-04-23 20:34:00,2024-04-24 17:02:00,MAA,CCU,200.0,229,124,-76,105,20,40,60,80,24,13,7,11,46,25,15,21,67,36,24,31,90,49,31,41,"{'F': 12, 'P': 8}","{'C': 16, 'J': 12, 'Z': 12}","{'Q': 18, 'R': 12, 'S': 6, 'T': 6, 'H': 12, 'M': 6}","{'Y': 6, 'A': 6, 'B': 3, 'D': 3, 'E': 3, 'G': 6, 'I': 3, 'K': 6, 'L': 3, 'N': 3, 'O': 3, 'U': 6, 'V': 3, 'W': 3, 'X': 3}"
INV-ZZ-7070171,SCH-ZZ-9337638,ZZ,ZZ20240424MAACCU4647.0,4647.0,Airbus A321-200,04/24/2024,2024-04-24 20:34:00,2024-04-25 17:02:00,MAA,CCU,200.0,239,133,-67,106,20,40,60,80,23,13,7,10,46,26,14,20,66,37,23,29,89,50,30,39,"{'F': 12, 'P': 8}","{'C': 16, 'J': 12, 'Z': 12}","{'Q': 18, 'R': 12, 'S': 6, 'T': 6, 'H': 12, 'M': 6}","{'Y': 6, 'A': 6, 'B': 3, 'D': 3, 'E': 3, 'G': 6, 'I': 3, 'K': 6, 'L': 3, 'N': 3, 'O': 3, 'U': 6, 'V': 3, 'W': 3, 'X': 3}"
INV-ZZ-7768403,SCH-ZZ-9337638,ZZ,ZZ20240425MAACCU4647.0,4647.0,Airbus A321-200,04/25/2024,2024-04-25 20:34:00,2024-04-26 17:02:00,MAA,CCU,200.0,228,130,-70,98,20,40,60,80,24,14,6,10,47,27,13,20,70,40,20,30,91,52,28,39,"{'F': 12, 'P': 8}","{'C': 16, 'J': 12, 'Z': 12}","{'Q': 18, 'R': 12, 'S': 6, 'T': 6, 'H': 12, 'M': 6}","{'Y': 6, 'A': 6, 'B': 3, 'D': 3, 'E': 3, 'G': 6, 'I': 3, 'K': 6, 'L': 3, 'N': 3, 'O': 3, 'U': 6, 'V': 3, 'W': 3, 'X': 3}"
INV-ZZ-3957590,SCH-ZZ-9337638,ZZ,ZZ20240426MAACCU4647.0,4647.0,Airbus A321-200,04/26/2024,2024-04-26 20:34:00,2024-04-27 17:02:00,MAA,CCU,200.0,236,127,-73,109,20,40,60,80,24,13,7,11,45,24,16,21,69,37,23,32,95,51,29,44,"{'F': 12, 'P': 8}","{'C': 16, 'J': 12, 'Z': 12}","{'Q': 18, 'R': 12, 'S': 6, 'T': 6, 'H': 12, 'M': 6}","{'Y': 6, 'A': 6, 'B': 3, 'D': 3, 'E': 3, 'G': 6, 'I': 3, 'K': 6, 'L': 3, 'N': 3, 'O': 3, 'U': 6, 'V': 3, 'W': 3, 'X': 3}"
INV-ZZ-5848177,SCH-ZZ-9337638,ZZ,ZZ20240429MAACCU4647.0,4647.0,Airbus A321-200,04/29/2024,2024-04-29 20:34:00,2024-04-30 17:02:00,MAA,CCU,200.0,226,131,-69,95,20,40,60,80,24,14,6,10,45,26,14,19,68,39,21,29,93,54,26,39,"{'F': 12, 'P': 8}","{'C': 16, 'J': 12, 'Z': 12}","{'Q': 18, 'R': 12, 'S': 6, 'T': 6, 'H': 12, 'M': 6}","{'Y': 6, 'A': 6, 'B': 3, 'D': 3, 'E': 3, 'G': 6, 'I': 3, 'K': 6, 'L': 3, 'N': 3, 'O': 3, 'U': 6, 'V': 3, 'W': 3, 'X': 3}"
INV-ZZ-8871317,SCH-ZZ-9337638,ZZ,ZZ20240430MAACCU4647.0,4647.0,Airbus A321-200,04/30/2024,2024-04-30 20:34:00,2024-05-01 17:02:00,MAA,CCU,200.0,231,130,-70,101,20,40,60,80,24,13,7,11,48,27,13,21,71,40,20,31,90,51,29,39,"{'F': 12, 'P': 8}","{'C': 16, 'J': 12, 'Z': 12}","{'Q': 18, 'R': 12, 'S': 6, 'T': 6, 'H': 12, 'M': 6}","{'Y': 6, 'A': 6, 'B': 3, 'D': 3, 'E': 3, 'G': 6, 'I': 3, 'K': 6, 'L': 3, 'N': 3, 'O': 3, 'U': 6, 'V': 3, 'W': 3, 'X': 3}"
INV-ZZ-4541645,SCH-ZZ-9337638,ZZ,ZZ20240501MAACCU4647.0,4647.0,Airbus A321-200,05/01/2024,2024-05-01 20:34:00,2024-05-02 17:02:00,MAA,CCU,200.0,228,136,-64,92,20,40,60,80,24,14,6,10,45,27,13,18,71,42,18,29,92,55,25,37,"{'F': 12, 'P': 8}","{'C': 16, 'J': 12, 'Z': 12}","{'Q': 18, 'R': 12, 'S': 6, 'T': 6, 'H': 12, 'M': 6}","{'Y': 6, 'A': 6, 'B': 3, 'D': 3, 'E': 3, 'G': 6, 'I': 3, 'K': 6, 'L': 3, 'N': 3, 'O': 3, 'U': 6, 'V': 3, 'W': 3, 'X': 3}"
INV-ZZ-1753928,SCH-ZZ-9337638,ZZ,ZZ20240502MAACCU4647.0,4647.0,Airbus A321-200,05/02/2024,2024-05-02 20:34:00,2024-05-03 17:02:00,MAA,CCU,200.0,237,122,-78,115,20,40,60,80,24,12,8,12,47,24,16,23,68,35,25,33,89,46,34,43,"{'F': 12, 'P': 8}","{'C': 16, 'J': 12, 'Z': 12}","{'Q': 18, 'R': 12, 'S': 6, 'T': 6, 'H': 12, 'M': 6}","{'Y': 6, 'A': 6, 'B': 3, 'D': 3, 'E': 3, 'G': 6, 'I': 3, 'K': 6, 'L': 3, 'N': 3, 'O': 3, 'U': 6, 'V': 3, 'W': 3, 'X': 3}"
INV-ZZ-1025615,SCH-ZZ-9337638,ZZ,ZZ20240503MAACCU4647.0,4647.0,Airbus A321-200,05/03/2024,2024-05-03 20:34:00,2024-05-04 17:02:00,MAA,CCU,200.0,220,126,-74,94,20,40,60,80,23,13,7,10,46,26,14,20,67,38,22,29,90,52,28,38,"{'F': 12, 'P': 8}","{'C': 16, 'J': 12, 'Z': 12}","{'Q': 18, 'R': 12, 'S': 6, 'T': 6, 'H': 12, 'M': 6}","{'Y': 6, 'A': 6, 'B': 3, 'D': 3, 'E': 3, 'G': 6, 'I': 3, 'K': 6, 'L': 3, 'N': 3, 'O': 3, 'U': 6, 'V': 3, 'W': 3, 'X': 3}"
INV-ZZ-6740946,SCH-ZZ-9337638,ZZ,ZZ20240506MAACCU4647.0,4647.0,Airbus A321-200,05/06/2024,2024-05-06 20:34:00,2024-05-07 17:02:00,MAA,CCU,200.0,220,115,-85,105,20,40,60,80,24,13,7,11,46,24,16,22,71,37,23,34,89,47,33,42,"{'F': 12, 'P': 8}","{'C': 16, 'J': 12, 'Z': 12}","{'Q': 18, 'R': 12, 'S': 6, 'T': 6, 'H': 12, 'M': 6}","{'Y': 6, 'A': 6, 'B': 3, 'D': 3, 'E': 3, 'G': 6, 'I': 3, 'K': 6, 'L': 3, 'N': 3, 'O': 3, 'U': 6, 'V': 3, 'W': 3, 'X': 3}"
INV-ZZ-4574977,SCH-ZZ-9337638,ZZ,ZZ20240507MAACCU4647.0,4647.0,Airbus A321-200,05/07/2024,2024-05-07 20:34:00,2024-05-08 17:02:00,MAA,CCU,200.0,229,128,-72,101,20,40,60,80,22,12,8,10,47,26,14,21,70,39,21,31,95,53,27,42,"{'F': 12, 'P': 8}","{'C': 16, 'J': 12, 'Z': 12}","{'Q': 18, 'R': 12, 'S': 6, 'T': 6, 'H': 12, 'M': 6}","{'Y': 6, 'A': 6, 'B': 3, 'D': 3, 'E': 3, 'G': 6, 'I': 3, 'K': 6, 'L': 3, 'N': 3, 'O': 3, 'U': 6, 'V': 3, 'W': 3, 'X': 3}"
INV-ZZ-5544386,SCH-ZZ-9337638,ZZ,ZZ20240508MAACCU4647.0,4647.0,Airbus A321-200,05/08/2024,2024-05-08 20:34:00,2024-05-09 17:02:00,MAA,CCU,200.0,222,111,-89,111,20,40,60,80,22,11,9,11,44,22,18,22,72,36,24,36,91,45,35,46,"{'F': 12, 'P': 8}","{'C': 16, 'J': 12, 'Z': 12}","{'Q': 18, 'R': 12, 'S': 6, 'T': 6, 'H': 12, 'M': 6}","{'Y': 6, 'A': 6, 'B': 3, 'D': 3, 'E': 3, 'G': 6, 'I': 3, 'K': 6, 'L': 3, 'N': 3, 'O': 3, 'U': 6, 'V': 3, 'W': 3, 'X': 3}"
INV-ZZ-8822583,SCH-ZZ-9337638,ZZ,ZZ20240509MAACCU4647.0,4647.0,Airbus A321-200,05/09/2024,2024-05-09 20:34:00,2024-05-10 17:02:00,MAA,CCU,200.0,224,118,-82,106,20,40,60,80,23,12,8,11,45,24,16,21,66,35,25,31,93,49,31,44,"{'F': 12, 'P': 8}","{'C': 16, 'J': 12, 'Z': 12}","{'Q': 18, 'R': 12, 'S': 6, 'T': 6, 'H': 12, 'M': 6}","{'Y': 6, 'A': 6, 'B': 3, 'D': 3, 'E': 3, 'G': 6, 'I': 3, 'K': 6, 'L': 3, 'N': 3, 'O': 3, 'U': 6, 'V': 3, 'W': 3, 'X': 3}"
INV-ZZ-6904297,SCH-ZZ-9337638,ZZ,ZZ20240510MAACCU4647.0,4647.0,Airbus A321-200,05/10/2024,2024-05-10 20:34:00,2024-05-11 17:02:00,MAA,CCU,200.0,237,128,-72,109,20,40,60,80,24,13,7,11,44,24,16,20,68,37,23,31,95,51,29,44,"{'F': 12, 'P': 8}","{'C': 16, 'J': 12, 'Z': 12}","{'Q': 18, 'R': 12, 'S': 6, 'T': 6, 'H': 12, 'M': 6}","{'Y': 6, 'A': 6, 'B': 3, 'D': 3, 'E': 3, 'G': 6, 'I': 3, 'K': 6, 'L': 3, 'N': 3, 'O': 3, 'U': 6, 'V': 3, 'W': 3, 'X': 3}"
INV-ZZ-9698120,SCH-ZZ-9337638,ZZ,ZZ20240513MAACCU4647.0,4647.0,Airbus A321-200,05/13/2024,2024-05-13 20:34:00,2024-05-14 17:02:00,MAA,CCU,200.0,228,126,-74,102,20,40,60,80,23,13,7,10,48,27,13,21,69,38,22,31,90,50,30,40,"{'F': 12, 'P': 8}","{'C': 16, 'J': 12, 'Z': 12}","{'Q': 18, 'R': 12, 'S': 6, 'T': 6, 'H': 12, 'M': 6}","{'Y': 6, 'A': 6, 'B': 3, 'D': 3, 'E': 3, 'G': 6, 'I': 3, 'K': 6, 'L': 3, 'N': 3, 'O': 3, 'U': 6, 'V': 3, 'W': 3, 'X': 3}"
INV-ZZ-3421998,SCH-ZZ-9337638,ZZ,ZZ20240514MAACCU4647.0,4647.0,Airbus A321-200,05/14/2024,2024-05-14 20:34:00,2024-05-15 17:02:00,MAA,CCU,200.0,239,134,-66,105,20,40,60,80,23,13,7,10,46,26,14,20,68,38,22,30,93,52,28,41,"{'F': 12, 'P': 8}","{'C': 16, 'J': 12, 'Z': 12}","{'Q': 18, 'R': 12, 'S': 6, 'T': 6, 'H': 12, 'M': 6}","{'Y': 6, 'A': 6, 'B': 3, 'D': 3, 'E': 3, 'G': 6, 'I': 3, 'K': 6, 'L': 3, 'N': 3, 'O': 3, 'U': 6, 'V': 3, 'W': 3, 'X': 3}"
INV-ZZ-4145052,SCH-ZZ-9337638,ZZ,ZZ20240515MAACCU4647.0,4647.0,Airbus A321-200,05/15/2024,2024-05-15 20:34:00,2024-05-16 17:02:00,MAA,CCU,200.0,221,109,-91,112,20,40,60,80,23,11,9,12,45,22,18,23,72,36,24,36,95,47,33,48,"{'F': 12, 'P': 8}","{'C': 16, 'J': 12, 'Z': 12}","{'Q': 18, 'R': 12, 'S': 6, 'T': 6, 'H': 12, 'M': 6}","{'Y': 6, 'A': 6, 'B': 3, 'D': 3, 'E': 3, 'G': 6, 'I': 3, 'K': 6, 'L': 3, 'N': 3, 'O': 3, 'U': 6, 'V': 3, 'W': 3, 'X': 3}"
INV-ZZ-1453947,SCH-ZZ-9337638,ZZ,ZZ20240516MAACCU4647.0,4647.0,Airbus A321-200,05/16/2024,2024-05-16 20:34:00,2024-05-17 17:02:00,MAA,CCU,200.0,231,118,-82,113,20,40,60,80,24,12,8,12,48,25,15,23,68,35,25,33,90,46,34,44,"{'F': 12, 'P': 8}","{'C': 16, 'J': 12, 'Z': 12}","{'Q': 18, 'R': 12, 'S': 6, 'T': 6, 'H': 12, 'M': 6}","{'Y': 6, 'A': 6, 'B': 3, 'D': 3, 'E': 3, 'G': 6, 'I': 3, 'K': 6, 'L': 3, 'N': 3, 'O': 3, 'U': 6, 'V': 3, 'W': 3, 'X': 3}"
INV-ZZ-6595250,SCH-ZZ-9337638,ZZ,ZZ20240517MAACCU4647.0,4647.0,Airbus A321-200,05/17/2024,2024-05-17 20:34:00,2024-05-18 17:02:00,MAA,CCU,200.0,238,124,-76,114,20,40,60,80,23,12,8,11,48,25,15,23,70,37,23,33,91,47,33,44,"{'F': 12, 'P': 8}","{'C': 16, 'J': 12, 'Z': 12}","{'Q': 18, 'R': 12, 'S': 6, 'T': 6, 'H': 12, 'M': 6}","{'Y': 6, 'A': 6, 'B': 3, 'D': 3, 'E': 3, 'G': 6, 'I': 3, 'K': 6, 'L': 3, 'N': 3, 'O': 3, 'U': 6, 'V': 3, 'W': 3, 'X': 3}"
INV-ZZ-2244388,SCH-ZZ-9337638,ZZ,ZZ20240520MAACCU4647.0,4647.0,Airbus A321-200,05/20/2024,2024-05-20 20:34:00,2024-05-21 17:02:00,MAA,CCU,200.0,232,111,-89,121,20,40,60,80,24,11,9,13,45,22,18,23,71,34,26,37,89,43,37,46,"{'F': 12, 'P': 8}","{'C': 16, 'J': 12, 'Z': 12}","{'Q': 18, 'R': 12, 'S': 6, 'T': 6, 'H': 12, 'M': 6}","{'Y': 6, 'A': 6, 'B': 3, 'D': 3, 'E': 3, 'G': 6, 'I': 3, 'K': 6, 'L': 3, 'N': 3, 'O': 3, 'U': 6, 'V': 3, 'W': 3, 'X': 3}"
INV-ZZ-3611879,SCH-ZZ-9337638,ZZ,ZZ20240521MAACCU4647.0,4647.0,Airbus A321-200,05/21/2024,2024-05-21 20:34:00,2024-05-22 17:02:00,MAA,CCU,200.0,226,106,-94,120,20,40,60,80,24,11,9,13,46,22,18,24,67,32,28,35,92,43,37,49,"{'F': 12, 'P': 8}","{'C': 16, 'J': 12, 'Z': 12}","{'Q': 18, 'R': 12, 'S': 6, 'T': 6, 'H': 12, 'M': 6}","{'Y': 6, 'A': 6, 'B': 3, 'D': 3, 'E': 3, 'G': 6, 'I': 3, 'K': 6, 'L': 3, 'N': 3, 'O': 3, 'U': 6, 'V': 3, 'W': 3, 'X': 3}"
INV-ZZ-7380088,SCH-ZZ-9337638,ZZ,ZZ20240522MAACCU4647.0,4647.0,Airbus A321-200,05/22/2024,2024-05-22 20:34:00,2024-05-23 17:02:00,MAA,CCU,200.0,228,122,-78,106,20,40,60,80,23,12,8,11,48,26,14,22,72,39,21,33,91,49,31,42,"{'F': 12, 'P': 8}","{'C': 16, 'J': 12, 'Z': 12}","{'Q': 18, 'R': 12, 'S': 6, 'T': 6, 'H': 12, 'M': 6}","{'Y': 6, 'A': 6, 'B': 3, 'D': 3, 'E': 3, 'G': 6, 'I': 3, 'K': 6, 'L': 3, 'N': 3, 'O': 3, 'U': 6, 'V': 3, 'W': 3, 'X': 3}"
INV-ZZ-5217144,SCH-ZZ-9337638,ZZ,ZZ20240523MAACCU4647.0,4647.0,Airbus A321-200,05/23/2024,2024-05-23 20:34:00,2024-05-24 17:02:00,MAA,CCU,200.0,224,117,-83,107,20,40,60,80,23,12,8,11,45,23,17,22,72,37,23,35,88,46,34,42,"{'F': 12, 'P': 8}","{'C': 16, 'J': 12, 'Z': 12}","{'Q': 18, 'R': 12, 'S': 6, 'T': 6, 'H': 12, 'M': 6}","{'Y': 6, 'A': 6, 'B': 3, 'D': 3, 'E': 3, 'G': 6, 'I': 3, 'K': 6, 'L': 3, 'N': 3, 'O': 3, 'U': 6, 'V': 3, 'W': 3, 'X': 3}"
INV-ZZ-3325306,SCH-ZZ-9337638,ZZ,ZZ20240524MAACCU4647.0,4647.0,Airbus A321-200,05/24/2024,2024-05-24 20:34:00,2024-05-25 17:02:00,MAA,CCU,200.0,233,122,-78,111,20,40,60,80,23,12,8,11,47,25,15,22,70,37,23,33,89,47,33,42,"{'F': 12, 'P': 8}","{'C': 16, 'J': 12, 'Z': 12}","{'Q': 18, 'R': 12, 'S': 6, 'T': 6, 'H': 12, 'M': 6}","{'Y': 6, 'A': 6, 'B': 3, 'D': 3, 'E': 3, 'G': 6, 'I': 3, 'K': 6, 'L': 3, 'N': 3, 'O': 3, 'U': 6, 'V': 3, 'W': 3, 'X': 3}"
INV-ZZ-7093906,SCH-ZZ-9337638,ZZ,ZZ20240527MAACCU4647.0,4647.0,Airbus A321-200,05/27/2024,2024-05-27 20:34:00,2024-05-28 17:02:00,MAA,CCU,200.0,235,123,-77,112,20,40,60,80,23,12,8,11,46,24,16,22,72,38,22,34,90,47,33,43,"{'F': 12, 'P': 8}","{'C': 16, 'J': 12, 'Z': 12}","{'Q': 18, 'R': 12, 'S': 6, 'T': 6, 'H': 12, 'M': 6}","{'Y': 6, 'A': 6, 'B': 3, 'D': 3, 'E': 3, 'G': 6, 'I': 3, 'K': 6, 'L': 3, 'N': 3, 'O': 3, 'U': 6, 'V': 3, 'W': 3, 'X': 3}"
INV-ZZ-3184341,SCH-ZZ-9337638,ZZ,ZZ20240528MAACCU4647.0,4647.0,Airbus A321-200,05/28/2024,2024-05-28 20:34:00,2024-05-29 17:02:00,MAA,CCU,200.0,223,106,-94,117,20,40,60,80,24,11,9,13,45,21,19,24,69,33,27,36,90,43,37,47,"{'F': 12, 'P': 8}","{'C': 16, 'J': 12, 'Z': 12}","{'Q': 18, 'R': 12, 'S': 6, 'T': 6, 'H': 12, 'M': 6}","{'Y': 6, 'A': 6, 'B': 3, 'D': 3, 'E': 3, 'G': 6, 'I': 3, 'K': 6, 'L': 3, 'N': 3, 'O': 3, 'U': 6, 'V': 3, 'W': 3, 'X': 3}"
INV-ZZ-4239630,SCH-ZZ-9337638,ZZ,ZZ20240529MAACCU4647.0,4647.0,Airbus A321-200,05/29/2024,2024-05-29 20:34:00,2024-05-30 17:02:00,MAA,CCU,200.0,232,114,-86,118,20,40,60,80,22,11,9,11,46,23,17,23,68,33,27,35,91,45,35,46,"{'F': 12, 'P': 8}","{'C': 16, 'J': 12, 'Z': 12}","{'Q': 18, 'R': 12, 'S': 6, 'T': 6, 'H': 12, 'M': 6}","{'Y': 6, 'A': 6, 'B': 3, 'D': 3, 'E': 3, 'G': 6, 'I': 3, 'K': 6, 'L': 3, 'N': 3, 'O': 3, 'U': 6, 'V': 3, 'W': 3, 'X': 3}"
INV-ZZ-5048738,SCH-ZZ-9337638,ZZ,ZZ20240530MAACCU4647.0,4647.0,Airbus A321-200,05/30/2024,2024-05-30 20:34:00,2024-05-31 17:02:00,MAA,CCU,200.0,239,114,-86,125,20,40,60,80,24,11,9,13,47,22,18,25,68,32,28,36,93,44,36,49,"{'F': 12, 'P': 8}","{'C': 16, 'J': 12, 'Z': 12}","{'Q': 18, 'R': 12, 'S': 6, 'T': 6, 'H': 12, 'M': 6}","{'Y': 6, 'A': 6, 'B': 3, 'D': 3, 'E': 3, 'G': 6, 'I': 3, 'K': 6, 'L': 3, 'N': 3, 'O': 3, 'U': 6, 'V': 3, 'W': 3, 'X': 3}"
INV-ZZ-8887864,SCH-ZZ-9337638,ZZ,ZZ20240531MAACCU4647.0,4647.0,Airbus A321-200,05/31/2024,2024-05-31 20:34:00,2024-06-01 17:02:00,MAA,CCU,200.0,226,101,-99,125,20,40,60,80,24,11,9,13,47,21,19,26,72,32,28,40,90,40,40,50,"{'F': 12, 'P': 8}","{'C': 16, 'J': 12, 'Z': 12}","{'Q': 18, 'R': 12, 'S': 6, 'T': 6, 'H': 12, 'M': 6}","{'Y': 6, 'A': 6, 'B': 3, 'D': 3, 'E': 3, 'G': 6, 'I': 3, 'K': 6, 'L': 3, 'N': 3, 'O': 3, 'U': 6, 'V': 3, 'W': 3, 'X': 3}"
INV-ZZ-5157999,SCH-ZZ-9337638,ZZ,ZZ20240603MAACCU4647.0,4647.0,Airbus A321-200,06/03/2024,2024-06-03 20:34:00,2024-06-04 17:02:00,MAA,CCU,200.0,235,119,-81,116,20,40,60,80,22,11,9,11,47,24,16,23,71,36,24,35,92,47,33,45,"{'F': 12, 'P': 8}","{'C': 16, 'J': 12, 'Z': 12}","{'Q': 18, 'R': 12, 'S': 6, 'T': 6, 'H': 12, 'M': 6}","{'Y': 6, 'A': 6, 'B': 3, 'D': 3, 'E': 3, 'G': 6, 'I': 3, 'K': 6, 'L': 3, 'N': 3, 'O': 3, 'U': 6, 'V': 3, 'W': 3, 'X': 3}"
INV-ZZ-3152415,SCH-ZZ-9337638,ZZ,ZZ20240604MAACCU4647.0,4647.0,Airbus A321-200,06/04/2024,2024-06-04 20:34:00,2024-06-05 17:02:00,MAA,CCU,200.0,236,118,-82,118,20,40,60,80,22,11,9,11,44,22,18,22,67,34,26,33,95,48,32,47,"{'F': 12, 'P': 8}","{'C': 16, 'J': 12, 'Z': 12}","{'Q': 18, 'R': 12, 'S': 6, 'T': 6, 'H': 12, 'M': 6}","{'Y': 6, 'A': 6, 'B': 3, 'D': 3, 'E': 3, 'G': 6, 'I': 3, 'K': 6, 'L': 3, 'N': 3, 'O': 3, 'U': 6, 'V': 3, 'W': 3, 'X': 3}"
INV-ZZ-2416555,SCH-ZZ-8796700,ZZ,ZZ20240417CCUBLR3294.0,3294.0,Airbus A320-200,04/17/2024,2024-04-17 14:54:00,2024-04-18 11:38:00,CCU,BLR,150.0,172,102,-48,70,15,30,45,60,18,11,4,7,35,21,9,14,51,30,15,21,71,42,18,29,"{'F': 9, 'P': 6}","{'C': 12, 'J': 9, 'Z': 9}","{'Q': 14, 'R': 9, 'S': 4, 'T': 4, 'H': 9, 'M': 4}","{'Y': 4, 'A': 4, 'B': 2, 'D': 2, 'E': 2, 'G': 4, 'I': 2, 'K': 4, 'L': 2, 'N': 2, 'O': 2, 'U': 4, 'V': 2, 'W': 2, 'X': 2}"
INV-ZZ-4979081,SCH-ZZ-8796700,ZZ,ZZ20240420CCUBLR3294.0,3294.0,Airbus A320-200,04/20/2024,2024-04-20 14:54:00,2024-04-21 11:38:00,CCU,BLR,150.0,171,97,-53,74,15,30,45,60,17,10,5,7,35,20,10,15,53,30,15,23,66,37,23,29,"{'F': 9, 'P': 6}","{'C': 12, 'J': 9, 'Z': 9}","{'Q': 14, 'R': 9, 'S': 4, 'T': 4, 'H': 9, 'M': 4}","{'Y': 4, 'A': 4, 'B': 2, 'D': 2, 'E': 2, 'G': 4, 'I': 2, 'K': 4, 'L': 2, 'N': 2, 'O': 2, 'U': 4, 'V': 2, 'W': 2, 'X': 2}"
INV-ZZ-1979920,SCH-ZZ-8796700,ZZ,ZZ20240421CCUBLR3294.0,3294.0,Airbus A320-200,04/21/2024,2024-04-21 14:54:00,2024-04-22 11:38:00,CCU,BLR,150.0,172,95,-55,77,15,30,45,60,18,10,5,8,36,20,10,16,53,29,16,24,70,39,21,31,"{'F': 9, 'P': 6}","{'C': 12, 'J': 9, 'Z': 9}","{'Q': 14, 'R': 9, 'S': 4, 'T': 4, 'H': 9, 'M': 4}","{'Y': 4, 'A': 4, 'B': 2, 'D': 2, 'E': 2, 'G': 4, 'I': 2, 'K': 4, 'L': 2, 'N': 2, 'O': 2, 'U': 4, 'V': 2, 'W': 2, 'X': 2}"
INV-ZZ-5036865,SCH-ZZ-8796700,ZZ,ZZ20240422CCUBLR3294.0,3294.0,Airbus A320-200,04/22/2024,2024-04-22 14:54:00,2024-04-23 11:38:00,CCU,BLR,150.0,171,101,-49,70,15,30,45,60,18,11,4,7,35,21,9,14,51,30,15,21,72,43,17,29,"{'F': 9, 'P': 6}","{'C': 12, 'J': 9, 'Z': 9}","{'Q': 14, 'R': 9, 'S': 4, 'T': 4, 'H': 9, 'M': 4}","{'Y': 4, 'A': 4, 'B': 2, 'D': 2, 'E': 2, 'G': 4, 'I': 2, 'K': 4, 'L': 2, 'N': 2, 'O': 2, 'U': 4, 'V': 2, 'W': 2, 'X': 2}"
INV-ZZ-3342280,SCH-ZZ-8796700,ZZ,ZZ20240423CCUBLR3294.0,3294.0,Airbus A320-200,04/23/2024,2024-04-23 14:54:00,2024-04-24 11:38:00,CCU,BLR,150.0,168,101,-49,67,15,30,45,60,18,11,4,7,35,21,9,14,53,32,13,21,70,42,18,28,"{'F': 9, 'P': 6}","{'C': 12, 'J': 9, 'Z': 9}","{'Q': 14, 'R': 9, 'S': 4, 'T': 4, 'H': 9, 'M': 4}","{'Y': 4, 'A': 4, 'B': 2, 'D': 2, 'E': 2, 'G': 4, 'I': 2, 'K': 4, 'L': 2, 'N': 2, 'O': 2, 'U': 4, 'V': 2, 'W': 2, 'X': 2}"
INV-ZZ-8212813,SCH-ZZ-8796700,ZZ,ZZ20240424CCUBLR3294.0,3294.0,Airbus A320-200,04/24/2024,2024-04-24 14:54:00,2024-04-25 11:38:00,CCU,BLR,150.0,174,94,-56,80,15,30,45,60,18,10,5,8,35,19,11,16,53,29,16,24,72,39,21,33,"{'F': 9, 'P': 6}","{'C': 12, 'J': 9, 'Z': 9}","{'Q': 14, 'R': 9, 'S': 4, 'T': 4, 'H': 9, 'M': 4}","{'Y': 4, 'A': 4, 'B': 2, 'D': 2, 'E': 2, 'G': 4, 'I': 2, 'K': 4, 'L': 2, 'N': 2, 'O': 2, 'U': 4, 'V': 2, 'W': 2, 'X': 2}"
INV-ZZ-1356544,SCH-ZZ-8796700,ZZ,ZZ20240427CCUBLR3294.0,3294.0,Airbus A320-200,04/27/2024,2024-04-27 14:54:00,2024-04-28 11:38:00,CCU,BLR,150.0,173,95,-55,78,15,30,45,60,18,10,5,8,33,18,12,15,50,28,17,22,70,39,21,31,"{'F': 9, 'P': 6}","{'C': 12, 'J': 9, 'Z': 9}","{'Q': 14, 'R': 9, 'S': 4, 'T': 4, 'H': 9, 'M': 4}","{'Y': 4, 'A': 4, 'B': 2, 'D': 2, 'E': 2, 'G': 4, 'I': 2, 'K': 4, 'L': 2, 'N': 2, 'O': 2, 'U': 4, 'V': 2, 'W': 2, 'X': 2}"
INV-ZZ-4762308,SCH-ZZ-8796700,ZZ,ZZ20240428CCUBLR3294.0,3294.0,Airbus A320-200,04/28/2024,2024-04-28 14:54:00,2024-04-29 11:38:00,CCU,BLR,150.0,170,92,-58,78,15,30,45,60,18,10,5,8,34,18,12,16,53,29,16,24,67,36,24,31,"{'F': 9, 'P': 6}","{'C': 12, 'J': 9, 'Z': 9}","{'Q': 14, 'R': 9, 'S': 4, 'T': 4, 'H': 9, 'M': 4}","{'Y': 4, 'A': 4, 'B': 2, 'D': 2, 'E': 2, 'G': 4, 'I': 2, 'K': 4, 'L': 2, 'N': 2, 'O': 2, 'U': 4, 'V': 2, 'W': 2, 'X': 2}"
INV-ZZ-8240789,SCH-ZZ-8796700,ZZ,ZZ20240429CCUBLR3294.0,3294.0,Airbus A320-200,04/29/2024,2024-04-29 14:54:00,2024-04-30 11:38:00,CCU,BLR,150.0,179,95,-55,84,15,30,45,60,17,9,6,8,33,17,13,16,50,26,19,24,67,35,25,32,"{'F': 9, 'P': 6}","{'C': 12, 'J': 9, 'Z': 9}","{'Q': 14, 'R': 9, 'S': 4, 'T': 4, 'H': 9, 'M': 4}","{'Y': 4, 'A': 4, 'B': 2, 'D': 2, 'E': 2, 'G': 4, 'I': 2, 'K': 4, 'L': 2, 'N': 2, 'O': 2, 'U': 4, 'V': 2, 'W': 2, 'X': 2}"
INV-ZZ-1351331,SCH-ZZ-8796700,ZZ,ZZ20240430CCUBLR3294.0,3294.0,Airbus A320-200,04/30/2024,2024-04-30 14:54:00,2024-05-01 11:38:00,CCU,BLR,150.0,178,105,-45,73,15,30,45,60,18,11,4,7,33,19,11,14,51,30,15,21,67,40,20,27,"{'F': 9, 'P': 6}","{'C': 12, 'J': 9, 'Z': 9}","{'Q': 14, 'R': 9, 'S': 4, 'T': 4, 'H': 9, 'M': 4}","{'Y': 4, 'A': 4, 'B': 2, 'D': 2, 'E': 2, 'G': 4, 'I': 2, 'K': 4, 'L': 2, 'N': 2, 'O': 2, 'U': 4, 'V': 2, 'W': 2, 'X': 2}"
INV-ZZ-3372385,SCH-ZZ-8796700,ZZ,ZZ20240501CCUBLR3294.0,3294.0,Airbus A320-200,05/01/2024,2024-05-01 14:54:00,2024-05-02 11:38:00,CCU,BLR,150.0,167,100,-50,67,15,30,45,60,17,10,5,7,34,20,10,14,50,30,15,20,68,41,19,27,"{'F': 9, 'P': 6}","{'C': 12, 'J': 9, 'Z': 9}","{'Q': 14, 'R': 9, 'S': 4, 'T': 4, 'H': 9, 'M': 4}","{'Y': 4, 'A': 4, 'B': 2, 'D': 2, 'E': 2, 'G': 4, 'I': 2, 'K': 4, 'L': 2, 'N': 2, 'O': 2, 'U': 4, 'V': 2, 'W': 2, 'X': 2}"
INV-ZZ-4149618,SCH-ZZ-8796700,ZZ,ZZ20240504CCUBLR3294.0,3294.0,Airbus A320-200,05/04/2024,2024-05-04 14:54:00,2024-05-05 11:38:00,CCU,BLR,150.0,174,89,-61,85,15,30,45,60,17,9,6,8,35,18,12,17,54,28,17,26,70,36,24,34,"{'F': 9, 'P': 6}","{'C': 12, 'J': 9, 'Z': 9}","{'Q': 14, 'R': 9, 'S': 4, 'T': 4, 'H': 9, 'M': 4}","{'Y': 4, 'A': 4, 'B': 2, 'D': 2, 'E': 2, 'G': 4, 'I': 2, 'K': 4, 'L': 2, 'N': 2, 'O': 2, 'U': 4, 'V': 2, 'W': 2, 'X': 2}"
INV-ZZ-5744710,SCH-ZZ-8796700,ZZ,ZZ20240505CCUBLR3294.0,3294.0,Airbus A320-200,05/05/2024,2024-05-05 14:54:00,2024-05-06 11:38:00,CCU,BLR,150.0,171,94,-56,77,15,30,45,60,17,9,6,8,35,19,11,16,53,29,16,24,68,37,23,31,"{'F': 9, 'P': 6}","{'C': 12, 'J': 9, 'Z': 9}","{'Q': 14, 'R': 9, 'S': 4, 'T': 4, 'H': 9, 'M': 4}","{'Y': 4, 'A': 4, 'B': 2, 'D': 2, 'E': 2, 'G': 4, 'I': 2, 'K': 4, 'L': 2, 'N': 2, 'O': 2, 'U': 4, 'V': 2, 'W': 2, 'X': 2}"
INV-ZZ-6382411,SCH-ZZ-8796700,ZZ,ZZ20240506CCUBLR3294.0,3294.0,Airbus A320-200,05/06/2024,2024-05-06 14:54:00,2024-05-07 11:38:00,CCU,BLR,150.0,176,89,-61,87,15,30,45,60,17,9,6,8,34,17,13,17,52,26,19,26,70,35,25,35,"{'F': 9, 'P': 6}","{'C': 12, 'J': 9, 'Z': 9}","{'Q': 14, 'R': 9, 'S': 4, 'T': 4, 'H': 9, 'M': 4}","{'Y': 4, 'A': 4, 'B': 2, 'D': 2, 'E': 2, 'G': 4, 'I': 2, 'K': 4, 'L': 2, 'N': 2, 'O': 2, 'U': 4, 'V': 2, 'W': 2, 'X': 2}"
INV-ZZ-1364961,SCH-ZZ-8796700,ZZ,ZZ20240507CCUBLR3294.0,3294.0,Airbus A320-200,05/07/2024,2024-05-07 14:54:00,2024-05-08 11:38:00,CCU,BLR,150.0,178,104,-46,74,15,30,45,60,18,11,4,7,34,20,10,14,52,30,15,22,67,39,21,28,"{'F': 9, 'P': 6}","{'C': 12, 'J': 9, 'Z': 9}","{'Q': 14, 'R': 9, 'S': 4, 'T': 4, 'H': 9, 'M': 4}","{'Y': 4, 'A': 4, 'B': 2, 'D': 2, 'E': 2, 'G': 4, 'I': 2, 'K': 4, 'L': 2, 'N': 2, 'O': 2, 'U': 4, 'V': 2, 'W': 2, 'X': 2}"
INV-ZZ-6544559,SCH-ZZ-8796700,ZZ,ZZ20240508CCUBLR3294.0,3294.0,Airbus A320-200,05/08/2024,2024-05-08 14:54:00,2024-05-09 11:38:00,CCU,BLR,150.0,173,96,-54,77,15,30,45,60,18,10,5,8,35,19,11,16,53,29,16,24,71,39,21,32,"{'F': 9, 'P': 6}","{'C': 12, 'J': 9, 'Z': 9}","{'Q': 14, 'R': 9, 'S': 4, 'T': 4, 'H': 9, 'M': 4}","{'Y': 4, 'A': 4, 'B': 2, 'D': 2, 'E': 2, 'G': 4, 'I': 2, 'K': 4, 'L': 2, 'N': 2, 'O': 2, 'U': 4, 'V': 2, 'W': 2, 'X': 2}"
INV-ZZ-4166932,SCH-ZZ-8796700,ZZ,ZZ20240511CCUBLR3294.0,3294.0,Airbus A320-200,05/11/2024,2024-05-11 14:54:00,2024-05-12 11:38:00,CCU,BLR,150.0,170,90,-60,80,15,30,45,60,17,9,6,8,34,18,12,16,52,27,18,25,68,36,24,32,"{'F': 9, 'P': 6}","{'C': 12, 'J': 9, 'Z': 9}","{'Q': 14, 'R': 9, 'S': 4, 'T': 4, 'H': 9, 'M': 4}","{'Y': 4, 'A': 4, 'B': 2, 'D': 2, 'E': 2, 'G': 4, 'I': 2, 'K': 4, 'L': 2, 'N': 2, 'O': 2, 'U': 4, 'V': 2, 'W': 2, 'X': 2}"
INV-ZZ-2681631,SCH-ZZ-8796700,ZZ,ZZ20240512CCUBLR3294.0,3294.0,Airbus A320-200,05/12/2024,2024-05-12 14:54:00,2024-05-13 11:38:00,CCU,BLR,150.0,166,87,-63,79,15,30,45,60,17,9,6,8,35,18,12,17,53,28,17,25,69,36,24,33,"{'F': 9, 'P': 6}","{'C': 12, 'J': 9, 'Z': 9}","{'Q': 14, 'R': 9, 'S': 4, 'T': 4, 'H': 9, 'M': 4}","{'Y': 4, 'A': 4, 'B': 2, 'D': 2, 'E': 2, 'G': 4, 'I': 2, 'K': 4, 'L': 2, 'N': 2, 'O': 2, 'U': 4, 'V': 2, 'W': 2, 'X': 2}"
INV-ZZ-5165594,SCH-ZZ-8796700,ZZ,ZZ20240513CCUBLR3294.0,3294.0,Airbus A320-200,05/13/2024,2024-05-13 14:54:00,2024-05-14 11:38:00,CCU,BLR,150.0,169,94,-56,75,15,30,45,60,17,9,6,8,33,18,12,15,52,29,16,23,67,37,23,30,"{'F': 9, 'P': 6}","{'C': 12, 'J': 9, 'Z': 9}","{'Q': 14, 'R': 9, 'S': 4, 'T': 4, 'H': 9, 'M': 4}","{'Y': 4, 'A': 4, 'B': 2, 'D': 2, 'E': 2, 'G': 4, 'I': 2, 'K': 4, 'L': 2, 'N': 2, 'O': 2, 'U': 4, 'V': 2, 'W': 2, 'X': 2}"
INV-ZZ-6762402,SCH-ZZ-8796700,ZZ,ZZ20240514CCUBLR3294.0,3294.0,Airbus A320-200,05/14/2024,2024-05-14 14:54:00,2024-05-15 11:38:00,CCU,BLR,150.0,170,85,-65,85,15,30,45,60,18,9,6,9,33,16,14,17,51,25,20,26,70,35,25,35,"{'F': 9, 'P': 6}","{'C': 12, 'J': 9, 'Z': 9}","{'Q': 14, 'R': 9, 'S': 4, 'T': 4, 'H': 9, 'M': 4}","{'Y': 4, 'A': 4, 'B': 2, 'D': 2, 'E': 2, 'G': 4, 'I': 2, 'K': 4, 'L': 2, 'N': 2, 'O': 2, 'U': 4, 'V': 2, 'W': 2, 'X': 2}"
INV-ZZ-1295587,SCH-ZZ-8796700,ZZ,ZZ20240515CCUBLR3294.0,3294.0,Airbus A320-200,05/15/2024,2024-05-15 14:54:00,2024-05-16 11:38:00,CCU,BLR,150.0,179,87,-63,92,15,30,45,60,17,8,7,9,35,17,13,18,50,24,21,26,71,35,25,36,"{'F': 9, 'P': 6}","{'C': 12, 'J': 9, 'Z': 9}","{'Q': 14, 'R': 9, 'S': 4, 'T': 4, 'H': 9, 'M': 4}","{'Y': 4, 'A': 4, 'B': 2, 'D': 2, 'E': 2, 'G': 4, 'I': 2, 'K': 4, 'L': 2, 'N': 2, 'O': 2, 'U': 4, 'V': 2, 'W': 2, 'X': 2}"
INV-ZZ-5567149,SCH-ZZ-8796700,ZZ,ZZ20240518CCUBLR3294.0,3294.0,Airbus A320-200,05/18/2024,2024-05-18 14:54:00,2024-05-19 11:38:00,CCU,BLR,150.0,167,90,-60,77,15,30,45,60,17,9,6,8,33,18,12,15,51,27,18,24,70,38,22,32,"{'F': 9, 'P': 6}","{'C': 12, 'J': 9, 'Z': 9}","{'Q': 14, 'R': 9, 'S': 4, 'T': 4, 'H': 9, 'M': 4}","{'Y': 4, 'A': 4, 'B': 2, 'D': 2, 'E': 2, 'G': 4, 'I': 2, 'K': 4, 'L': 2, 'N': 2, 'O': 2, 'U': 4, 'V': 2, 'W': 2, 'X': 2}"
INV-ZZ-2334505,SCH-ZZ-8796700,ZZ,ZZ20240519CCUBLR3294.0,3294.0,Airbus A320-200,05/19/2024,2024-05-19 14:54:00,2024-05-20 11:38:00,CCU,BLR,150.0,179,95,-55,84,15,30,45,60,18,10,5,8,35,18,12,17,51,27,18,24,70,37,23,33,"{'F': 9, 'P': 6}","{'C': 12, 'J': 9, 'Z': 9}","{'Q': 14, 'R': 9, 'S': 4, 'T': 4, 'H': 9, 'M': 4}","{'Y': 4, 'A': 4, 'B': 2, 'D': 2, 'E': 2, 'G': 4, 'I': 2, 'K': 4, 'L': 2, 'N': 2, 'O': 2, 'U': 4, 'V': 2, 'W': 2, 'X': 2}"
INV-ZZ-7302915,SCH-ZZ-8796700,ZZ,ZZ20240520CCUBLR3294.0,3294.0,Airbus A320-200,05/20/2024,2024-05-20 14:54:00,2024-05-21 11:38:00,CCU,BLR,150.0,176,92,-58,84,15,30,45,60,17,9,6,8,34,18,12,16,50,26,19,24,70,36,24,34,"{'F': 9, 'P': 6}","{'C': 12, 'J': 9, 'Z': 9}","{'Q': 14, 'R': 9, 'S': 4, 'T': 4, 'H': 9, 'M': 4}","{'Y': 4, 'A': 4, 'B': 2, 'D': 2, 'E': 2, 'G': 4, 'I': 2, 'K': 4, 'L': 2, 'N': 2, 'O': 2, 'U': 4, 'V': 2, 'W': 2, 'X': 2}"
INV-ZZ-8435346,SCH-ZZ-8796700,ZZ,ZZ20240521CCUBLR3294.0,3294.0,Airbus A320-200,05/21/2024,2024-05-21 14:54:00,2024-05-22 11:38:00,CCU,BLR,150.0,172,85,-65,87,15,30,45,60,17,8,7,9,34,17,13,17,50,25,20,25,70,34,26,36,"{'F': 9, 'P': 6}","{'C': 12, 'J': 9, 'Z': 9}","{'Q': 14, 'R': 9, 'S': 4, 'T': 4, 'H': 9, 'M': 4}","{'Y': 4, 'A': 4, 'B': 2, 'D': 2, 'E': 2, 'G': 4, 'I': 2, 'K': 4, 'L': 2, 'N': 2, 'O': 2, 'U': 4, 'V': 2, 'W': 2, 'X': 2}"
INV-ZZ-7205479,SCH-ZZ-8796700,ZZ,ZZ20240522CCUBLR3294.0,3294.0,Airbus A320-200,05/22/2024,2024-05-22 14:54:00,2024-05-23 11:38:00,CCU,BLR,150.0,176,85,-65,91,15,30,45,60,17,8,7,9,35,17,13,18,50,24,21,26,71,34,26,37,"{'F': 9, 'P': 6}","{'C': 12, 'J': 9, 'Z': 9}","{'Q': 14, 'R': 9, 'S': 4, 'T': 4, 'H': 9, 'M': 4}","{'Y': 4, 'A': 4, 'B': 2, 'D': 2, 'E': 2, 'G': 4, 'I': 2, 'K': 4, 'L': 2, 'N': 2, 'O': 2, 'U': 4, 'V': 2, 'W': 2, 'X': 2}"
INV-ZZ-8125083,SCH-ZZ-8796700,ZZ,ZZ20240525CCUBLR3294.0,3294.0,Airbus A320-200,05/25/2024,2024-05-25 14:54:00,2024-05-26 11:38:00,CCU,BLR,150.0,174,80,-70,94,15,30,45,60,18,8,7,10,35,16,14,19,50,23,22,27,67,31,29,36,"{'F': 9, 'P': 6}","{'C': 12, 'J': 9, 'Z': 9}","{'Q': 14, 'R': 9, 'S': 4, 'T': 4, 'H': 9, 'M': 4}","{'Y': 4, 'A': 4, 'B': 2, 'D': 2, 'E': 2, 'G': 4, 'I': 2, 'K': 4, 'L': 2, 'N': 2, 'O': 2, 'U': 4, 'V': 2, 'W': 2, 'X': 2}"
INV-ZZ-7300616,SCH-ZZ-8796700,ZZ,ZZ20240526CCUBLR3294.0,3294.0,Airbus A320-200,05/26/2024,2024-05-26 14:54:00,2024-05-27 11:38:00,CCU,BLR,150.0,172,79,-71,93,15,30,45,60,18,8,7,10,33,15,15,18,54,25,20,29,67,31,29,36,"{'F': 9, 'P': 6}","{'C': 12, 'J': 9, 'Z': 9}","{'Q': 14, 'R': 9, 'S': 4, 'T': 4, 'H': 9, 'M': 4}","{'Y': 4, 'A': 4, 'B': 2, 'D': 2, 'E': 2, 'G': 4, 'I': 2, 'K': 4, 'L': 2, 'N': 2, 'O': 2, 'U': 4, 'V': 2, 'W': 2, 'X': 2}"
INV-ZZ-5355014,SCH-ZZ-8796700,ZZ,ZZ20240527CCUBLR3294.0,3294.0,Airbus A320-200,05/27/2024,2024-05-27 14:54:00,2024-05-28 11:38:00,CCU,BLR,150.0,165,85,-65,80,15,30,45,60,17,9,6,8,35,18,12,17,53,27,18,26,71,37,23,34,"{'F': 9, 'P': 6}","{'C': 12, 'J': 9, 'Z': 9}","{'Q': 14, 'R': 9, 'S': 4, 'T': 4, 'H': 9, 'M': 4}","{'Y': 4, 'A': 4, 'B': 2, 'D': 2, 'E': 2, 'G': 4, 'I': 2, 'K': 4, 'L': 2, 'N': 2, 'O': 2, 'U': 4, 'V': 2, 'W': 2, 'X': 2}"
INV-ZZ-3826366,SCH-ZZ-8796700,ZZ,ZZ20240528CCUBLR3294.0,3294.0,Airbus A320-200,05/28/2024,2024-05-28 14:54:00,2024-05-29 11:38:00,CCU,BLR,150.0,173,81,-69,92,15,30,45,60,17,8,7,9,35,16,14,19,52,24,21,28,71,33,27,38,"{'F': 9, 'P': 6}","{'C': 12, 'J': 9, 'Z': 9}","{'Q': 14, 'R': 9, 'S': 4, 'T': 4, 'H': 9, 'M': 4}","{'Y': 4, 'A': 4, 'B': 2, 'D': 2, 'E': 2, 'G': 4, 'I': 2, 'K': 4, 'L': 2, 'N': 2, 'O': 2, 'U': 4, 'V': 2, 'W': 2, 'X': 2}"
INV-ZZ-4728213,SCH-ZZ-8796700,ZZ,ZZ20240529CCUBLR3294.0,3294.0,Airbus A320-200,05/29/2024,2024-05-29 14:54:00,2024-05-30 11:38:00,CCU,BLR,150.0,175,78,-72,97,15,30,45,60,17,8,7,9,35,16,14,19,51,23,22,28,72,32,28,40,"{'F': 9, 'P': 6}","{'C': 12, 'J': 9, 'Z': 9}","{'Q': 14, 'R': 9, 'S': 4, 'T': 4, 'H': 9, 'M': 4}","{'Y': 4, 'A': 4, 'B': 2, 'D': 2, 'E': 2, 'G': 4, 'I': 2, 'K': 4, 'L': 2, 'N': 2, 'O': 2, 'U': 4, 'V': 2, 'W': 2, 'X': 2}"
INV-ZZ-1078852,SCH-ZZ-8796700,ZZ,ZZ20240601CCUBLR3294.0,3294.0,Airbus A320-200,06/01/2024,2024-06-01 14:54:00,2024-06-02 11:38:00,CCU,BLR,150.0,178,82,-68,96,15,30,45,60,17,8,7,9,36,17,13,19,52,24,21,28,67,31,29,36,"{'F': 9, 'P': 6}","{'C': 12, 'J': 9, 'Z': 9}","{'Q': 14, 'R': 9, 'S': 4, 'T': 4, 'H': 9, 'M': 4}","{'Y': 4, 'A': 4, 'B': 2, 'D': 2, 'E': 2, 'G': 4, 'I': 2, 'K': 4, 'L': 2, 'N': 2, 'O': 2, 'U': 4, 'V': 2, 'W': 2, 'X': 2}"
INV-ZZ-1051714,SCH-ZZ-1209990,ZZ,ZZ20240503BOMMAA3355.0,3355.0,Boeing 787,05/03/2024,2024-05-03 10:32:00,2024-05-03 13:38:00,BOM,MAA,270.0,302,157,-113,145,27,54,81,108,31,16,11,15,64,33,21,31,91,47,34,44,126,66,42,60,"{'F': 16, 'P': 11}","{'C': 22, 'J': 16, 'Z': 16}","{'Q': 24, 'R': 16, 'S': 8, 'T': 8, 'H': 16, 'M': 8}","{'Y': 8, 'A': 8, 'B': 4, 'D': 4, 'E': 4, 'G': 8, 'I': 4, 'K': 8, 'L': 4, 'N': 4, 'O': 4, 'U': 8, 'V': 4, 'W': 4, 'X': 4}"
INV-ZZ-9275796,SCH-ZZ-1209990,ZZ,ZZ20240504BOMMAA3355.0,3355.0,Boeing 787,05/04/2024,2024-05-04 10:32:00,2024-05-04 13:38:00,BOM,MAA,270.0,319,163,-107,156,27,54,81,108,32,16,11,16,63,32,22,31,96,49,32,47,129,66,42,63,"{'F': 16, 'P': 11}","{'C': 22, 'J': 16, 'Z': 16}","{'Q': 24, 'R': 16, 'S': 8, 'T': 8, 'H': 16, 'M': 8}","{'Y': 8, 'A': 8, 'B': 4, 'D': 4, 'E': 4, 'G': 8, 'I': 4, 'K': 8, 'L': 4, 'N': 4, 'O': 4, 'U': 8, 'V': 4, 'W': 4, 'X': 4}"
INV-ZZ-4558029,SCH-ZZ-1209990,ZZ,ZZ20240505BOMMAA3355.0,3355.0,Boeing 787,05/05/2024,2024-05-05 10:32:00,2024-05-05 13:38:00,BOM,MAA,270.0,310,175,-95,135,27,54,81,108,32,18,9,14,64,36,18,28,92,52,29,40,127,72,36,55,"{'F': 16, 'P': 11}","{'C': 22, 'J': 16, 'Z': 16}","{'Q': 24, 'R': 16, 'S': 8, 'T': 8, 'H': 16, 'M': 8}","{'Y': 8, 'A': 8, 'B': 4, 'D': 4, 'E': 4, 'G': 8, 'I': 4, 'K': 8, 'L': 4, 'N': 4, 'O': 4, 'U': 8, 'V': 4, 'W': 4, 'X': 4}"
INV-ZZ-5968228,SCH-ZZ-1209990,ZZ,ZZ20240510BOMMAA3355.0,3355.0,Boeing 787,05/10/2024,2024-05-10 10:32:00,2024-05-10 13:38:00,BOM,MAA,270.0,315,176,-94,139,27,54,81,108,31,17,10,14,62,35,19,27,91,51,30,40,121,68,40,53,"{'F': 16, 'P': 11}","{'C': 22, 'J': 16, 'Z': 16}","{'Q': 24, 'R': 16, 'S': 8, 'T': 8, 'H': 16, 'M': 8}","{'Y': 8, 'A': 8, 'B': 4, 'D': 4, 'E': 4, 'G': 8, 'I': 4, 'K': 8, 'L': 4, 'N': 4, 'O': 4, 'U': 8, 'V': 4, 'W': 4, 'X': 4}"
INV-ZZ-1050351,SCH-ZZ-1209990,ZZ,ZZ20240511BOMMAA3355.0,3355.0,Boeing 787,05/11/2024,2024-05-11 10:32:00,2024-05-11 13:38:00,BOM,MAA,270.0,322,171,-99,151,27,54,81,108,32,17,10,15,61,32,22,29,96,51,30,45,119,63,45,56,"{'F': 16, 'P': 11}","{'C': 22, 'J': 16, 'Z': 16}","{'Q': 24, 'R': 16, 'S': 8, 'T': 8, 'H': 16, 'M': 8}","{'Y': 8, 'A': 8, 'B': 4, 'D': 4, 'E': 4, 'G': 8, 'I': 4, 'K': 8, 'L': 4, 'N': 4, 'O': 4, 'U': 8, 'V': 4, 'W': 4, 'X': 4}"
INV-ZZ-4488406,SCH-ZZ-1209990,ZZ,ZZ20240512BOMMAA3355.0,3355.0,Boeing 787,05/12/2024,2024-05-12 10:32:00,2024-05-12 13:38:00,BOM,MAA,270.0,305,152,-118,153,27,54,81,108,31,15,12,16,60,30,24,30,95,47,34,48,129,64,44,65,"{'F': 16, 'P': 11}","{'C': 22, 'J': 16, 'Z': 16}","{'Q': 24, 'R': 16, 'S': 8, 'T': 8, 'H': 16, 'M': 8}","{'Y': 8, 'A': 8, 'B': 4, 'D': 4, 'E': 4, 'G': 8, 'I': 4, 'K': 8, 'L': 4, 'N': 4, 'O': 4, 'U': 8, 'V': 4, 'W': 4, 'X': 4}"
INV-ZZ-9099376,SCH-ZZ-1209990,ZZ,ZZ20240517BOMMAA3355.0,3355.0,Boeing 787,05/17/2024,2024-05-17 10:32:00,2024-05-17 13:38:00,BOM,MAA,270.0,302,164,-106,138,27,54,81,108,30,16,11,14,63,34,20,29,92,50,31,42,128,70,38,58,"{'F': 16, 'P': 11}","{'C': 22, 'J': 16, 'Z': 16}","{'Q': 24, 'R': 16, 'S': 8, 'T': 8, 'H': 16, 'M': 8}","{'Y': 8, 'A': 8, 'B': 4, 'D': 4, 'E': 4, 'G': 8, 'I': 4, 'K': 8, 'L': 4, 'N': 4, 'O': 4, 'U': 8, 'V': 4, 'W': 4, 'X': 4}"
INV-ZZ-6599286,SCH-ZZ-1209990,ZZ,ZZ20240518BOMMAA3355.0,3355.0,Boeing 787,05/18/2024,2024-05-18 10:32:00,2024-05-18 13:38:00,BOM,MAA,270.0,314,168,-102,146,27,54,81,108,31,17,10,14,60,32,22,28,93,50,31,43,129,69,39,60,"{'F': 16, 'P': 11}","{'C': 22, 'J': 16, 'Z': 16}","{'Q': 24, 'R': 16, 'S': 8, 'T': 8, 'H': 16, 'M': 8}","{'Y': 8, 'A': 8, 'B': 4, 'D': 4, 'E': 4, 'G': 8, 'I': 4, 'K': 8, 'L': 4, 'N': 4, 'O': 4, 'U': 8, 'V': 4, 'W': 4, 'X': 4}"
INV-ZZ-4567172,SCH-ZZ-1209990,ZZ,ZZ20240519BOMMAA3355.0,3355.0,Boeing 787,05/19/2024,2024-05-19 10:32:00,2024-05-19 13:38:00,BOM,MAA,270.0,305,158,-112,147,27,54,81,108,30,16,11,14,61,32,22,29,91,47,34,44,129,67,41,62,"{'F': 16, 'P': 11}","{'C': 22, 'J': 16, 'Z': 16}","{'Q': 24, 'R': 16, 'S': 8, 'T': 8, 'H': 16, 'M': 8}","{'Y': 8, 'A': 8, 'B': 4, 'D': 4, 'E': 4, 'G': 8, 'I': 4, 'K': 8, 'L': 4, 'N': 4, 'O': 4, 'U': 8, 'V': 4, 'W': 4, 'X': 4}"
INV-ZZ-1599346,SCH-ZZ-1209990,ZZ,ZZ20240524BOMMAA3355.0,3355.0,Boeing 787,05/24/2024,2024-05-24 10:32:00,2024-05-24 13:38:00,BOM,MAA,270.0,300,148,-122,152,27,54,81,108,31,15,12,16,63,31,23,32,91,45,36,46,128,63,45,65,"{'F': 16, 'P': 11}","{'C': 22, 'J': 16, 'Z': 16}","{'Q': 24, 'R': 16, 'S': 8, 'T': 8, 'H': 16, 'M': 8}","{'Y': 8, 'A': 8, 'B': 4, 'D': 4, 'E': 4, 'G': 8, 'I': 4, 'K': 8, 'L': 4, 'N': 4, 'O': 4, 'U': 8, 'V': 4, 'W': 4, 'X': 4}"
INV-ZZ-5292048,SCH-ZZ-1209990,ZZ,ZZ20240525BOMMAA3355.0,3355.0,Boeing 787,05/25/2024,2024-05-25 10:32:00,2024-05-25 13:38:00,BOM,MAA,270.0,308,158,-112,150,27,54,81,108,31,16,11,15,61,31,23,30,93,48,33,45,119,61,47,58,"{'F': 16, 'P': 11}","{'C': 22, 'J': 16, 'Z': 16}","{'Q': 24, 'R': 16, 'S': 8, 'T': 8, 'H': 16, 'M': 8}","{'Y': 8, 'A': 8, 'B': 4, 'D': 4, 'E': 4, 'G': 8, 'I': 4, 'K': 8, 'L': 4, 'N': 4, 'O': 4, 'U': 8, 'V': 4, 'W': 4, 'X': 4}"
INV-ZZ-2998493,SCH-ZZ-1209990,ZZ,ZZ20240526BOMMAA3355.0,3355.0,Boeing 787,05/26/2024,2024-05-26 10:32:00,2024-05-26 13:38:00,BOM,MAA,270.0,315,148,-122,167,27,54,81,108,32,15,12,17,64,30,24,34,89,42,39,47,128,60,48,68,"{'F': 16, 'P': 11}","{'C': 22, 'J': 16, 'Z': 16}","{'Q': 24, 'R': 16, 'S': 8, 'T': 8, 'H': 16, 'M': 8}","{'Y': 8, 'A': 8, 'B': 4, 'D': 4, 'E': 4, 'G': 8, 'I': 4, 'K': 8, 'L': 4, 'N': 4, 'O': 4, 'U': 8, 'V': 4, 'W': 4, 'X': 4}"
INV-ZZ-4131385,SCH-ZZ-1209990,ZZ,ZZ20240531BOMMAA3355.0,3355.0,Boeing 787,05/31/2024,2024-05-31 10:32:00,2024-05-31 13:38:00,BOM,MAA,270.0,316,140,-130,176,27,54,81,108,31,14,13,17,63,28,26,35,95,42,39,53,127,56,52,71,"{'F': 16, 'P': 11}","{'C': 22, 'J': 16, 'Z': 16}","{'Q': 24, 'R': 16, 'S': 8, 'T': 8, 'H': 16, 'M': 8}","{'Y': 8, 'A': 8, 'B': 4, 'D': 4, 'E': 4, 'G': 8, 'I': 4, 'K': 8, 'L': 4, 'N': 4, 'O': 4, 'U': 8, 'V': 4, 'W': 4, 'X': 4}"
INV-ZZ-2637912,SCH-ZZ-1209990,ZZ,ZZ20240601BOMMAA3355.0,3355.0,Boeing 787,06/01/2024,2024-06-01 10:32:00,2024-06-01 13:38:00,BOM,MAA,270.0,305,153,-117,152,27,54,81,108,31,16,11,15,61,31,23,30,90,45,36,45,123,62,46,61,"{'F': 16, 'P': 11}","{'C': 22, 'J': 16, 'Z': 16}","{'Q': 24, 'R': 16, 'S': 8, 'T': 8, 'H': 16, 'M': 8}","{'Y': 8, 'A': 8, 'B': 4, 'D': 4, 'E': 4, 'G': 8, 'I': 4, 'K': 8, 'L': 4, 'N': 4, 'O': 4, 'U': 8, 'V': 4, 'W': 4, 'X': 4}"
INV-ZZ-7125734,SCH-ZZ-1209990,ZZ,ZZ20240602BOMMAA3355.0,3355.0,Boeing 787,06/02/2024,2024-06-02 10:32:00,2024-06-02 13:38:00,BOM,MAA,270.0,315,145,-125,170,27,54,81,108,32,15,12,17,62,29,25,33,96,44,37,52,124,57,51,67,"{'F': 16, 'P': 11}","{'C': 22, 'J': 16, 'Z': 16}","{'Q': 24, 'R': 16, 'S': 8, 'T': 8, 'H': 16, 'M': 8}","{'Y': 8, 'A': 8, 'B': 4, 'D': 4, 'E': 4, 'G': 8, 'I': 4, 'K': 8, 'L': 4, 'N': 4, 'O': 4, 'U': 8, 'V': 4, 'W': 4, 'X': 4}"
INV-ZZ-1769048,SCH-ZZ-1209990,ZZ,ZZ20240607BOMMAA3355.0,3355.0,Boeing 787,06/07/2024,2024-06-07 10:32:00,2024-06-07 13:38:00,BOM,MAA,270.0,302,135,-135,167,27,54,81,108,31,14,13,17,60,27,27,33,97,43,38,54,120,54,54,66,"{'F': 16, 'P': 11}","{'C': 22, 'J': 16, 'Z': 16}","{'Q': 24, 'R': 16, 'S': 8, 'T': 8, 'H': 16, 'M': 8}","{'Y': 8, 'A': 8, 'B': 4, 'D': 4, 'E': 4, 'G': 8, 'I': 4, 'K': 8, 'L': 4, 'N': 4, 'O': 4, 'U': 8, 'V': 4, 'W': 4, 'X': 4}"
INV-ZZ-1900193,SCH-ZZ-1209990,ZZ,ZZ20240608BOMMAA3355.0,3355.0,Boeing 787,06/08/2024,2024-06-08 10:32:00,2024-06-08 13:38:00,BOM,MAA,270.0,311,135,-135,176,27,54,81,108,30,13,14,17,61,26,28,35,95,41,40,54,129,56,52,73,"{'F': 16, 'P': 11}","{'C': 22, 'J': 16, 'Z': 16}","{'Q': 24, 'R': 16, 'S': 8, 'T': 8, 'H': 16, 'M': 8}","{'Y': 8, 'A': 8, 'B': 4, 'D': 4, 'E': 4, 'G': 8, 'I': 4, 'K': 8, 'L': 4, 'N': 4, 'O': 4, 'U': 8, 'V': 4, 'W': 4, 'X': 4}"
INV-ZZ-4414340,SCH-ZZ-1209990,ZZ,ZZ20240609BOMMAA3355.0,3355.0,Boeing 787,06/09/2024,2024-06-09 10:32:00,2024-06-09 13:38:00,BOM,MAA,270.0,317,147,-123,170,27,54,81,108,31,14,13,17,61,28,26,33,91,42,39,49,127,59,49,68,"{'F': 16, 'P': 11}","{'C': 22, 'J': 16, 'Z': 16}","{'Q': 24, 'R': 16, 'S': 8, 'T': 8, 'H': 16, 'M': 8}","{'Y': 8, 'A': 8, 'B': 4, 'D': 4, 'E': 4, 'G': 8, 'I': 4, 'K': 8, 'L': 4, 'N': 4, 'O': 4, 'U': 8, 'V': 4, 'W': 4, 'X': 4}"
INV-ZZ-2150376,SCH-ZZ-1209990,ZZ,ZZ20240614BOMMAA3355.0,3355.0,Boeing 787,06/14/2024,2024-06-14 10:32:00,2024-06-14 13:38:00,BOM,MAA,270.0,303,143,-127,160,27,54,81,108,32,15,12,17,60,28,26,32,94,44,37,50,125,59,49,66,"{'F': 16, 'P': 11}","{'C': 22, 'J': 16, 'Z': 16}","{'Q': 24, 'R': 16, 'S': 8, 'T': 8, 'H': 16, 'M': 8}","{'Y': 8, 'A': 8, 'B': 4, 'D': 4, 'E': 4, 'G': 8, 'I': 4, 'K': 8, 'L': 4, 'N': 4, 'O': 4, 'U': 8, 'V': 4, 'W': 4, 'X': 4}"
INV-ZZ-1264482,SCH-ZZ-1209990,ZZ,ZZ20240615BOMMAA3355.0,3355.0,Boeing 787,06/15/2024,2024-06-15 10:32:00,2024-06-15 13:38:00,BOM,MAA,270.0,300,123,-147,177,27,54,81,108,31,13,14,18,64,26,28,38,93,38,43,55,119,49,59,70,"{'F': 16, 'P': 11}","{'C': 22, 'J': 16, 'Z': 16}","{'Q': 24, 'R': 16, 'S': 8, 'T': 8, 'H': 16, 'M': 8}","{'Y': 8, 'A': 8, 'B': 4, 'D': 4, 'E': 4, 'G': 8, 'I': 4, 'K': 8, 'L': 4, 'N': 4, 'O': 4, 'U': 8, 'V': 4, 'W': 4, 'X': 4}"
INV-ZZ-9060561,SCH-ZZ-1209990,ZZ,ZZ20240616BOMMAA3355.0,3355.0,Boeing 787,06/16/2024,2024-06-16 10:32:00,2024-06-16 13:38:00,BOM,MAA,270.0,317,135,-135,182,27,54,81,108,32,14,13,18,62,26,28,36,95,40,41,55,122,52,56,70,"{'F': 16, 'P': 11}","{'C': 22, 'J': 16, 'Z': 16}","{'Q': 24, 'R': 16, 'S': 8, 'T': 8, 'H': 16, 'M': 8}","{'Y': 8, 'A': 8, 'B': 4, 'D': 4, 'E': 4, 'G': 8, 'I': 4, 'K': 8, 'L': 4, 'N': 4, 'O': 4, 'U': 8, 'V': 4, 'W': 4, 'X': 4}"
INV-ZZ-9874457,SCH-ZZ-1216883,ZZ,ZZ20240419DELBLR3152.0,3152.0,Boeing 777,04/19/2024,2024-04-19 21:06:00,2024-04-20 16:58:00,DEL,BLR,425.0,484,287,-138,197,42,85,127,170,49,29,13,20,94,56,29,38,145,86,41,59,203,121,49,82,"{'F': 25, 'P': 17}","{'C': 34, 'J': 26, 'Z': 26}","{'Q': 38, 'R': 25, 'S': 13, 'T': 13, 'H': 25, 'M': 13}","{'Y': 13, 'A': 13, 'B': 6, 'D': 6, 'E': 6, 'G': 13, 'I': 6, 'K': 13, 'L': 6, 'N': 6, 'O': 6, 'U': 13, 'V': 6, 'W': 6, 'X': 6}"
INV-ZZ-2551576,SCH-ZZ-1216883,ZZ,ZZ20240421DELBLR3152.0,3152.0,Boeing 777,04/21/2024,2024-04-21 21:06:00,2024-04-22 16:58:00,DEL,BLR,425.0,506,278,-147,228,42,85,127,170,48,26,16,22,99,54,31,45,145,80,47,65,192,105,65,87,"{'F': 25, 'P': 17}","{'C': 34, 'J': 26, 'Z': 26}","{'Q': 38, 'R': 25, 'S': 13, 'T': 13, 'H': 25, 'M': 13}","{'Y': 13, 'A': 13, 'B': 6, 'D': 6, 'E': 6, 'G': 13, 'I': 6, 'K': 13, 'L': 6, 'N': 6, 'O': 6, 'U': 13, 'V': 6, 'W': 6, 'X': 6}"
INV-ZZ-8422670,SCH-ZZ-1216883,ZZ,ZZ20240423DELBLR3152.0,3152.0,Boeing 777,04/23/2024,2024-04-23 21:06:00,2024-04-24 16:58:00,DEL,BLR,425.0,482,279,-146,203,42,85,127,170,49,28,14,21,100,58,27,42,141,82,45,59,191,110,60,81,"{'F': 25, 'P': 17}","{'C': 34, 'J': 26, 'Z': 26}","{'Q': 38, 'R': 25, 'S': 13, 'T': 13, 'H': 25, 'M': 13}","{'Y': 13, 'A': 13, 'B': 6, 'D': 6, 'E': 6, 'G': 13, 'I': 6, 'K': 13, 'L': 6, 'N': 6, 'O': 6, 'U': 13, 'V': 6, 'W': 6, 'X': 6}"
INV-ZZ-3006800,SCH-ZZ-1216883,ZZ,ZZ20240424DELBLR3152.0,3152.0,Boeing 777,04/24/2024,2024-04-24 21:06:00,2024-04-25 16:58:00,DEL,BLR,425.0,492,289,-136,203,42,85,127,170,50,29,13,21,100,59,26,41,147,86,41,61,202,119,51,83,"{'F': 25, 'P': 17}","{'C': 34, 'J': 26, 'Z': 26}","{'Q': 38, 'R': 25, 'S': 13, 'T': 13, 'H': 25, 'M': 13}","{'Y': 13, 'A': 13, 'B': 6, 'D': 6, 'E': 6, 'G': 13, 'I': 6, 'K': 13, 'L': 6, 'N': 6, 'O': 6, 'U': 13, 'V': 6, 'W': 6, 'X': 6}"
INV-ZZ-2165335,SCH-ZZ-1216883,ZZ,ZZ20240426DELBLR3152.0,3152.0,Boeing 777,04/26/2024,2024-04-26 21:06:00,2024-04-27 16:58:00,DEL,BLR,425.0,489,290,-135,199,42,85,127,170,47,28,14,19,96,57,28,39,145,86,41,59,201,119,51,82,"{'F': 25, 'P': 17}","{'C': 34, 'J': 26, 'Z': 26}","{'Q': 38, 'R': 25, 'S': 13, 'T': 13, 'H': 25, 'M': 13}","{'Y': 13, 'A': 13, 'B': 6, 'D': 6, 'E': 6, 'G': 13, 'I': 6, 'K': 13, 'L': 6, 'N': 6, 'O': 6, 'U': 13, 'V': 6, 'W': 6, 'X': 6}"
INV-ZZ-1692145,SCH-ZZ-1216883,ZZ,ZZ20240428DELBLR3152.0,3152.0,Boeing 777,04/28/2024,2024-04-28 21:06:00,2024-04-29 16:58:00,DEL,BLR,425.0,484,269,-156,215,42,85,127,170,48,27,15,21,99,55,30,44,148,82,45,66,190,105,65,85,"{'F': 25, 'P': 17}","{'C': 34, 'J': 26, 'Z': 26}","{'Q': 38, 'R': 25, 'S': 13, 'T': 13, 'H': 25, 'M': 13}","{'Y': 13, 'A': 13, 'B': 6, 'D': 6, 'E': 6, 'G': 13, 'I': 6, 'K': 13, 'L': 6, 'N': 6, 'O': 6, 'U': 13, 'V': 6, 'W': 6, 'X': 6}"
INV-ZZ-5135537,SCH-ZZ-1216883,ZZ,ZZ20240430DELBLR3152.0,3152.0,Boeing 777,04/30/2024,2024-04-30 21:06:00,2024-05-01 16:58:00,DEL,BLR,425.0,485,292,-133,193,42,85,127,170,49,30,12,19,99,60,25,39,144,87,40,57,193,116,54,77,"{'F': 25, 'P': 17}","{'C': 34, 'J': 26, 'Z': 26}","{'Q': 38, 'R': 25, 'S': 13, 'T': 13, 'H': 25, 'M': 13}","{'Y': 13, 'A': 13, 'B': 6, 'D': 6, 'E': 6, 'G': 13, 'I': 6, 'K': 13, 'L': 6, 'N': 6, 'O': 6, 'U': 13, 'V': 6, 'W': 6, 'X': 6}"
INV-ZZ-5884789,SCH-ZZ-1216883,ZZ,ZZ20240501DELBLR3152.0,3152.0,Boeing 777,05/01/2024,2024-05-01 21:06:00,2024-05-02 16:58:00,DEL,BLR,425.0,492,276,-149,216,42,85,127,170,50,28,14,22,97,54,31,43,143,80,47,63,203,114,56,89,"{'F': 25, 'P': 17}","{'C': 34, 'J': 26, 'Z': 26}","{'Q': 38, 'R': 25, 'S': 13, 'T': 13, 'H': 25, 'M': 13}","{'Y': 13, 'A': 13, 'B': 6, 'D': 6, 'E': 6, 'G': 13, 'I': 6, 'K': 13, 'L': 6, 'N': 6, 'O': 6, 'U': 13, 'V': 6, 'W': 6, 'X': 6}"
INV-ZZ-7694535,SCH-ZZ-1216883,ZZ,ZZ20240503DELBLR3152.0,3152.0,Boeing 777,05/03/2024,2024-05-03 21:06:00,2024-05-04 16:58:00,DEL,BLR,425.0,473,280,-145,193,42,85,127,170,49,29,13,20,102,60,25,42,146,86,41,60,187,111,59,76,"{'F': 25, 'P': 17}","{'C': 34, 'J': 26, 'Z': 26}","{'Q': 38, 'R': 25, 'S': 13, 'T': 13, 'H': 25, 'M': 13}","{'Y': 13, 'A': 13, 'B': 6, 'D': 6, 'E': 6, 'G': 13, 'I': 6, 'K': 13, 'L': 6, 'N': 6, 'O': 6, 'U': 13, 'V': 6, 'W': 6, 'X': 6}"
INV-ZZ-7289738,SCH-ZZ-1216883,ZZ,ZZ20240505DELBLR3152.0,3152.0,Boeing 777,05/05/2024,2024-05-05 21:06:00,2024-05-06 16:58:00,DEL,BLR,425.0,507,283,-142,224,42,85,127,170,50,28,14,22,94,52,33,42,143,80,47,63,202,113,57,89,"{'F': 25, 'P': 17}","{'C': 34, 'J': 26, 'Z': 26}","{'Q': 38, 'R': 25, 'S': 13, 'T': 13, 'H': 25, 'M': 13}","{'Y': 13, 'A': 13, 'B': 6, 'D': 6, 'E': 6, 'G': 13, 'I': 6, 'K': 13, 'L': 6, 'N': 6, 'O': 6, 'U': 13, 'V': 6, 'W': 6, 'X': 6}"
INV-ZZ-6005126,SCH-ZZ-1216883,ZZ,ZZ20240507DELBLR3152.0,3152.0,Boeing 777,05/07/2024,2024-05-07 21:06:00,2024-05-08 16:58:00,DEL,BLR,425.0,487,283,-142,204,42,85,127,170,49,28,14,21,98,57,28,41,149,87,40,62,191,111,59,80,"{'F': 25, 'P': 17}","{'C': 34, 'J': 26, 'Z': 26}","{'Q': 38, 'R': 25, 'S': 13, 'T': 13, 'H': 25, 'M': 13}","{'Y': 13, 'A': 13, 'B': 6, 'D': 6, 'E': 6, 'G': 13, 'I': 6, 'K': 13, 'L': 6, 'N': 6, 'O': 6, 'U': 13, 'V': 6, 'W': 6, 'X': 6}"
INV-ZZ-6400815,SCH-ZZ-1216883,ZZ,ZZ20240508DELBLR3152.0,3152.0,Boeing 777,05/08/2024,2024-05-08 21:06:00,2024-05-09 16:58:00,DEL,BLR,425.0,472,257,-168,215,42,85,127,170,49,27,15,22,96,52,33,44,150,82,45,68,191,104,66,87,"{'F': 25, 'P': 17}","{'C': 34, 'J': 26, 'Z': 26}","{'Q': 38, 'R': 25, 'S': 13, 'T': 13, 'H': 25, 'M': 13}","{'Y': 13, 'A': 13, 'B': 6, 'D': 6, 'E': 6, 'G': 13, 'I': 6, 'K': 13, 'L': 6, 'N': 6, 'O': 6, 'U': 13, 'V': 6, 'W': 6, 'X': 6}"
INV-ZZ-4980839,SCH-ZZ-1216883,ZZ,ZZ20240510DELBLR3152.0,3152.0,Boeing 777,05/10/2024,2024-05-10 21:06:00,2024-05-11 16:58:00,DEL,BLR,425.0,501,272,-153,229,42,85,127,170,48,26,16,22,102,55,30,47,151,82,45,69,198,107,63,91,"{'F': 25, 'P': 17}","{'C': 34, 'J': 26, 'Z': 26}","{'Q': 38, 'R': 25, 'S': 13, 'T': 13, 'H': 25, 'M': 13}","{'Y': 13, 'A': 13, 'B': 6, 'D': 6, 'E': 6, 'G': 13, 'I': 6, 'K': 13, 'L': 6, 'N': 6, 'O': 6, 'U': 13, 'V': 6, 'W': 6, 'X': 6}"
INV-ZZ-7520772,SCH-ZZ-1216883,ZZ,ZZ20240512DELBLR3152.0,3152.0,Boeing 777,05/12/2024,2024-05-12 21:06:00,2024-05-13 16:58:00,DEL,BLR,425.0,504,285,-140,219,42,85,127,170,50,28,14,22,101,57,28,44,145,82,45,63,193,109,61,84,"{'F': 25, 'P': 17}","{'C': 34, 'J': 26, 'Z': 26}","{'Q': 38, 'R': 25, 'S': 13, 'T': 13, 'H': 25, 'M': 13}","{'Y': 13, 'A': 13, 'B': 6, 'D': 6, 'E': 6, 'G': 13, 'I': 6, 'K': 13, 'L': 6, 'N': 6, 'O': 6, 'U': 13, 'V': 6, 'W': 6, 'X': 6}"
INV-ZZ-6335749,SCH-ZZ-1216883,ZZ,ZZ20240514DELBLR3152.0,3152.0,Boeing 777,05/14/2024,2024-05-14 21:06:00,2024-05-15 16:58:00,DEL,BLR,425.0,485,268,-157,217,42,85,127,170,47,26,16,21,102,56,29,46,147,81,46,66,199,110,60,89,"{'F': 25, 'P': 17}","{'C': 34, 'J': 26, 'Z': 26}","{'Q': 38, 'R': 25, 'S': 13, 'T': 13, 'H': 25, 'M': 13}","{'Y': 13, 'A': 13, 'B': 6, 'D': 6, 'E': 6, 'G': 13, 'I': 6, 'K': 13, 'L': 6, 'N': 6, 'O': 6, 'U': 13, 'V': 6, 'W': 6, 'X': 6}"
INV-ZZ-2978014,SCH-ZZ-1216883,ZZ,ZZ20240515DELBLR3152.0,3152.0,Boeing 777,05/15/2024,2024-05-15 21:06:00,2024-05-16 16:58:00,DEL,BLR,425.0,509,283,-142,226,42,85,127,170,47,26,16,21,97,54,31,43,148,82,45,66,199,110,60,89,"{'F': 25, 'P': 17}","{'C': 34, 'J': 26, 'Z': 26}","{'Q': 38, 'R': 25, 'S': 13, 'T': 13, 'H': 25, 'M': 13}","{'Y': 13, 'A': 13, 'B': 6, 'D': 6, 'E': 6, 'G': 13, 'I': 6, 'K': 13, 'L': 6, 'N': 6, 'O': 6, 'U': 13, 'V': 6, 'W': 6, 'X': 6}"
INV-ZZ-5152415,SCH-ZZ-1216883,ZZ,ZZ20240517DELBLR3152.0,3152.0,Boeing 777,05/17/2024,2024-05-17 21:06:00,2024-05-18 16:58:00,DEL,BLR,425.0,475,226,-199,249,42,85,127,170,48,23,19,25,94,45,40,49,142,68,59,74,197,94,76,103,"{'F': 25, 'P': 17}","{'C': 34, 'J': 26, 'Z': 26}","{'Q': 38, 'R': 25, 'S': 13, 'T': 13, 'H': 25, 'M': 13}","{'Y': 13, 'A': 13, 'B': 6, 'D': 6, 'E': 6, 'G': 13, 'I': 6, 'K': 13, 'L': 6, 'N': 6, 'O': 6, 'U': 13, 'V': 6, 'W': 6, 'X': 6}"
INV-ZZ-2630542,SCH-ZZ-1216883,ZZ,ZZ20240519DELBLR3152.0,3152.0,Boeing 777,05/19/2024,2024-05-19 21:06:00,2024-05-20 16:58:00,DEL,BLR,425.0,509,249,-176,260,42,85,127,170,48,23,19,25,97,47,38,50,147,72,55,75,200,98,72,102,"{'F': 25, 'P': 17}","{'C': 34, 'J': 26, 'Z': 26}","{'Q': 38, 'R': 25, 'S': 13, 'T': 13, 'H': 25, 'M': 13}","{'Y': 13, 'A': 13, 'B': 6, 'D': 6, 'E': 6, 'G': 13, 'I': 6, 'K': 13, 'L': 6, 'N': 6, 'O': 6, 'U': 13, 'V': 6, 'W': 6, 'X': 6}"
INV-ZZ-9928182,SCH-ZZ-1216883,ZZ,ZZ20240521DELBLR3152.0,3152.0,Boeing 777,05/21/2024,2024-05-21 21:06:00,2024-05-22 16:58:00,DEL,BLR,425.0,485,241,-184,244,42,85,127,170,50,25,17,25,97,48,37,49,144,72,55,72,197,98,72,99,"{'F': 25, 'P': 17}","{'C': 34, 'J': 26, 'Z': 26}","{'Q': 38, 'R': 25, 'S': 13, 'T': 13, 'H': 25, 'M': 13}","{'Y': 13, 'A': 13, 'B': 6, 'D': 6, 'E': 6, 'G': 13, 'I': 6, 'K': 13, 'L': 6, 'N': 6, 'O': 6, 'U': 13, 'V': 6, 'W': 6, 'X': 6}"
INV-ZZ-8622900,SCH-ZZ-1216883,ZZ,ZZ20240522DELBLR3152.0,3152.0,Boeing 777,05/22/2024,2024-05-22 21:06:00,2024-05-23 16:58:00,DEL,BLR,425.0,488,236,-189,252,42,85,127,170,49,24,18,25,97,47,38,50,150,72,55,78,191,92,78,99,"{'F': 25, 'P': 17}","{'C': 34, 'J': 26, 'Z': 26}","{'Q': 38, 'R': 25, 'S': 13, 'T': 13, 'H': 25, 'M': 13}","{'Y': 13, 'A': 13, 'B': 6, 'D': 6, 'E': 6, 'G': 13, 'I': 6, 'K': 13, 'L': 6, 'N': 6, 'O': 6, 'U': 13, 'V': 6, 'W': 6, 'X': 6}"
INV-ZZ-4992153,SCH-ZZ-1216883,ZZ,ZZ20240524DELBLR3152.0,3152.0,Boeing 777,05/24/2024,2024-05-24 21:06:00,2024-05-25 16:58:00,DEL,BLR,425.0,502,252,-173,250,42,85,127,170,46,23,19,23,100,50,35,50,144,72,55,72,196,98,72,98,"{'F': 25, 'P': 17}","{'C': 34, 'J': 26, 'Z': 26}","{'Q': 38, 'R': 25, 'S': 13, 'T': 13, 'H': 25, 'M': 13}","{'Y': 13, 'A': 13, 'B': 6, 'D': 6, 'E': 6, 'G': 13, 'I': 6, 'K': 13, 'L': 6, 'N': 6, 'O': 6, 'U': 13, 'V': 6, 'W': 6, 'X': 6}"
INV-ZZ-6962281,SCH-ZZ-1216883,ZZ,ZZ20240526DELBLR3152.0,3152.0,Boeing 777,05/26/2024,2024-05-26 21:06:00,2024-05-27 16:58:00,DEL,BLR,425.0,473,233,-192,240,42,85,127,170,47,23,19,24,99,49,36,50,152,75,52,77,202,100,70,102,"{'F': 25, 'P': 17}","{'C': 34, 'J': 26, 'Z': 26}","{'Q': 38, 'R': 25, 'S': 13, 'T': 13, 'H': 25, 'M': 13}","{'Y': 13, 'A': 13, 'B': 6, 'D': 6, 'E': 6, 'G': 13, 'I': 6, 'K': 13, 'L': 6, 'N': 6, 'O': 6, 'U': 13, 'V': 6, 'W': 6, 'X': 6}"
INV-ZZ-2570052,SCH-ZZ-1216883,ZZ,ZZ20240528DELBLR3152.0,3152.0,Boeing 777,05/28/2024,2024-05-28 21:06:00,2024-05-29 16:58:00,DEL,BLR,425.0,508,246,-179,262,42,85,127,170,47,23,19,24,100,49,36,51,147,71,56,76,203,98,72,105,"{'F': 25, 'P': 17}","{'C': 34, 'J': 26, 'Z': 26}","{'Q': 38, 'R': 25, 'S': 13, 'T': 13, 'H': 25, 'M': 13}","{'Y': 13, 'A': 13, 'B': 6, 'D': 6, 'E': 6, 'G': 13, 'I': 6, 'K': 13, 'L': 6, 'N': 6, 'O': 6, 'U': 13, 'V': 6, 'W': 6, 'X': 6}"
INV-ZZ-3788931,SCH-ZZ-1216883,ZZ,ZZ20240529DELBLR3152.0,3152.0,Boeing 777,05/29/2024,2024-05-29 21:06:00,2024-05-30 16:58:00,DEL,BLR,425.0,468,226,-199,242,42,85,127,170,46,22,20,24,97,47,38,50,148,71,56,77,192,93,77,99,"{'F': 25, 'P': 17}","{'C': 34, 'J': 26, 'Z': 26}","{'Q': 38, 'R': 25, 'S': 13, 'T': 13, 'H': 25, 'M': 13}","{'Y': 13, 'A': 13, 'B': 6, 'D': 6, 'E': 6, 'G': 13, 'I': 6, 'K': 13, 'L': 6, 'N': 6, 'O': 6, 'U': 13, 'V': 6, 'W': 6, 'X': 6}"
INV-ZZ-3016349,SCH-ZZ-1216883,ZZ,ZZ20240531DELBLR3152.0,3152.0,Boeing 777,05/31/2024,2024-05-31 21:06:00,2024-06-01 16:58:00,DEL,BLR,425.0,470,222,-203,248,42,85,127,170,50,24,18,26,97,46,39,51,147,69,58,78,191,90,80,101,"{'F': 25, 'P': 17}","{'C': 34, 'J': 26, 'Z': 26}","{'Q': 38, 'R': 25, 'S': 13, 'T': 13, 'H': 25, 'M': 13}","{'Y': 13, 'A': 13, 'B': 6, 'D': 6, 'E': 6, 'G': 13, 'I': 6, 'K': 13, 'L': 6, 'N': 6, 'O': 6, 'U': 13, 'V': 6, 'W': 6, 'X': 6}"
INV-ZZ-5649379,SCH-ZZ-1216883,ZZ,ZZ20240602DELBLR3152.0,3152.0,Boeing 777,06/02/2024,2024-06-02 21:06:00,2024-06-03 16:58:00,DEL,BLR,425.0,477,229,-196,248,42,85,127,170,49,23,19,26,96,46,39,50,146,70,57,76,199,95,75,104,"{'F': 25, 'P': 17}","{'C': 34, 'J': 26, 'Z': 26}","{'Q': 38, 'R': 25, 'S': 13, 'T': 13, 'H': 25, 'M': 13}","{'Y': 13, 'A': 13, 'B': 6, 'D': 6, 'E': 6, 'G': 13, 'I': 6, 'K': 13, 'L': 6, 'N': 6, 'O': 6, 'U': 13, 'V': 6, 'W': 6, 'X': 6}"
INV-ZZ-8969078,SCH-ZZ-7624092,ZZ,ZZ20240504BLRAMD4647.0,4647.0,ATR 72,05/04/2024,2024-05-04 03:34:00,2024-05-04 06:37:00,BLR,AMD,72.0,81,45,-27,36,7,14,21,28,8,4,3,4,16,9,5,7,24,13,8,11,33,18,10,15,"{'F': 4, 'P': 3}","{'C': 6, 'J': 4, 'Z': 4}","{'Q': 6, 'R': 4, 'S': 2, 'T': 2, 'H': 4, 'M': 2}","{'Y': 2, 'A': 2, 'B': 1, 'D': 1, 'E': 1, 'G': 2, 'I': 1, 'K': 2, 'L': 1, 'N': 1, 'O': 1, 'U': 2, 'V': 1, 'W': 1, 'X': 1}"
INV-ZZ-4702930,SCH-ZZ-7624092,ZZ,ZZ20240505BLRAMD4647.0,4647.0,ATR 72,05/05/2024,2024-05-05 03:34:00,2024-05-05 06:37:00,BLR,AMD,72.0,84,46,-26,38,7,14,21,28,8,4,3,4,16,9,5,7,25,14,7,11,33,18,10,15,"{'F': 4, 'P': 3}","{'C': 6, 'J': 4, 'Z': 4}","{'Q': 6, 'R': 4, 'S': 2, 'T': 2, 'H': 4, 'M': 2}","{'Y': 2, 'A': 2, 'B': 1, 'D': 1, 'E': 1, 'G': 2, 'I': 1, 'K': 2, 'L': 1, 'N': 1, 'O': 1, 'U': 2, 'V': 1, 'W': 1, 'X': 1}"
INV-ZZ-8083202,SCH-ZZ-7624092,ZZ,ZZ20240506BLRAMD4647.0,4647.0,ATR 72,05/06/2024,2024-05-06 03:34:00,2024-05-06 06:37:00,BLR,AMD,72.0,80,47,-25,33,7,14,21,28,8,5,2,3,16,9,5,7,23,13,8,10,33,19,9,14,"{'F': 4, 'P': 3}","{'C': 6, 'J': 4, 'Z': 4}","{'Q': 6, 'R': 4, 'S': 2, 'T': 2, 'H': 4, 'M': 2}","{'Y': 2, 'A': 2, 'B': 1, 'D': 1, 'E': 1, 'G': 2, 'I': 1, 'K': 2, 'L': 1, 'N': 1, 'O': 1, 'U': 2, 'V': 1, 'W': 1, 'X': 1}"
INV-ZZ-4215030,SCH-ZZ-7624092,ZZ,ZZ20240507BLRAMD4647.0,4647.0,ATR 72,05/07/2024,2024-05-07 03:34:00,2024-05-07 06:37:00,BLR,AMD,72.0,83,48,-24,35,7,14,21,28,8,5,2,3,16,9,5,7,25,15,6,10,31,18,10,13,"{'F': 4, 'P': 3}","{'C': 6, 'J': 4, 'Z': 4}","{'Q': 6, 'R': 4, 'S': 2, 'T': 2, 'H': 4, 'M': 2}","{'Y': 2, 'A': 2, 'B': 1, 'D': 1, 'E': 1, 'G': 2, 'I': 1, 'K': 2, 'L': 1, 'N': 1, 'O': 1, 'U': 2, 'V': 1, 'W': 1, 'X': 1}"
INV-ZZ-3022615,SCH-ZZ-7624092,ZZ,ZZ20240510BLRAMD4647.0,4647.0,ATR 72,05/10/2024,2024-05-10 03:34:00,2024-05-10 06:37:00,BLR,AMD,72.0,82,42,-30,40,7,14,21,28,8,4,3,4,16,8,6,8,24,12,9,12,33,17,11,16,"{'F': 4, 'P': 3}","{'C': 6, 'J': 4, 'Z': 4}","{'Q': 6, 'R': 4, 'S': 2, 'T': 2, 'H': 4, 'M': 2}","{'Y': 2, 'A': 2, 'B': 1, 'D': 1, 'E': 1, 'G': 2, 'I': 1, 'K': 2, 'L': 1, 'N': 1, 'O': 1, 'U': 2, 'V': 1, 'W': 1, 'X': 1}"
INV-ZZ-2263920,SCH-ZZ-7624092,ZZ,ZZ20240511BLRAMD4647.0,4647.0,ATR 72,05/11/2024,2024-05-11 03:34:00,2024-05-11 06:37:00,BLR,AMD,72.0,82,47,-25,35,7,14,21,28,8,5,2,3,16,9,5,7,23,13,8,10,32,18,10,14,"{'F': 4, 'P': 3}","{'C': 6, 'J': 4, 'Z': 4}","{'Q': 6, 'R': 4, 'S': 2, 'T': 2, 'H': 4, 'M': 2}","{'Y': 2, 'A': 2, 'B': 1, 'D': 1, 'E': 1, 'G': 2, 'I': 1, 'K': 2, 'L': 1, 'N': 1, 'O': 1, 'U': 2, 'V': 1, 'W': 1, 'X': 1}"
INV-ZZ-2760173,SCH-ZZ-7624092,ZZ,ZZ20240512BLRAMD4647.0,4647.0,ATR 72,05/12/2024,2024-05-12 03:34:00,2024-05-12 06:37:00,BLR,AMD,72.0,83,42,-30,41,7,14,21,28,8,4,3,4,17,9,5,8,24,12,9,12,31,16,12,15,"{'F': 4, 'P': 3}","{'C': 6, 'J': 4, 'Z': 4}","{'Q': 6, 'R': 4, 'S': 2, 'T': 2, 'H': 4, 'M': 2}","{'Y': 2, 'A': 2, 'B': 1, 'D': 1, 'E': 1, 'G': 2, 'I': 1, 'K': 2, 'L': 1, 'N': 1, 'O': 1, 'U': 2, 'V': 1, 'W': 1, 'X': 1}"
INV-ZZ-6544265,SCH-ZZ-7624092,ZZ,ZZ20240513BLRAMD4647.0,4647.0,ATR 72,05/13/2024,2024-05-13 03:34:00,2024-05-13 06:37:00,BLR,AMD,72.0,84,44,-28,40,7,14,21,28,8,4,3,4,16,8,6,8,23,12,9,11,32,17,11,15,"{'F': 4, 'P': 3}","{'C': 6, 'J': 4, 'Z': 4}","{'Q': 6, 'R': 4, 'S': 2, 'T': 2, 'H': 4, 'M': 2}","{'Y': 2, 'A': 2, 'B': 1, 'D': 1, 'E': 1, 'G': 2, 'I': 1, 'K': 2, 'L': 1, 'N': 1, 'O': 1, 'U': 2, 'V': 1, 'W': 1, 'X': 1}"
INV-ZZ-1189708,SCH-ZZ-7624092,ZZ,ZZ20240514BLRAMD4647.0,4647.0,ATR 72,05/14/2024,2024-05-14 03:34:00,2024-05-14 06:37:00,BLR,AMD,72.0,80,43,-29,37,7,14,21,28,8,4,3,4,16,9,5,7,24,13,8,11,31,17,11,14,"{'F': 4, 'P': 3}","{'C': 6, 'J': 4, 'Z': 4}","{'Q': 6, 'R': 4, 'S': 2, 'T': 2, 'H': 4, 'M': 2}","{'Y': 2, 'A': 2, 'B': 1, 'D': 1, 'E': 1, 'G': 2, 'I': 1, 'K': 2, 'L': 1, 'N': 1, 'O': 1, 'U': 2, 'V': 1, 'W': 1, 'X': 1}"
INV-ZZ-6484767,SCH-ZZ-7624092,ZZ,ZZ20240517BLRAMD4647.0,4647.0,ATR 72,05/17/2024,2024-05-17 03:34:00,2024-05-17 06:37:00,BLR,AMD,72.0,79,38,-34,41,7,14,21,28,8,4,3,4,16,8,6,8,23,11,10,12,33,16,12,17,"{'F': 4, 'P': 3}","{'C': 6, 'J': 4, 'Z': 4}","{'Q': 6, 'R': 4, 'S': 2, 'T': 2, 'H': 4, 'M': 2}","{'Y': 2, 'A': 2, 'B': 1, 'D': 1, 'E': 1, 'G': 2, 'I': 1, 'K': 2, 'L': 1, 'N': 1, 'O': 1, 'U': 2, 'V': 1, 'W': 1, 'X': 1}"
INV-ZZ-6913538,SCH-ZZ-7624092,ZZ,ZZ20240518BLRAMD4647.0,4647.0,ATR 72,05/18/2024,2024-05-18 03:34:00,2024-05-18 06:37:00,BLR,AMD,72.0,84,45,-27,39,7,14,21,28,8,4,3,4,15,8,6,7,23,12,9,11,33,18,10,15,"{'F': 4, 'P': 3}","{'C': 6, 'J': 4, 'Z': 4}","{'Q': 6, 'R': 4, 'S': 2, 'T': 2, 'H': 4, 'M': 2}","{'Y': 2, 'A': 2, 'B': 1, 'D': 1, 'E': 1, 'G': 2, 'I': 1, 'K': 2, 'L': 1, 'N': 1, 'O': 1, 'U': 2, 'V': 1, 'W': 1, 'X': 1}"
INV-ZZ-5825805,SCH-ZZ-7624092,ZZ,ZZ20240519BLRAMD4647.0,4647.0,ATR 72,05/19/2024,2024-05-19 03:34:00,2024-05-19 06:37:00,BLR,AMD,72.0,83,41,-31,42,7,14,21,28,8,4,3,4,16,8,6,8,23,11,10,12,32,16,12,16,"{'F': 4, 'P': 3}","{'C': 6, 'J': 4, 'Z': 4}","{'Q': 6, 'R': 4, 'S': 2, 'T': 2, 'H': 4, 'M': 2}","{'Y': 2, 'A': 2, 'B': 1, 'D': 1, 'E': 1, 'G': 2, 'I': 1, 'K': 2, 'L': 1, 'N': 1, 'O': 1, 'U': 2, 'V': 1, 'W': 1, 'X': 1}"
INV-ZZ-1918751,SCH-ZZ-7624092,ZZ,ZZ20240520BLRAMD4647.0,4647.0,ATR 72,05/20/2024,2024-05-20 03:34:00,2024-05-20 06:37:00,BLR,AMD,72.0,80,43,-29,37,7,14,21,28,8,4,3,4,17,9,5,8,23,12,9,11,31,17,11,14,"{'F': 4, 'P': 3}","{'C': 6, 'J': 4, 'Z': 4}","{'Q': 6, 'R': 4, 'S': 2, 'T': 2, 'H': 4, 'M': 2}","{'Y': 2, 'A': 2, 'B': 1, 'D': 1, 'E': 1, 'G': 2, 'I': 1, 'K': 2, 'L': 1, 'N': 1, 'O': 1, 'U': 2, 'V': 1, 'W': 1, 'X': 1}"
INV-ZZ-7710576,SCH-ZZ-7624092,ZZ,ZZ20240521BLRAMD4647.0,4647.0,ATR 72,05/21/2024,2024-05-21 03:34:00,2024-05-21 06:37:00,BLR,AMD,72.0,85,41,-31,44,7,14,21,28,8,4,3,4,16,8,6,8,23,11,10,12,32,15,13,17,"{'F': 4, 'P': 3}","{'C': 6, 'J': 4, 'Z': 4}","{'Q': 6, 'R': 4, 'S': 2, 'T': 2, 'H': 4, 'M': 2}","{'Y': 2, 'A': 2, 'B': 1, 'D': 1, 'E': 1, 'G': 2, 'I': 1, 'K': 2, 'L': 1, 'N': 1, 'O': 1, 'U': 2, 'V': 1, 'W': 1, 'X': 1}"
INV-ZZ-2096908,SCH-ZZ-7624092,ZZ,ZZ20240524BLRAMD4647.0,4647.0,ATR 72,05/24/2024,2024-05-24 03:34:00,2024-05-24 06:37:00,BLR,AMD,72.0,79,39,-33,40,7,14,21,28,8,4,3,4,16,8,6,8,23,11,10,12,32,16,12,16,"{'F': 4, 'P': 3}","{'C': 6, 'J': 4, 'Z': 4}","{'Q': 6, 'R': 4, 'S': 2, 'T': 2, 'H': 4, 'M': 2}","{'Y': 2, 'A': 2, 'B': 1, 'D': 1, 'E': 1, 'G': 2, 'I': 1, 'K': 2, 'L': 1, 'N': 1, 'O': 1, 'U': 2, 'V': 1, 'W': 1, 'X': 1}"
INV-ZZ-7478697,SCH-ZZ-7624092,ZZ,ZZ20240525BLRAMD4647.0,4647.0,ATR 72,05/25/2024,2024-05-25 03:34:00,2024-05-25 06:37:00,BLR,AMD,72.0,81,39,-33,42,7,14,21,28,8,4,3,4,16,8,6,8,23,11,10,12,33,16,12,17,"{'F': 4, 'P': 3}","{'C': 6, 'J': 4, 'Z': 4}","{'Q': 6, 'R': 4, 'S': 2, 'T': 2, 'H': 4, 'M': 2}","{'Y': 2, 'A': 2, 'B': 1, 'D': 1, 'E': 1, 'G': 2, 'I': 1, 'K': 2, 'L': 1, 'N': 1, 'O': 1, 'U': 2, 'V': 1, 'W': 1, 'X': 1}"
INV-ZZ-9396193,SCH-ZZ-7624092,ZZ,ZZ20240526BLRAMD4647.0,4647.0,ATR 72,05/26/2024,2024-05-26 03:34:00,2024-05-26 06:37:00,BLR,AMD,72.0,83,39,-33,44,7,14,21,28,8,4,3,4,17,8,6,9,23,11,10,12,31,14,14,17,"{'F': 4, 'P': 3}","{'C': 6, 'J': 4, 'Z': 4}","{'Q': 6, 'R': 4, 'S': 2, 'T': 2, 'H': 4, 'M': 2}","{'Y': 2, 'A': 2, 'B': 1, 'D': 1, 'E': 1, 'G': 2, 'I': 1, 'K': 2, 'L': 1, 'N': 1, 'O': 1, 'U': 2, 'V': 1, 'W': 1, 'X': 1}"
INV-ZZ-9362864,SCH-ZZ-7624092,ZZ,ZZ20240527BLRAMD4647.0,4647.0,ATR 72,05/27/2024,2024-05-27 03:34:00,2024-05-27 06:37:00,BLR,AMD,72.0,85,41,-31,44,7,14,21,28,8,4,3,4,17,8,6,9,23,11,10,12,33,16,12,17,"{'F': 4, 'P': 3}","{'C': 6, 'J': 4, 'Z': 4}","{'Q': 6, 'R': 4, 'S': 2, 'T': 2, 'H': 4, 'M': 2}","{'Y': 2, 'A': 2, 'B': 1, 'D': 1, 'E': 1, 'G': 2, 'I': 1, 'K': 2, 'L': 1, 'N': 1, 'O': 1, 'U': 2, 'V': 1, 'W': 1, 'X': 1}"
INV-ZZ-8480129,SCH-ZZ-7624092,ZZ,ZZ20240528BLRAMD4647.0,4647.0,ATR 72,05/28/2024,2024-05-28 03:34:00,2024-05-28 06:37:00,BLR,AMD,72.0,80,38,-34,42,7,14,21,28,8,4,3,4,17,8,6,9,25,12,9,13,32,15,13,17,"{'F': 4, 'P': 3}","{'C': 6, 'J': 4, 'Z': 4}","{'Q': 6, 'R': 4, 'S': 2, 'T': 2, 'H': 4, 'M': 2}","{'Y': 2, 'A': 2, 'B': 1, 'D': 1, 'E': 1, 'G': 2, 'I': 1, 'K': 2, 'L': 1, 'N': 1, 'O': 1, 'U': 2, 'V': 1, 'W': 1, 'X': 1}"
INV-ZZ-4828017,SCH-ZZ-7624092,ZZ,ZZ20240531BLRAMD4647.0,4647.0,ATR 72,05/31/2024,2024-05-31 03:34:00,2024-05-31 06:37:00,BLR,AMD,72.0,81,38,-34,43,7,14,21,28,8,4,3,4,15,7,7,8,25,12,9,13,32,15,13,17,"{'F': 4, 'P': 3}","{'C': 6, 'J': 4, 'Z': 4}","{'Q': 6, 'R': 4, 'S': 2, 'T': 2, 'H': 4, 'M': 2}","{'Y': 2, 'A': 2, 'B': 1, 'D': 1, 'E': 1, 'G': 2, 'I': 1, 'K': 2, 'L': 1, 'N': 1, 'O': 1, 'U': 2, 'V': 1, 'W': 1, 'X': 1}"
INV-ZZ-9041952,SCH-ZZ-7624092,ZZ,ZZ20240601BLRAMD4647.0,4647.0,ATR 72,06/01/2024,2024-06-01 03:34:00,2024-06-01 06:37:00,BLR,AMD,72.0,84,38,-34,46,7,14,21,28,8,4,3,4,16,7,7,9,25,11,10,14,31,14,14,17,"{'F': 4, 'P': 3}","{'C': 6, 'J': 4, 'Z': 4}","{'Q': 6, 'R': 4, 'S': 2, 'T': 2, 'H': 4, 'M': 2}","{'Y': 2, 'A': 2, 'B': 1, 'D': 1, 'E': 1, 'G': 2, 'I': 1, 'K': 2, 'L': 1, 'N': 1, 'O': 1, 'U': 2, 'V': 1, 'W': 1, 'X': 1}"
INV-ZZ-1346048,SCH-ZZ-7624092,ZZ,ZZ20240602BLRAMD4647.0,4647.0,ATR 72,06/02/2024,2024-06-02 03:34:00,2024-06-02 06:37:00,BLR,AMD,72.0,81,40,-32,41,7,14,21,28,8,4,3,4,16,8,6,8,24,12,9,12,31,15,13,16,"{'F': 4, 'P': 3}","{'C': 6, 'J': 4, 'Z': 4}","{'Q': 6, 'R': 4, 'S': 2, 'T': 2, 'H': 4, 'M': 2}","{'Y': 2, 'A': 2, 'B': 1, 'D': 1, 'E': 1, 'G': 2, 'I': 1, 'K': 2, 'L': 1, 'N': 1, 'O': 1, 'U': 2, 'V': 1, 'W': 1, 'X': 1}"
INV-ZZ-1812644,SCH-ZZ-7624092,ZZ,ZZ20240603BLRAMD4647.0,4647.0,ATR 72,06/03/2024,2024-06-03 03:34:00,2024-06-03 06:37:00,BLR,AMD,72.0,83,41,-31,42,7,14,21,28,8,4,3,4,16,8,6,8,24,12,9,12,33,16,12,17,"{'F': 4, 'P': 3}","{'C': 6, 'J': 4, 'Z': 4}","{'Q': 6, 'R': 4, 'S': 2, 'T': 2, 'H': 4, 'M': 2}","{'Y': 2, 'A': 2, 'B': 1, 'D': 1, 'E': 1, 'G': 2, 'I': 1, 'K': 2, 'L': 1, 'N': 1, 'O': 1, 'U': 2, 'V': 1, 'W': 1, 'X': 1}"
INV-ZZ-5156125,SCH-ZZ-7624092,ZZ,ZZ20240604BLRAMD4647.0,4647.0,ATR 72,06/04/2024,2024-06-04 03:34:00,2024-06-04 06:37:00,BLR,AMD,72.0,83,36,-36,47,7,14,21,28,8,3,4,5,16,7,7,9,24,10,11,14,33,14,14,19,"{'F': 4, 'P': 3}","{'C': 6, 'J': 4, 'Z': 4}","{'Q': 6, 'R': 4, 'S': 2, 'T': 2, 'H': 4, 'M': 2}","{'Y': 2, 'A': 2, 'B': 1, 'D': 1, 'E': 1, 'G': 2, 'I': 1, 'K': 2, 'L': 1, 'N': 1, 'O': 1, 'U': 2, 'V': 1, 'W': 1, 'X': 1}"
INV-ZZ-7800710,SCH-ZZ-7624092,ZZ,ZZ20240607BLRAMD4647.0,4647.0,ATR 72,06/07/2024,2024-06-07 03:34:00,2024-06-07 06:37:00,BLR,AMD,72.0,83,39,-33,44,7,14,21,28,8,4,3,4,17,8,6,9,25,12,9,13,31,15,13,16,"{'F': 4, 'P': 3}","{'C': 6, 'J': 4, 'Z': 4}","{'Q': 6, 'R': 4, 'S': 2, 'T': 2, 'H': 4, 'M': 2}","{'Y': 2, 'A': 2, 'B': 1, 'D': 1, 'E': 1, 'G': 2, 'I': 1, 'K': 2, 'L': 1, 'N': 1, 'O': 1, 'U': 2, 'V': 1, 'W': 1, 'X': 1}"
INV-ZZ-3744567,SCH-ZZ-7624092,ZZ,ZZ20240608BLRAMD4647.0,4647.0,ATR 72,06/08/2024,2024-06-08 03:34:00,2024-06-08 06:37:00,BLR,AMD,72.0,85,37,-35,48,7,14,21,28,8,3,4,5,16,7,7,9,23,10,11,13,32,14,14,18,"{'F': 4, 'P': 3}","{'C': 6, 'J': 4, 'Z': 4}","{'Q': 6, 'R': 4, 'S': 2, 'T': 2, 'H': 4, 'M': 2}","{'Y': 2, 'A': 2, 'B': 1, 'D': 1, 'E': 1, 'G': 2, 'I': 1, 'K': 2, 'L': 1, 'N': 1, 'O': 1, 'U': 2, 'V': 1, 'W': 1, 'X': 1}"
INV-ZZ-6268179,SCH-ZZ-7624092,ZZ,ZZ20240609BLRAMD4647.0,4647.0,ATR 72,06/09/2024,2024-06-09 03:34:00,2024-06-09 06:37:00,BLR,AMD,72.0,83,37,-35,46,7,14,21,28,8,4,3,4,16,7,7,9,24,11,10,13,31,14,14,17,"{'F': 4, 'P': 3}","{'C': 6, 'J': 4, 'Z': 4}","{'Q': 6, 'R': 4, 'S': 2, 'T': 2, 'H': 4, 'M': 2}","{'Y': 2, 'A': 2, 'B': 1, 'D': 1, 'E': 1, 'G': 2, 'I': 1, 'K': 2, 'L': 1, 'N': 1, 'O': 1, 'U': 2, 'V': 1, 'W': 1, 'X': 1}"
INV-ZZ-4903773,SCH-ZZ-7624092,ZZ,ZZ20240610BLRAMD4647.0,4647.0,ATR 72,06/10/2024,2024-06-10 03:34:00,2024-06-10 06:37:00,BLR,AMD,72.0,83,35,-37,48,7,14,21,28,8,3,4,5,17,7,7,10,24,10,11,14,33,14,14,19,"{'F': 4, 'P': 3}","{'C': 6, 'J': 4, 'Z': 4}","{'Q': 6, 'R': 4, 'S': 2, 'T': 2, 'H': 4, 'M': 2}","{'Y': 2, 'A': 2, 'B': 1, 'D': 1, 'E': 1, 'G': 2, 'I': 1, 'K': 2, 'L': 1, 'N': 1, 'O': 1, 'U': 2, 'V': 1, 'W': 1, 'X': 1}"
INV-ZZ-9659038,SCH-ZZ-7624092,ZZ,ZZ20240611BLRAMD4647.0,4647.0,ATR 72,06/11/2024,2024-06-11 03:34:00,2024-06-11 06:37:00,BLR,AMD,72.0,82,36,-36,46,7,14,21,28,8,4,3,4,16,7,7,9,24,11,10,13,31,14,14,17,"{'F': 4, 'P': 3}","{'C': 6, 'J': 4, 'Z': 4}","{'Q': 6, 'R': 4, 'S': 2, 'T': 2, 'H': 4, 'M': 2}","{'Y': 2, 'A': 2, 'B': 1, 'D': 1, 'E': 1, 'G': 2, 'I': 1, 'K': 2, 'L': 1, 'N': 1, 'O': 1, 'U': 2, 'V': 1, 'W': 1, 'X': 1}"
INV-ZZ-4193311,SCH-ZZ-7624092,ZZ,ZZ20240614BLRAMD4647.0,4647.0,ATR 72,06/14/2024,2024-06-14 03:34:00,2024-06-14 06:37:00,BLR,AMD,72.0,80,35,-37,45,7,14,21,28,8,3,4,5,16,7,7,9,24,10,11,14,32,14,14,18,"{'F': 4, 'P': 3}","{'C': 6, 'J': 4, 'Z': 4}","{'Q': 6, 'R': 4, 'S': 2, 'T': 2, 'H': 4, 'M': 2}","{'Y': 2, 'A': 2, 'B': 1, 'D': 1, 'E': 1, 'G': 2, 'I': 1, 'K': 2, 'L': 1, 'N': 1, 'O': 1, 'U': 2, 'V': 1, 'W': 1, 'X': 1}"
INV-ZZ-9213814,SCH-ZZ-7624092,ZZ,ZZ20240615BLRAMD4647.0,4647.0,ATR 72,06/15/2024,2024-06-15 03:34:00,2024-06-15 06:37:00,BLR,AMD,72.0,79,38,-34,41,7,14,21,28,8,4,3,4,16,8,6,8,24,11,10,13,33,16,12,17,"{'F': 4, 'P': 3}","{'C': 6, 'J': 4, 'Z': 4}","{'Q': 6, 'R': 4, 'S': 2, 'T': 2, 'H': 4, 'M': 2}","{'Y': 2, 'A': 2, 'B': 1, 'D': 1, 'E': 1, 'G': 2, 'I': 1, 'K': 2, 'L': 1, 'N': 1, 'O': 1, 'U': 2, 'V': 1, 'W': 1, 'X': 1}"
INV-ZZ-6674261,SCH-ZZ-7624092,ZZ,ZZ20240616BLRAMD4647.0,4647.0,ATR 72,06/16/2024,2024-06-16 03:34:00,2024-06-16 06:37:00,BLR,AMD,72.0,81,39,-33,42,7,14,21,28,8,4,3,4,17,8,6,9,23,11,10,12,33,16,12,17,"{'F': 4, 'P': 3}","{'C': 6, 'J': 4, 'Z': 4}","{'Q': 6, 'R': 4, 'S': 2, 'T': 2, 'H': 4, 'M': 2}","{'Y': 2, 'A': 2, 'B': 1, 'D': 1, 'E': 1, 'G': 2, 'I': 1, 'K': 2, 'L': 1, 'N': 1, 'O': 1, 'U': 2, 'V': 1, 'W': 1, 'X': 1}"
INV-ZZ-5381711,SCH-ZZ-7624092,ZZ,ZZ20240617BLRAMD4647.0,4647.0,ATR 72,06/17/2024,2024-06-17 03:34:00,2024-06-17 06:37:00,BLR,AMD,72.0,83,35,-37,48,7,14,21,28,8,3,4,5,16,7,7,9,25,11,10,14,33,14,14,19,"{'F': 4, 'P': 3}","{'C': 6, 'J': 4, 'Z': 4}","{'Q': 6, 'R': 4, 'S': 2, 'T': 2, 'H': 4, 'M': 2}","{'Y': 2, 'A': 2, 'B': 1, 'D': 1, 'E': 1, 'G': 2, 'I': 1, 'K': 2, 'L': 1, 'N': 1, 'O': 1, 'U': 2, 'V': 1, 'W': 1, 'X': 1}"
INV-ZZ-5078135,SCH-ZZ-7624092,ZZ,ZZ20240618BLRAMD4647.0,4647.0,ATR 72,06/18/2024,2024-06-18 03:34:00,2024-06-18 06:37:00,BLR,AMD,72.0,81,35,-37,46,7,14,21,28,8,3,4,5,16,7,7,9,25,11,10,14,31,13,15,18,"{'F': 4, 'P': 3}","{'C': 6, 'J': 4, 'Z': 4}","{'Q': 6, 'R': 4, 'S': 2, 'T': 2, 'H': 4, 'M': 2}","{'Y': 2, 'A': 2, 'B': 1, 'D': 1, 'E': 1, 'G': 2, 'I': 1, 'K': 2, 'L': 1, 'N': 1, 'O': 1, 'U': 2, 'V': 1, 'W': 1, 'X': 1}"
INV-ZZ-6903609,SCH-ZZ-7068651,ZZ,ZZ20240406CCUHYD3723.0,3723.0,Boeing 787,04/06/2024,2024-04-06 16:19:00,2024-04-07 00:54:00,CCU,HYD,270.0,303,190,-80,113,27,54,81,108,32,20,7,12,61,38,16,23,92,58,23,34,120,75,33,45,"{'F': 16, 'P': 11}","{'C': 22, 'J': 16, 'Z': 16}","{'Q': 24, 'R': 16, 'S': 8, 'T': 8, 'H': 16, 'M': 8}","{'Y': 8, 'A': 8, 'B': 4, 'D': 4, 'E': 4, 'G': 8, 'I': 4, 'K': 8, 'L': 4, 'N': 4, 'O': 4, 'U': 8, 'V': 4, 'W': 4, 'X': 4}"
INV-ZZ-2017253,SCH-ZZ-7068651,ZZ,ZZ20240407CCUHYD3723.0,3723.0,Boeing 787,04/07/2024,2024-04-07 16:19:00,2024-04-08 00:54:00,CCU,HYD,270.0,297,176,-94,121,27,54,81,108,30,18,9,12,60,36,18,24,94,56,25,38,127,75,33,52,"{'F': 16, 'P': 11}","{'C': 22, 'J': 16, 'Z': 16}","{'Q': 24, 'R': 16, 'S': 8, 'T': 8, 'H': 16, 'M': 8}","{'Y': 8, 'A': 8, 'B': 4, 'D': 4, 'E': 4, 'G': 8, 'I': 4, 'K': 8, 'L': 4, 'N': 4, 'O': 4, 'U': 8, 'V': 4, 'W': 4, 'X': 4}"
INV-ZZ-4864835,SCH-ZZ-7068651,ZZ,ZZ20240411CCUHYD3723.0,3723.0,Boeing 787,04/11/2024,2024-04-11 16:19:00,2024-04-12 00:54:00,CCU,HYD,270.0,317,187,-83,130,27,54,81,108,32,19,8,13,64,38,16,26,90,53,28,37,121,71,37,50,"{'F': 16, 'P': 11}","{'C': 22, 'J': 16, 'Z': 16}","{'Q': 24, 'R': 16, 'S': 8, 'T': 8, 'H': 16, 'M': 8}","{'Y': 8, 'A': 8, 'B': 4, 'D': 4, 'E': 4, 'G': 8, 'I': 4, 'K': 8, 'L': 4, 'N': 4, 'O': 4, 'U': 8, 'V': 4, 'W': 4, 'X': 4}"
INV-ZZ-4078402,SCH-ZZ-7068651,ZZ,ZZ20240413CCUHYD3723.0,3723.0,Boeing 787,04/13/2024,2024-04-13 16:19:00,2024-04-14 00:54:00,CCU,HYD,270.0,297,186,-84,111,27,54,81,108,32,20,7,12,63,39,15,24,93,58,23,35,122,76,32,46,"{'F': 16, 'P': 11}","{'C': 22, 'J': 16, 'Z': 16}","{'Q': 24, 'R': 16, 'S': 8, 'T': 8, 'H': 16, 'M': 8}","{'Y': 8, 'A': 8, 'B': 4, 'D': 4, 'E': 4, 'G': 8, 'I': 4, 'K': 8, 'L': 4, 'N': 4, 'O': 4, 'U': 8, 'V': 4, 'W': 4, 'X': 4}"
INV-ZZ-5186934,SCH-ZZ-7068651,ZZ,ZZ20240414CCUHYD3723.0,3723.0,Boeing 787,04/14/2024,2024-04-14 16:19:00,2024-04-15 00:54:00,CCU,HYD,270.0,322,182,-88,140,27,54,81,108,30,17,10,13,62,35,19,27,97,55,26,42,126,71,37,55,"{'F': 16, 'P': 11}","{'C': 22, 'J': 16, 'Z': 16}","{'Q': 24, 'R': 16, 'S': 8, 'T': 8, 'H': 16, 'M': 8}","{'Y': 8, 'A': 8, 'B': 4, 'D': 4, 'E': 4, 'G': 8, 'I': 4, 'K': 8, 'L': 4, 'N': 4, 'O': 4, 'U': 8, 'V': 4, 'W': 4, 'X': 4}"
INV-ZZ-3853891,SCH-ZZ-7068651,ZZ,ZZ20240418CCUHYD3723.0,3723.0,Boeing 787,04/18/2024,2024-04-18 16:19:00,2024-04-19 00:54:00,CCU,HYD,270.0,311,177,-93,134,27,54,81,108,30,17,10,13,63,36,18,27,90,51,30,39,126,72,36,54,"{'F': 16, 'P': 11}","{'C': 22, 'J': 16, 'Z': 16}","{'Q': 24, 'R': 16, 'S': 8, 'T': 8, 'H': 16, 'M': 8}","{'Y': 8, 'A': 8, 'B': 4, 'D': 4, 'E': 4, 'G': 8, 'I': 4, 'K': 8, 'L': 4, 'N': 4, 'O': 4, 'U': 8, 'V': 4, 'W': 4, 'X': 4}"
INV-ZZ-8513261,SCH-ZZ-7068651,ZZ,ZZ20240420CCUHYD3723.0,3723.0,Boeing 787,04/20/2024,2024-04-20 16:19:00,2024-04-21 00:54:00,CCU,HYD,270.0,312,181,-89,131,27,54,81,108,32,19,8,13,60,35,19,25,93,54,27,39,120,70,38,50,"{'F': 16, 'P': 11}","{'C': 22, 'J': 16, 'Z': 16}","{'Q': 24, 'R': 16, 'S': 8, 'T': 8, 'H': 16, 'M': 8}","{'Y': 8, 'A': 8, 'B': 4, 'D': 4, 'E': 4, 'G': 8, 'I': 4, 'K': 8, 'L': 4, 'N': 4, 'O': 4, 'U': 8, 'V': 4, 'W': 4, 'X': 4}"
INV-ZZ-9747842,SCH-ZZ-7068651,ZZ,ZZ20240421CCUHYD3723.0,3723.0,Boeing 787,04/21/2024,2024-04-21 16:19:00,2024-04-22 00:54:00,CCU,HYD,270.0,300,187,-83,113,27,54,81,108,30,19,8,11,61,38,16,23,96,60,21,36,128,80,28,48,"{'F': 16, 'P': 11}","{'C': 22, 'J': 16, 'Z': 16}","{'Q': 24, 'R': 16, 'S': 8, 'T': 8, 'H': 16, 'M': 8}","{'Y': 8, 'A': 8, 'B': 4, 'D': 4, 'E': 4, 'G': 8, 'I': 4, 'K': 8, 'L': 4, 'N': 4, 'O': 4, 'U': 8, 'V': 4, 'W': 4, 'X': 4}"
INV-ZZ-9046597,SCH-ZZ-7068651,ZZ,ZZ20240425CCUHYD3723.0,3723.0,Boeing 787,04/25/2024,2024-04-25 16:19:00,2024-04-26 00:54:00,CCU,HYD,270.0,304,183,-87,121,27,54,81,108,31,19,8,12,65,39,15,26,93,56,25,37,129,78,30,51,"{'F': 16, 'P': 11}","{'C': 22, 'J': 16, 'Z': 16}","{'Q': 24, 'R': 16, 'S': 8, 'T': 8, 'H': 16, 'M': 8}","{'Y': 8, 'A': 8, 'B': 4, 'D': 4, 'E': 4, 'G': 8, 'I': 4, 'K': 8, 'L': 4, 'N': 4, 'O': 4, 'U': 8, 'V': 4, 'W': 4, 'X': 4}"
INV-ZZ-7900668,SCH-ZZ-7068651,ZZ,ZZ20240427CCUHYD3723.0,3723.0,Boeing 787,04/27/2024,2024-04-27 16:19:00,2024-04-28 00:54:00,CCU,HYD,270.0,318,175,-95,143,27,54,81,108,30,17,10,13,63,35,19,28,95,52,29,43,120,66,42,54,"{'F': 16, 'P': 11}","{'C': 22, 'J': 16, 'Z': 16}","{'Q': 24, 'R': 16, 'S': 8, 'T': 8, 'H': 16, 'M': 8}","{'Y': 8, 'A': 8, 'B': 4, 'D': 4, 'E': 4, 'G': 8, 'I': 4, 'K': 8, 'L': 4, 'N': 4, 'O': 4, 'U': 8, 'V': 4, 'W': 4, 'X': 4}"
INV-ZZ-1050389,SCH-ZZ-7068651,ZZ,ZZ20240428CCUHYD3723.0,3723.0,Boeing 787,04/28/2024,2024-04-28 16:19:00,2024-04-29 00:54:00,CCU,HYD,270.0,304,165,-105,139,27,54,81,108,30,16,11,14,62,34,20,28,90,49,32,41,119,65,43,54,"{'F': 16, 'P': 11}","{'C': 22, 'J': 16, 'Z': 16}","{'Q': 24, 'R': 16, 'S': 8, 'T': 8, 'H': 16, 'M': 8}","{'Y': 8, 'A': 8, 'B': 4, 'D': 4, 'E': 4, 'G': 8, 'I': 4, 'K': 8, 'L': 4, 'N': 4, 'O': 4, 'U': 8, 'V': 4, 'W': 4, 'X': 4}"
INV-ZZ-9603106,SCH-ZZ-7068651,ZZ,ZZ20240502CCUHYD3723.0,3723.0,Boeing 787,05/02/2024,2024-05-02 16:19:00,2024-05-03 00:54:00,CCU,HYD,270.0,317,189,-81,128,27,54,81,108,31,18,9,13,64,38,16,26,97,58,23,39,124,74,34,50,"{'F': 16, 'P': 11}","{'C': 22, 'J': 16, 'Z': 16}","{'Q': 24, 'R': 16, 'S': 8, 'T': 8, 'H': 16, 'M': 8}","{'Y': 8, 'A': 8, 'B': 4, 'D': 4, 'E': 4, 'G': 8, 'I': 4, 'K': 8, 'L': 4, 'N': 4, 'O': 4, 'U': 8, 'V': 4, 'W': 4, 'X': 4}"
INV-ZZ-7772604,SCH-ZZ-7068651,ZZ,ZZ20240504CCUHYD3723.0,3723.0,Boeing 787,05/04/2024,2024-05-04 16:19:00,2024-05-05 00:54:00,CCU,HYD,270.0,321,179,-91,142,27,54,81,108,30,17,10,13,62,35,19,27,93,52,29,41,127,71,37,56,"{'F': 16, 'P': 11}","{'C': 22, 'J': 16, 'Z': 16}","{'Q': 24, 'R': 16, 'S': 8, 'T': 8, 'H': 16, 'M': 8}","{'Y': 8, 'A': 8, 'B': 4, 'D': 4, 'E': 4, 'G': 8, 'I': 4, 'K': 8, 'L': 4, 'N': 4, 'O': 4, 'U': 8, 'V': 4, 'W': 4, 'X': 4}"
INV-ZZ-1683934,SCH-ZZ-7068651,ZZ,ZZ20240505CCUHYD3723.0,3723.0,Boeing 787,05/05/2024,2024-05-05 16:19:00,2024-05-06 00:54:00,CCU,HYD,270.0,313,177,-93,136,27,54,81,108,31,18,9,13,63,36,18,27,94,53,28,41,119,67,41,52,"{'F': 16, 'P': 11}","{'C': 22, 'J': 16, 'Z': 16}","{'Q': 24, 'R': 16, 'S': 8, 'T': 8, 'H': 16, 'M': 8}","{'Y': 8, 'A': 8, 'B': 4, 'D': 4, 'E': 4, 'G': 8, 'I': 4, 'K': 8, 'L': 4, 'N': 4, 'O': 4, 'U': 8, 'V': 4, 'W': 4, 'X': 4}"
INV-ZZ-8978958,SCH-ZZ-7068651,ZZ,ZZ20240509CCUHYD3723.0,3723.0,Boeing 787,05/09/2024,2024-05-09 16:19:00,2024-05-10 00:54:00,CCU,HYD,270.0,321,165,-105,156,27,54,81,108,30,15,12,15,62,32,22,30,91,47,34,44,127,65,43,62,"{'F': 16, 'P': 11}","{'C': 22, 'J': 16, 'Z': 16}","{'Q': 24, 'R': 16, 'S': 8, 'T': 8, 'H': 16, 'M': 8}","{'Y': 8, 'A': 8, 'B': 4, 'D': 4, 'E': 4, 'G': 8, 'I': 4, 'K': 8, 'L': 4, 'N': 4, 'O': 4, 'U': 8, 'V': 4, 'W': 4, 'X': 4}"
INV-ZZ-9803887,SCH-ZZ-7068651,ZZ,ZZ20240511CCUHYD3723.0,3723.0,Boeing 787,05/11/2024,2024-05-11 16:19:00,2024-05-12 00:54:00,CCU,HYD,270.0,311,155,-115,156,27,54,81,108,31,15,12,16,61,30,24,31,96,48,33,48,124,62,46,62,"{'F': 16, 'P': 11}","{'C': 22, 'J': 16, 'Z': 16}","{'Q': 24, 'R': 16, 'S': 8, 'T': 8, 'H': 16, 'M': 8}","{'Y': 8, 'A': 8, 'B': 4, 'D': 4, 'E': 4, 'G': 8, 'I': 4, 'K': 8, 'L': 4, 'N': 4, 'O': 4, 'U': 8, 'V': 4, 'W': 4, 'X': 4}"
INV-ZZ-1203243,SCH-ZZ-7068651,ZZ,ZZ20240512CCUHYD3723.0,3723.0,Boeing 787,05/12/2024,2024-05-12 16:19:00,2024-05-13 00:54:00,CCU,HYD,270.0,301,172,-98,129,27,54,81,108,32,18,9,14,62,35,19,27,95,54,27,41,121,69,39,52,"{'F': 16, 'P': 11}","{'C': 22, 'J': 16, 'Z': 16}","{'Q': 24, 'R': 16, 'S': 8, 'T': 8, 'H': 16, 'M': 8}","{'Y': 8, 'A': 8, 'B': 4, 'D': 4, 'E': 4, 'G': 8, 'I': 4, 'K': 8, 'L': 4, 'N': 4, 'O': 4, 'U': 8, 'V': 4, 'W': 4, 'X': 4}"
INV-ZZ-6514059,SCH-ZZ-7068651,ZZ,ZZ20240516CCUHYD3723.0,3723.0,Boeing 787,05/16/2024,2024-05-16 16:19:00,2024-05-17 00:54:00,CCU,HYD,270.0,317,155,-115,162,27,54,81,108,30,15,12,15,63,31,23,32,95,46,35,49,123,60,48,63,"{'F': 16, 'P': 11}","{'C': 22, 'J': 16, 'Z': 16}","{'Q': 24, 'R': 16, 'S': 8, 'T': 8, 'H': 16, 'M': 8}","{'Y': 8, 'A': 8, 'B': 4, 'D': 4, 'E': 4, 'G': 8, 'I': 4, 'K': 8, 'L': 4, 'N': 4, 'O': 4, 'U': 8, 'V': 4, 'W': 4, 'X': 4}"
INV-ZZ-6636935,SCH-ZZ-7068651,ZZ,ZZ20240518CCUHYD3723.0,3723.0,Boeing 787,05/18/2024,2024-05-18 16:19:00,2024-05-19 00:54:00,CCU,HYD,270.0,298,146,-124,152,27,54,81,108,30,15,12,15,62,30,24,32,94,46,35,48,124,61,47,63,"{'F': 16, 'P': 11}","{'C': 22, 'J': 16, 'Z': 16}","{'Q': 24, 'R': 16, 'S': 8, 'T': 8, 'H': 16, 'M': 8}","{'Y': 8, 'A': 8, 'B': 4, 'D': 4, 'E': 4, 'G': 8, 'I': 4, 'K': 8, 'L': 4, 'N': 4, 'O': 4, 'U': 8, 'V': 4, 'W': 4, 'X': 4}"
INV-ZZ-6134765,SCH-ZZ-7068651,ZZ,ZZ20240519CCUHYD3723.0,3723.0,Boeing 787,05/19/2024,2024-05-19 16:19:00,2024-05-20 00:54:00,CCU,HYD,270.0,306,155,-115,151,27,54,81,108,32,16,11,16,60,30,24,30,95,48,33,47,127,64,44,63,"{'F': 16, 'P': 11}","{'C': 22, 'J': 16, 'Z': 16}","{'Q': 24, 'R': 16, 'S': 8, 'T': 8, 'H': 16, 'M': 8}","{'Y': 8, 'A': 8, 'B': 4, 'D': 4, 'E': 4, 'G': 8, 'I': 4, 'K': 8, 'L': 4, 'N': 4, 'O': 4, 'U': 8, 'V': 4, 'W': 4, 'X': 4}"
INV-ZZ-5285845,SCH-ZZ-7163326,ZZ,ZZ20240502MAAHYD3027.0,3027.0,Boeing 717,05/02/2024,2024-05-02 14:05:00,2024-05-03 00:21:00,MAA,HYD,100.0,110,57,-43,53,10,20,30,40,11,6,4,5,23,12,8,11,33,17,13,16,46,24,16,22,"{'F': 6, 'P': 4}","{'C': 8, 'J': 6, 'Z': 6}","{'Q': 9, 'R': 6, 'S': 3, 'T': 3, 'H': 6, 'M': 3}","{'Y': 3, 'A': 3, 'B': 2, 'D': 2, 'E': 2, 'G': 3, 'I': 2, 'K': 3, 'L': 2, 'N': 2, 'O': 2, 'U': 3, 'V': 2, 'W': 2, 'X': 2}"
INV-ZZ-8426754,SCH-ZZ-7163326,ZZ,ZZ20240503MAAHYD3027.0,3027.0,Boeing 717,05/03/2024,2024-05-03 14:05:00,2024-05-04 00:21:00,MAA,HYD,100.0,113,58,-42,55,10,20,30,40,11,6,4,5,23,12,8,11,35,18,12,17,46,24,16,22,"{'F': 6, 'P': 4}","{'C': 8, 'J': 6, 'Z': 6}","{'Q': 9, 'R': 6, 'S': 3, 'T': 3, 'H': 6, 'M': 3}","{'Y': 3, 'A': 3, 'B': 2, 'D': 2, 'E': 2, 'G': 3, 'I': 2, 'K': 3, 'L': 2, 'N': 2, 'O': 2, 'U': 3, 'V': 2, 'W': 2, 'X': 2}"
INV-ZZ-4714515,SCH-ZZ-7163326,ZZ,ZZ20240509MAAHYD3027.0,3027.0,Boeing 717,05/09/2024,2024-05-09 14:05:00,2024-05-10 00:21:00,MAA,HYD,100.0,116,65,-35,51,10,20,30,40,12,7,3,5,23,13,7,10,33,18,12,15,46,26,14,20,"{'F': 6, 'P': 4}","{'C': 8, 'J': 6, 'Z': 6}","{'Q': 9, 'R': 6, 'S': 3, 'T': 3, 'H': 6, 'M': 3}","{'Y': 3, 'A': 3, 'B': 2, 'D': 2, 'E': 2, 'G': 3, 'I': 2, 'K': 3, 'L': 2, 'N': 2, 'O': 2, 'U': 3, 'V': 2, 'W': 2, 'X': 2}"
INV-ZZ-2485323,SCH-ZZ-7163326,ZZ,ZZ20240510MAAHYD3027.0,3027.0,Boeing 717,05/10/2024,2024-05-10 14:05:00,2024-05-11 00:21:00,MAA,HYD,100.0,111,62,-38,49,10,20,30,40,11,6,4,5,23,13,7,10,35,19,11,16,47,26,14,21,"{'F': 6, 'P': 4}","{'C': 8, 'J': 6, 'Z': 6}","{'Q': 9, 'R': 6, 'S': 3, 'T': 3, 'H': 6, 'M': 3}","{'Y': 3, 'A': 3, 'B': 2, 'D': 2, 'E': 2, 'G': 3, 'I': 2, 'K': 3, 'L': 2, 'N': 2, 'O': 2, 'U': 3, 'V': 2, 'W': 2, 'X': 2}"
INV-ZZ-3453248,SCH-ZZ-7163326,ZZ,ZZ20240516MAAHYD3027.0,3027.0,Boeing 717,05/16/2024,2024-05-16 14:05:00,2024-05-17 00:21:00,MAA,HYD,100.0,114,62,-38,52,10,20,30,40,11,6,4,5,23,13,7,10,35,19,11,16,44,24,16,20,"{'F': 6, 'P': 4}","{'C': 8, 'J': 6, 'Z': 6}","{'Q': 9, 'R': 6, 'S': 3, 'T': 3, 'H': 6, 'M': 3}","{'Y': 3, 'A': 3, 'B': 2, 'D': 2, 'E': 2, 'G': 3, 'I': 2, 'K': 3, 'L': 2, 'N': 2, 'O': 2, 'U': 3, 'V': 2, 'W': 2, 'X': 2}"
INV-ZZ-8813472,SCH-ZZ-7163326,ZZ,ZZ20240517MAAHYD3027.0,3027.0,Boeing 717,05/17/2024,2024-05-17 14:05:00,2024-05-18 00:21:00,MAA,HYD,100.0,117,59,-41,58,10,20,30,40,12,6,4,6,23,12,8,11,34,17,13,17,44,22,18,22,"{'F': 6, 'P': 4}","{'C': 8, 'J': 6, 'Z': 6}","{'Q': 9, 'R': 6, 'S': 3, 'T': 3, 'H': 6, 'M': 3}","{'Y': 3, 'A': 3, 'B': 2, 'D': 2, 'E': 2, 'G': 3, 'I': 2, 'K': 3, 'L': 2, 'N': 2, 'O': 2, 'U': 3, 'V': 2, 'W': 2, 'X': 2}"
INV-ZZ-4861936,SCH-ZZ-7163326,ZZ,ZZ20240523MAAHYD3027.0,3027.0,Boeing 717,05/23/2024,2024-05-23 14:05:00,2024-05-24 00:21:00,MAA,HYD,100.0,119,55,-45,64,10,20,30,40,12,6,4,6,23,11,9,12,35,16,14,19,45,21,19,24,"{'F': 6, 'P': 4}","{'C': 8, 'J': 6, 'Z': 6}","{'Q': 9, 'R': 6, 'S': 3, 'T': 3, 'H': 6, 'M': 3}","{'Y': 3, 'A': 3, 'B': 2, 'D': 2, 'E': 2, 'G': 3, 'I': 2, 'K': 3, 'L': 2, 'N': 2, 'O': 2, 'U': 3, 'V': 2, 'W': 2, 'X': 2}"
INV-ZZ-7205701,SCH-ZZ-7163326,ZZ,ZZ20240524MAAHYD3027.0,3027.0,Boeing 717,05/24/2024,2024-05-24 14:05:00,2024-05-25 00:21:00,MAA,HYD,100.0,110,53,-47,57,10,20,30,40,12,6,4,6,22,11,9,11,34,16,14,18,44,21,19,23,"{'F': 6, 'P': 4}","{'C': 8, 'J': 6, 'Z': 6}","{'Q': 9, 'R': 6, 'S': 3, 'T': 3, 'H': 6, 'M': 3}","{'Y': 3, 'A': 3, 'B': 2, 'D': 2, 'E': 2, 'G': 3, 'I': 2, 'K': 3, 'L': 2, 'N': 2, 'O': 2, 'U': 3, 'V': 2, 'W': 2, 'X': 2}"
INV-ZZ-4724615,SCH-ZZ-7163326,ZZ,ZZ20240530MAAHYD3027.0,3027.0,Boeing 717,05/30/2024,2024-05-30 14:05:00,2024-05-31 00:21:00,MAA,HYD,100.0,117,59,-41,58,10,20,30,40,11,6,4,5,24,12,8,12,36,18,12,18,46,23,17,23,"{'F': 6, 'P': 4}","{'C': 8, 'J': 6, 'Z': 6}","{'Q': 9, 'R': 6, 'S': 3, 'T': 3, 'H': 6, 'M': 3}","{'Y': 3, 'A': 3, 'B': 2, 'D': 2, 'E': 2, 'G': 3, 'I': 2, 'K': 3, 'L': 2, 'N': 2, 'O': 2, 'U': 3, 'V': 2, 'W': 2, 'X': 2}"
INV-ZZ-8711566,SCH-ZZ-7163326,ZZ,ZZ20240531MAAHYD3027.0,3027.0,Boeing 717,05/31/2024,2024-05-31 14:05:00,2024-06-01 00:21:00,MAA,HYD,100.0,113,51,-49,62,10,20,30,40,12,5,5,7,22,10,10,12,34,15,15,19,48,22,18,26,"{'F': 6, 'P': 4}","{'C': 8, 'J': 6, 'Z': 6}","{'Q': 9, 'R': 6, 'S': 3, 'T': 3, 'H': 6, 'M': 3}","{'Y': 3, 'A': 3, 'B': 2, 'D': 2, 'E': 2, 'G': 3, 'I': 2, 'K': 3, 'L': 2, 'N': 2, 'O': 2, 'U': 3, 'V': 2, 'W': 2, 'X': 2}"
INV-ZZ-2037961,SCH-ZZ-7163326,ZZ,ZZ20240606MAAHYD3027.0,3027.0,Boeing 717,06/06/2024,2024-06-06 14:05:00,2024-06-07 00:21:00,MAA,HYD,100.0,116,52,-48,64,10,20,30,40,11,5,5,6,22,10,10,12,34,15,15,19,46,21,19,25,"{'F': 6, 'P': 4}","{'C': 8, 'J': 6, 'Z': 6}","{'Q': 9, 'R': 6, 'S': 3, 'T': 3, 'H': 6, 'M': 3}","{'Y': 3, 'A': 3, 'B': 2, 'D': 2, 'E': 2, 'G': 3, 'I': 2, 'K': 3, 'L': 2, 'N': 2, 'O': 2, 'U': 3, 'V': 2, 'W': 2, 'X': 2}"
INV-ZZ-4169211,SCH-ZZ-7163326,ZZ,ZZ20240607MAAHYD3027.0,3027.0,Boeing 717,06/07/2024,2024-06-07 14:05:00,2024-06-08 00:21:00,MAA,HYD,100.0,119,59,-41,60,10,20,30,40,12,6,4,6,23,11,9,12,34,17,13,17,44,22,18,22,"{'F': 6, 'P': 4}","{'C': 8, 'J': 6, 'Z': 6}","{'Q': 9, 'R': 6, 'S': 3, 'T': 3, 'H': 6, 'M': 3}","{'Y': 3, 'A': 3, 'B': 2, 'D': 2, 'E': 2, 'G': 3, 'I': 2, 'K': 3, 'L': 2, 'N': 2, 'O': 2, 'U': 3, 'V': 2, 'W': 2, 'X': 2}"
INV-ZZ-9294988,SCH-ZZ-7163326,ZZ,ZZ20240613MAAHYD3027.0,3027.0,Boeing 717,06/13/2024,2024-06-13 14:05:00,2024-06-14 00:21:00,MAA,HYD,100.0,115,52,-48,63,10,20,30,40,11,5,5,6,24,11,9,13,33,15,15,18,48,22,18,26,"{'F': 6, 'P': 4}","{'C': 8, 'J': 6, 'Z': 6}","{'Q': 9, 'R': 6, 'S': 3, 'T': 3, 'H': 6, 'M': 3}","{'Y': 3, 'A': 3, 'B': 2, 'D': 2, 'E': 2, 'G': 3, 'I': 2, 'K': 3, 'L': 2, 'N': 2, 'O': 2, 'U': 3, 'V': 2, 'W': 2, 'X': 2}"
INV-ZZ-6346459,SCH-ZZ-7163326,ZZ,ZZ20240614MAAHYD3027.0,3027.0,Boeing 717,06/14/2024,2024-06-14 14:05:00,2024-06-15 00:21:00,MAA,HYD,100.0,116,51,-49,65,10,20,30,40,12,5,5,7,23,10,10,13,36,16,14,20,46,20,20,26,"{'F': 6, 'P': 4}","{'C': 8, 'J': 6, 'Z': 6}","{'Q': 9, 'R': 6, 'S': 3, 'T': 3, 'H': 6, 'M': 3}","{'Y': 3, 'A': 3, 'B': 2, 'D': 2, 'E': 2, 'G': 3, 'I': 2, 'K': 3, 'L': 2, 'N': 2, 'O': 2, 'U': 3, 'V': 2, 'W': 2, 'X': 2}"
INV-ZZ-4845949,SCH-ZZ-4079085,ZZ,ZZ20240507HYDBLR2887.0,2887.0,Airbus A321 Neo,05/07/2024,2024-05-07 00:30:00,2024-05-07 13:36:00,HYD,BLR,220.0,247,143,-77,104,22,44,66,88,25,14,8,11,51,30,14,21,77,45,21,32,99,57,31,42,"{'F': 13, 'P': 9}","{'C': 18, 'J': 13, 'Z': 13}","{'Q': 20, 'R': 13, 'S': 7, 'T': 7, 'H': 13, 'M': 7}","{'Y': 7, 'A': 7, 'B': 3, 'D': 3, 'E': 3, 'G': 7, 'I': 3, 'K': 7, 'L': 3, 'N': 3, 'O': 3, 'U': 7, 'V': 3, 'W': 3, 'X': 3}"
INV-ZZ-9006817,SCH-ZZ-4079085,ZZ,ZZ20240508HYDBLR2887.0,2887.0,Airbus A321 Neo,05/08/2024,2024-05-08 00:30:00,2024-05-08 13:36:00,HYD,BLR,220.0,257,142,-78,115,22,44,66,88,26,14,8,12,50,28,16,22,79,44,22,35,100,55,33,45,"{'F': 13, 'P': 9}","{'C': 18, 'J': 13, 'Z': 13}","{'Q': 20, 'R': 13, 'S': 7, 'T': 7, 'H': 13, 'M': 7}","{'Y': 7, 'A': 7, 'B': 3, 'D': 3, 'E': 3, 'G': 7, 'I': 3, 'K': 7, 'L': 3, 'N': 3, 'O': 3, 'U': 7, 'V': 3, 'W': 3, 'X': 3}"
INV-ZZ-1838433,SCH-ZZ-4079085,ZZ,ZZ20240509HYDBLR2887.0,2887.0,Airbus A321 Neo,05/09/2024,2024-05-09 00:30:00,2024-05-09 13:36:00,HYD,BLR,220.0,250,136,-84,114,22,44,66,88,26,14,8,12,52,28,16,24,77,42,24,35,99,54,34,45,"{'F': 13, 'P': 9}","{'C': 18, 'J': 13, 'Z': 13}","{'Q': 20, 'R': 13, 'S': 7, 'T': 7, 'H': 13, 'M': 7}","{'Y': 7, 'A': 7, 'B': 3, 'D': 3, 'E': 3, 'G': 7, 'I': 3, 'K': 7, 'L': 3, 'N': 3, 'O': 3, 'U': 7, 'V': 3, 'W': 3, 'X': 3}"
INV-ZZ-4203708,SCH-ZZ-4079085,ZZ,ZZ20240511HYDBLR2887.0,2887.0,Airbus A321 Neo,05/11/2024,2024-05-11 00:30:00,2024-05-11 13:36:00,HYD,BLR,220.0,253,131,-89,122,22,44,66,88,25,13,9,12,52,27,17,25,77,40,26,37,106,55,33,51,"{'F': 13, 'P': 9}","{'C': 18, 'J': 13, 'Z': 13}","{'Q': 20, 'R': 13, 'S': 7, 'T': 7, 'H': 13, 'M': 7}","{'Y': 7, 'A': 7, 'B': 3, 'D': 3, 'E': 3, 'G': 7, 'I': 3, 'K': 7, 'L': 3, 'N': 3, 'O': 3, 'U': 7, 'V': 3, 'W': 3, 'X': 3}"
INV-ZZ-5214849,SCH-ZZ-4079085,ZZ,ZZ20240512HYDBLR2887.0,2887.0,Airbus A321 Neo,05/12/2024,2024-05-12 00:30:00,2024-05-12 13:36:00,HYD,BLR,220.0,253,137,-83,116,22,44,66,88,25,13,9,12,51,28,16,23,77,42,24,35,100,54,34,46,"{'F': 13, 'P': 9}","{'C': 18, 'J': 13, 'Z': 13}","{'Q': 20, 'R': 13, 'S': 7, 'T': 7, 'H': 13, 'M': 7}","{'Y': 7, 'A': 7, 'B': 3, 'D': 3, 'E': 3, 'G': 7, 'I': 3, 'K': 7, 'L': 3, 'N': 3, 'O': 3, 'U': 7, 'V': 3, 'W': 3, 'X': 3}"
INV-ZZ-8848016,SCH-ZZ-4079085,ZZ,ZZ20240514HYDBLR2887.0,2887.0,Airbus A321 Neo,05/14/2024,2024-05-14 00:30:00,2024-05-14 13:36:00,HYD,BLR,220.0,262,129,-91,133,22,44,66,88,25,12,10,13,51,25,19,26,76,37,29,39,102,50,38,52,"{'F': 13, 'P': 9}","{'C': 18, 'J': 13, 'Z': 13}","{'Q': 20, 'R': 13, 'S': 7, 'T': 7, 'H': 13, 'M': 7}","{'Y': 7, 'A': 7, 'B': 3, 'D': 3, 'E': 3, 'G': 7, 'I': 3, 'K': 7, 'L': 3, 'N': 3, 'O': 3, 'U': 7, 'V': 3, 'W': 3, 'X': 3}"
INV-ZZ-2651667,SCH-ZZ-4079085,ZZ,ZZ20240515HYDBLR2887.0,2887.0,Airbus A321 Neo,05/15/2024,2024-05-15 00:30:00,2024-05-15 13:36:00,HYD,BLR,220.0,245,123,-97,122,22,44,66,88,26,13,9,13,48,24,20,24,76,38,28,38,103,52,36,51,"{'F': 13, 'P': 9}","{'C': 18, 'J': 13, 'Z': 13}","{'Q': 20, 'R': 13, 'S': 7, 'T': 7, 'H': 13, 'M': 7}","{'Y': 7, 'A': 7, 'B': 3, 'D': 3, 'E': 3, 'G': 7, 'I': 3, 'K': 7, 'L': 3, 'N': 3, 'O': 3, 'U': 7, 'V': 3, 'W': 3, 'X': 3}"
INV-ZZ-7364196,SCH-ZZ-4079085,ZZ,ZZ20240516HYDBLR2887.0,2887.0,Airbus A321 Neo,05/16/2024,2024-05-16 00:30:00,2024-05-16 13:36:00,HYD,BLR,220.0,251,126,-94,124,22,44,66,88,24,12,10,12,51,26,18,25,74,37,29,37,102,51,37,51,"{'F': 13, 'P': 9}","{'C': 18, 'J': 13, 'Z': 13}","{'Q': 20, 'R': 13, 'S': 7, 'T': 7, 'H': 13, 'M': 7}","{'Y': 7, 'A': 7, 'B': 3, 'D': 3, 'E': 3, 'G': 7, 'I': 3, 'K': 7, 'L': 3, 'N': 3, 'O': 3, 'U': 7, 'V': 3, 'W': 3, 'X': 3}"
INV-ZZ-7773574,SCH-ZZ-4079085,ZZ,ZZ20240518HYDBLR2887.0,2887.0,Airbus A321 Neo,05/18/2024,2024-05-18 00:30:00,2024-05-18 13:36:00,HYD,BLR,220.0,258,131,-89,127,22,44,66,88,25,13,9,12,50,25,19,25,77,39,27,38,102,52,36,50,"{'F': 13, 'P': 9}","{'C': 18, 'J': 13, 'Z': 13}","{'Q': 20, 'R': 13, 'S': 7, 'T': 7, 'H': 13, 'M': 7}","{'Y': 7, 'A': 7, 'B': 3, 'D': 3, 'E': 3, 'G': 7, 'I': 3, 'K': 7, 'L': 3, 'N': 3, 'O': 3, 'U': 7, 'V': 3, 'W': 3, 'X': 3}"
INV-ZZ-9092827,SCH-ZZ-4079085,ZZ,ZZ20240519HYDBLR2887.0,2887.0,Airbus A321 Neo,05/19/2024,2024-05-19 00:30:00,2024-05-19 13:36:00,HYD,BLR,220.0,255,139,-81,116,22,44,66,88,26,14,8,12,49,27,17,22,75,41,25,34,105,57,31,48,"{'F': 13, 'P': 9}","{'C': 18, 'J': 13, 'Z': 13}","{'Q': 20, 'R': 13, 'S': 7, 'T': 7, 'H': 13, 'M': 7}","{'Y': 7, 'A': 7, 'B': 3, 'D': 3, 'E': 3, 'G': 7, 'I': 3, 'K': 7, 'L': 3, 'N': 3, 'O': 3, 'U': 7, 'V': 3, 'W': 3, 'X': 3}"
INV-ZZ-2684728,SCH-ZZ-4079085,ZZ,ZZ20240521HYDBLR2887.0,2887.0,Airbus A321 Neo,05/21/2024,2024-05-21 00:30:00,2024-05-21 13:36:00,HYD,BLR,220.0,249,121,-99,128,22,44,66,88,25,12,10,13,53,26,18,27,74,36,30,38,102,50,38,52,"{'F': 13, 'P': 9}","{'C': 18, 'J': 13, 'Z': 13}","{'Q': 20, 'R': 13, 'S': 7, 'T': 7, 'H': 13, 'M': 7}","{'Y': 7, 'A': 7, 'B': 3, 'D': 3, 'E': 3, 'G': 7, 'I': 3, 'K': 7, 'L': 3, 'N': 3, 'O': 3, 'U': 7, 'V': 3, 'W': 3, 'X': 3}"
INV-ZZ-7674145,SCH-ZZ-4079085,ZZ,ZZ20240522HYDBLR2887.0,2887.0,Airbus A321 Neo,05/22/2024,2024-05-22 00:30:00,2024-05-22 13:36:00,HYD,BLR,220.0,244,130,-90,114,22,44,66,88,26,14,8,12,51,27,17,24,76,41,25,35,97,52,36,45,"{'F': 13, 'P': 9}","{'C': 18, 'J': 13, 'Z': 13}","{'Q': 20, 'R': 13, 'S': 7, 'T': 7, 'H': 13, 'M': 7}","{'Y': 7, 'A': 7, 'B': 3, 'D': 3, 'E': 3, 'G': 7, 'I': 3, 'K': 7, 'L': 3, 'N': 3, 'O': 3, 'U': 7, 'V': 3, 'W': 3, 'X': 3}"
INV-ZZ-2567604,SCH-ZZ-4079085,ZZ,ZZ20240523HYDBLR2887.0,2887.0,Airbus A321 Neo,05/23/2024,2024-05-23 00:30:00,2024-05-23 13:36:00,HYD,BLR,220.0,260,128,-92,132,22,44,66,88,26,13,9,13,49,24,20,25,79,39,27,40,98,48,40,50,"{'F': 13, 'P': 9}","{'C': 18, 'J': 13, 'Z': 13}","{'Q': 20, 'R': 13, 'S': 7, 'T': 7, 'H': 13, 'M': 7}","{'Y': 7, 'A': 7, 'B': 3, 'D': 3, 'E': 3, 'G': 7, 'I': 3, 'K': 7, 'L': 3, 'N': 3, 'O': 3, 'U': 7, 'V': 3, 'W': 3, 'X': 3}"
INV-ZZ-1782266,SCH-ZZ-4079085,ZZ,ZZ20240525HYDBLR2887.0,2887.0,Airbus A321 Neo,05/25/2024,2024-05-25 00:30:00,2024-05-25 13:36:00,HYD,BLR,220.0,247,123,-97,124,22,44,66,88,25,12,10,13,49,24,20,25,78,39,27,39,103,51,37,52,"{'F': 13, 'P': 9}","{'C': 18, 'J': 13, 'Z': 13}","{'Q': 20, 'R': 13, 'S': 7, 'T': 7, 'H': 13, 'M': 7}","{'Y': 7, 'A': 7, 'B': 3, 'D': 3, 'E': 3, 'G': 7, 'I': 3, 'K': 7, 'L': 3, 'N': 3, 'O': 3, 'U': 7, 'V': 3, 'W': 3, 'X': 3}"
INV-ZZ-9766380,SCH-ZZ-4079085,ZZ,ZZ20240526HYDBLR2887.0,2887.0,Airbus A321 Neo,05/26/2024,2024-05-26 00:30:00,2024-05-26 13:36:00,HYD,BLR,220.0,260,126,-94,134,22,44,66,88,25,12,10,13,50,24,20,26,78,38,28,40,106,51,37,55,"{'F': 13, 'P': 9}","{'C': 18, 'J': 13, 'Z': 13}","{'Q': 20, 'R': 13, 'S': 7, 'T': 7, 'H': 13, 'M': 7}","{'Y': 7, 'A': 7, 'B': 3, 'D': 3, 'E': 3, 'G': 7, 'I': 3, 'K': 7, 'L': 3, 'N': 3, 'O': 3, 'U': 7, 'V': 3, 'W': 3, 'X': 3}"
INV-ZZ-1246674,SCH-ZZ-4079085,ZZ,ZZ20240528HYDBLR2887.0,2887.0,Airbus A321 Neo,05/28/2024,2024-05-28 00:30:00,2024-05-28 13:36:00,HYD,BLR,220.0,254,130,-90,124,22,44,66,88,25,13,9,12,51,26,18,25,79,40,26,39,99,51,37,48,"{'F': 13, 'P': 9}","{'C': 18, 'J': 13, 'Z': 13}","{'Q': 20, 'R': 13, 'S': 7, 'T': 7, 'H': 13, 'M': 7}","{'Y': 7, 'A': 7, 'B': 3, 'D': 3, 'E': 3, 'G': 7, 'I': 3, 'K': 7, 'L': 3, 'N': 3, 'O': 3, 'U': 7, 'V': 3, 'W': 3, 'X': 3}"
INV-ZZ-5025219,SCH-ZZ-4079085,ZZ,ZZ20240529HYDBLR2887.0,2887.0,Airbus A321 Neo,05/29/2024,2024-05-29 00:30:00,2024-05-29 13:36:00,HYD,BLR,220.0,244,111,-109,133,22,44,66,88,25,11,11,14,52,24,20,28,76,34,32,42,99,45,43,54,"{'F': 13, 'P': 9}","{'C': 18, 'J': 13, 'Z': 13}","{'Q': 20, 'R': 13, 'S': 7, 'T': 7, 'H': 13, 'M': 7}","{'Y': 7, 'A': 7, 'B': 3, 'D': 3, 'E': 3, 'G': 7, 'I': 3, 'K': 7, 'L': 3, 'N': 3, 'O': 3, 'U': 7, 'V': 3, 'W': 3, 'X': 3}"
INV-ZZ-9793305,SCH-ZZ-4079085,ZZ,ZZ20240530HYDBLR2887.0,2887.0,Airbus A321 Neo,05/30/2024,2024-05-30 00:30:00,2024-05-30 13:36:00,HYD,BLR,220.0,245,112,-108,133,22,44,66,88,26,12,10,14,49,22,22,27,77,35,31,42,100,46,42,54,"{'F': 13, 'P': 9}","{'C': 18, 'J': 13, 'Z': 13}","{'Q': 20, 'R': 13, 'S': 7, 'T': 7, 'H': 13, 'M': 7}","{'Y': 7, 'A': 7, 'B': 3, 'D': 3, 'E': 3, 'G': 7, 'I': 3, 'K': 7, 'L': 3, 'N': 3, 'O': 3, 'U': 7, 'V': 3, 'W': 3, 'X': 3}"
INV-ZZ-7567394,SCH-ZZ-4079085,ZZ,ZZ20240601HYDBLR2887.0,2887.0,Airbus A321 Neo,06/01/2024,2024-06-01 00:30:00,2024-06-01 13:36:00,HYD,BLR,220.0,252,111,-109,141,22,44,66,88,25,11,11,14,49,22,22,27,74,33,33,41,101,45,43,56,"{'F': 13, 'P': 9}","{'C': 18, 'J': 13, 'Z': 13}","{'Q': 20, 'R': 13, 'S': 7, 'T': 7, 'H': 13, 'M': 7}","{'Y': 7, 'A': 7, 'B': 3, 'D': 3, 'E': 3, 'G': 7, 'I': 3, 'K': 7, 'L': 3, 'N': 3, 'O': 3, 'U': 7, 'V': 3, 'W': 3, 'X': 3}"
INV-ZZ-5231109,SCH-ZZ-4079085,ZZ,ZZ20240602HYDBLR2887.0,2887.0,Airbus A321 Neo,06/02/2024,2024-06-02 00:30:00,2024-06-02 13:36:00,HYD,BLR,220.0,255,118,-102,137,22,44,66,88,25,12,10,13,49,23,21,26,74,34,32,40,99,46,42,53,"{'F': 13, 'P': 9}","{'C': 18, 'J': 13, 'Z': 13}","{'Q': 20, 'R': 13, 'S': 7, 'T': 7, 'H': 13, 'M': 7}","{'Y': 7, 'A': 7, 'B': 3, 'D': 3, 'E': 3, 'G': 7, 'I': 3, 'K': 7, 'L': 3, 'N': 3, 'O': 3, 'U': 7, 'V': 3, 'W': 3, 'X': 3}"
INV-ZZ-9570629,SCH-ZZ-4079085,ZZ,ZZ20240604HYDBLR2887.0,2887.0,Airbus A321 Neo,06/04/2024,2024-06-04 00:30:00,2024-06-04 13:36:00,HYD,BLR,220.0,257,128,-92,129,22,44,66,88,25,12,10,13,52,26,18,26,73,36,30,37,99,49,39,50,"{'F': 13, 'P': 9}","{'C': 18, 'J': 13, 'Z': 13}","{'Q': 20, 'R': 13, 'S': 7, 'T': 7, 'H': 13, 'M': 7}","{'Y': 7, 'A': 7, 'B': 3, 'D': 3, 'E': 3, 'G': 7, 'I': 3, 'K': 7, 'L': 3, 'N': 3, 'O': 3, 'U': 7, 'V': 3, 'W': 3, 'X': 3}"
INV-ZZ-4368849,SCH-ZZ-4079085,ZZ,ZZ20240605HYDBLR2887.0,2887.0,Airbus A321 Neo,06/05/2024,2024-06-05 00:30:00,2024-06-05 13:36:00,HYD,BLR,220.0,259,115,-105,144,22,44,66,88,25,11,11,14,49,22,22,27,79,35,31,44,104,46,42,58,"{'F': 13, 'P': 9}","{'C': 18, 'J': 13, 'Z': 13}","{'Q': 20, 'R': 13, 'S': 7, 'T': 7, 'H': 13, 'M': 7}","{'Y': 7, 'A': 7, 'B': 3, 'D': 3, 'E': 3, 'G': 7, 'I': 3, 'K': 7, 'L': 3, 'N': 3, 'O': 3, 'U': 7, 'V': 3, 'W': 3, 'X': 3}"
INV-ZZ-6680944,SCH-ZZ-4079085,ZZ,ZZ20240606HYDBLR2887.0,2887.0,Airbus A321 Neo,06/06/2024,2024-06-06 00:30:00,2024-06-06 13:36:00,HYD,BLR,220.0,255,119,-101,136,22,44,66,88,25,12,10,13,52,24,20,28,73,34,32,39,105,49,39,56,"{'F': 13, 'P': 9}","{'C': 18, 'J': 13, 'Z': 13}","{'Q': 20, 'R': 13, 'S': 7, 'T': 7, 'H': 13, 'M': 7}","{'Y': 7, 'A': 7, 'B': 3, 'D': 3, 'E': 3, 'G': 7, 'I': 3, 'K': 7, 'L': 3, 'N': 3, 'O': 3, 'U': 7, 'V': 3, 'W': 3, 'X': 3}"
INV-ZZ-8259150,SCH-ZZ-4079085,ZZ,ZZ20240608HYDBLR2887.0,2887.0,Airbus A321 Neo,06/08/2024,2024-06-08 00:30:00,2024-06-08 13:36:00,HYD,BLR,220.0,259,127,-93,132,22,44,66,88,25,12,10,13,50,25,19,25,77,38,28,39,106,52,36,54,"{'F': 13, 'P': 9}","{'C': 18, 'J': 13, 'Z': 13}","{'Q': 20, 'R': 13, 'S': 7, 'T': 7, 'H': 13, 'M': 7}","{'Y': 7, 'A': 7, 'B': 3, 'D': 3, 'E': 3, 'G': 7, 'I': 3, 'K': 7, 'L': 3, 'N': 3, 'O': 3, 'U': 7, 'V': 3, 'W': 3, 'X': 3}"
INV-ZZ-7309448,SCH-ZZ-4079085,ZZ,ZZ20240609HYDBLR2887.0,2887.0,Airbus A321 Neo,06/09/2024,2024-06-09 00:30:00,2024-06-09 13:36:00,HYD,BLR,220.0,243,107,-113,136,22,44,66,88,26,11,11,15,51,23,21,28,77,34,32,43,99,44,44,55,"{'F': 13, 'P': 9}","{'C': 18, 'J': 13, 'Z': 13}","{'Q': 20, 'R': 13, 'S': 7, 'T': 7, 'H': 13, 'M': 7}","{'Y': 7, 'A': 7, 'B': 3, 'D': 3, 'E': 3, 'G': 7, 'I': 3, 'K': 7, 'L': 3, 'N': 3, 'O': 3, 'U': 7, 'V': 3, 'W': 3, 'X': 3}"
INV-ZZ-9474563,SCH-ZZ-4079085,ZZ,ZZ20240611HYDBLR2887.0,2887.0,Airbus A321 Neo,06/11/2024,2024-06-11 00:30:00,2024-06-11 13:36:00,HYD,BLR,220.0,256,118,-102,138,22,44,66,88,25,11,11,14,51,23,21,28,77,35,31,42,100,46,42,54,"{'F': 13, 'P': 9}","{'C': 18, 'J': 13, 'Z': 13}","{'Q': 20, 'R': 13, 'S': 7, 'T': 7, 'H': 13, 'M': 7}","{'Y': 7, 'A': 7, 'B': 3, 'D': 3, 'E': 3, 'G': 7, 'I': 3, 'K': 7, 'L': 3, 'N': 3, 'O': 3, 'U': 7, 'V': 3, 'W': 3, 'X': 3}"
INV-ZZ-7506799,SCH-ZZ-4079085,ZZ,ZZ20240612HYDBLR2887.0,2887.0,Airbus A321 Neo,06/12/2024,2024-06-12 00:30:00,2024-06-12 13:36:00,HYD,BLR,220.0,252,121,-99,131,22,44,66,88,25,12,10,13,49,24,20,25,75,36,30,39,98,47,41,51,"{'F': 13, 'P': 9}","{'C': 18, 'J': 13, 'Z': 13}","{'Q': 20, 'R': 13, 'S': 7, 'T': 7, 'H': 13, 'M': 7}","{'Y': 7, 'A': 7, 'B': 3, 'D': 3, 'E': 3, 'G': 7, 'I': 3, 'K': 7, 'L': 3, 'N': 3, 'O': 3, 'U': 7, 'V': 3, 'W': 3, 'X': 3}"
INV-ZZ-6879589,SCH-ZZ-4079085,ZZ,ZZ20240613HYDBLR2887.0,2887.0,Airbus A321 Neo,06/13/2024,2024-06-13 00:30:00,2024-06-13 13:36:00,HYD,BLR,220.0,257,118,-102,139,22,44,66,88,26,12,10,14,53,24,20,29,76,35,31,41,104,48,40,56,"{'F': 13, 'P': 9}","{'C': 18, 'J': 13, 'Z': 13}","{'Q': 20, 'R': 13, 'S': 7, 'T': 7, 'H': 13, 'M': 7}","{'Y': 7, 'A': 7, 'B': 3, 'D': 3, 'E': 3, 'G': 7, 'I': 3, 'K': 7, 'L': 3, 'N': 3, 'O': 3, 'U': 7, 'V': 3, 'W': 3, 'X': 3}"
INV-ZZ-1057633,SCH-ZZ-4079085,ZZ,ZZ20240615HYDBLR2887.0,2887.0,Airbus A321 Neo,06/15/2024,2024-06-15 00:30:00,2024-06-15 13:36:00,HYD,BLR,220.0,247,105,-115,142,22,44,66,88,25,11,11,14,49,21,23,28,74,32,34,42,103,44,44,59,"{'F': 13, 'P': 9}","{'C': 18, 'J': 13, 'Z': 13}","{'Q': 20, 'R': 13, 'S': 7, 'T': 7, 'H': 13, 'M': 7}","{'Y': 7, 'A': 7, 'B': 3, 'D': 3, 'E': 3, 'G': 7, 'I': 3, 'K': 7, 'L': 3, 'N': 3, 'O': 3, 'U': 7, 'V': 3, 'W': 3, 'X': 3}"
INV-ZZ-4501663,SCH-ZZ-4079085,ZZ,ZZ20240616HYDBLR2887.0,2887.0,Airbus A321 Neo,06/16/2024,2024-06-16 00:30:00,2024-06-16 13:36:00,HYD,BLR,220.0,251,103,-117,148,22,44,66,88,25,10,12,15,49,20,24,29,76,31,35,45,101,41,47,60,"{'F': 13, 'P': 9}","{'C': 18, 'J': 13, 'Z': 13}","{'Q': 20, 'R': 13, 'S': 7, 'T': 7, 'H': 13, 'M': 7}","{'Y': 7, 'A': 7, 'B': 3, 'D': 3, 'E': 3, 'G': 7, 'I': 3, 'K': 7, 'L': 3, 'N': 3, 'O': 3, 'U': 7, 'V': 3, 'W': 3, 'X': 3}"
INV-ZZ-9841359,SCH-ZZ-4079085,ZZ,ZZ20240618HYDBLR2887.0,2887.0,Airbus A321 Neo,06/18/2024,2024-06-18 00:30:00,2024-06-18 13:36:00,HYD,BLR,220.0,263,106,-114,157,22,44,66,88,26,11,11,15,49,20,24,29,77,31,35,46,103,42,46,61,"{'F': 13, 'P': 9}","{'C': 18, 'J': 13, 'Z': 13}","{'Q': 20, 'R': 13, 'S': 7, 'T': 7, 'H': 13, 'M': 7}","{'Y': 7, 'A': 7, 'B': 3, 'D': 3, 'E': 3, 'G': 7, 'I': 3, 'K': 7, 'L': 3, 'N': 3, 'O': 3, 'U': 7, 'V': 3, 'W': 3, 'X': 3}"
INV-ZZ-8175948,SCH-ZZ-4079085,ZZ,ZZ20240619HYDBLR2887.0,2887.0,Airbus A321 Neo,06/19/2024,2024-06-19 00:30:00,2024-06-19 13:36:00,HYD,BLR,220.0,249,102,-118,147,22,44,66,88,25,10,12,15,51,21,23,30,78,32,34,46,104,42,46,62,"{'F': 13, 'P': 9}","{'C': 18, 'J': 13, 'Z': 13}","{'Q': 20, 'R': 13, 'S': 7, 'T': 7, 'H': 13, 'M': 7}","{'Y': 7, 'A': 7, 'B': 3, 'D': 3, 'E': 3, 'G': 7, 'I': 3, 'K': 7, 'L': 3, 'N': 3, 'O': 3, 'U': 7, 'V': 3, 'W': 3, 'X': 3}"
INV-ZZ-2318111,SCH-ZZ-4079085,ZZ,ZZ20240620HYDBLR2887.0,2887.0,Airbus A321 Neo,06/20/2024,2024-06-20 00:30:00,2024-06-20 13:36:00,HYD,BLR,220.0,248,100,-120,148,22,44,66,88,24,10,12,14,49,20,24,29,73,29,37,44,100,40,48,60,"{'F': 13, 'P': 9}","{'C': 18, 'J': 13, 'Z': 13}","{'Q': 20, 'R': 13, 'S': 7, 'T': 7, 'H': 13, 'M': 7}","{'Y': 7, 'A': 7, 'B': 3, 'D': 3, 'E': 3, 'G': 7, 'I': 3, 'K': 7, 'L': 3, 'N': 3, 'O': 3, 'U': 7, 'V': 3, 'W': 3, 'X': 3}"
INV-ZZ-2006385,SCH-ZZ-9301492,ZZ,ZZ20240424AMDBOM4676.0,4676.0,Airbus A320-200,04/24/2024,2024-04-24 02:56:00,2024-04-24 23:00:00,AMD,BOM,150.0,169,90,-60,79,15,30,45,60,17,9,6,8,36,19,11,17,52,28,17,24,66,35,25,31,"{'F': 9, 'P': 6}","{'C': 12, 'J': 9, 'Z': 9}","{'Q': 14, 'R': 9, 'S': 4, 'T': 4, 'H': 9, 'M': 4}","{'Y': 4, 'A': 4, 'B': 2, 'D': 2, 'E': 2, 'G': 4, 'I': 2, 'K': 4, 'L': 2, 'N': 2, 'O': 2, 'U': 4, 'V': 2, 'W': 2, 'X': 2}"
INV-ZZ-8147946,SCH-ZZ-9301492,ZZ,ZZ20240426AMDBOM4676.0,4676.0,Airbus A320-200,04/26/2024,2024-04-26 02:56:00,2024-04-26 23:00:00,AMD,BOM,150.0,176,103,-47,73,15,30,45,60,17,10,5,7,35,21,9,14,52,31,14,21,66,39,21,27,"{'F': 9, 'P': 6}","{'C': 12, 'J': 9, 'Z': 9}","{'Q': 14, 'R': 9, 'S': 4, 'T': 4, 'H': 9, 'M': 4}","{'Y': 4, 'A': 4, 'B': 2, 'D': 2, 'E': 2, 'G': 4, 'I': 2, 'K': 4, 'L': 2, 'N': 2, 'O': 2, 'U': 4, 'V': 2, 'W': 2, 'X': 2}"
INV-ZZ-3888450,SCH-ZZ-9301492,ZZ,ZZ20240501AMDBOM4676.0,4676.0,Airbus A320-200,05/01/2024,2024-05-01 02:56:00,2024-05-01 23:00:00,AMD,BOM,150.0,178,104,-46,74,15,30,45,60,18,11,4,7,35,21,9,14,51,30,15,21,69,40,20,29,"{'F': 9, 'P': 6}","{'C': 12, 'J': 9, 'Z': 9}","{'Q': 14, 'R': 9, 'S': 4, 'T': 4, 'H': 9, 'M': 4}","{'Y': 4, 'A': 4, 'B': 2, 'D': 2, 'E': 2, 'G': 4, 'I': 2, 'K': 4, 'L': 2, 'N': 2, 'O': 2, 'U': 4, 'V': 2, 'W': 2, 'X': 2}"
INV-ZZ-1983316,SCH-ZZ-9301492,ZZ,ZZ20240503AMDBOM4676.0,4676.0,Airbus A320-200,05/03/2024,2024-05-03 02:56:00,2024-05-03 23:00:00,AMD,BOM,150.0,172,90,-60,82,15,30,45,60,18,9,6,9,34,18,12,16,52,27,18,25,71,37,23,34,"{'F': 9, 'P': 6}","{'C': 12, 'J': 9, 'Z': 9}","{'Q': 14, 'R': 9, 'S': 4, 'T': 4, 'H': 9, 'M': 4}","{'Y': 4, 'A': 4, 'B': 2, 'D': 2, 'E': 2, 'G': 4, 'I': 2, 'K': 4, 'L': 2, 'N': 2, 'O': 2, 'U': 4, 'V': 2, 'W': 2, 'X': 2}"
INV-ZZ-3075991,SCH-ZZ-9301492,ZZ,ZZ20240508AMDBOM4676.0,4676.0,Airbus A320-200,05/08/2024,2024-05-08 02:56:00,2024-05-08 23:00:00,AMD,BOM,150.0,166,94,-56,72,15,30,45,60,18,10,5,8,35,20,10,15,50,28,17,22,70,40,20,30,"{'F': 9, 'P': 6}","{'C': 12, 'J': 9, 'Z': 9}","{'Q': 14, 'R': 9, 'S': 4, 'T': 4, 'H': 9, 'M': 4}","{'Y': 4, 'A': 4, 'B': 2, 'D': 2, 'E': 2, 'G': 4, 'I': 2, 'K': 4, 'L': 2, 'N': 2, 'O': 2, 'U': 4, 'V': 2, 'W': 2, 'X': 2}"
INV-ZZ-8137298,SCH-ZZ-9301492,ZZ,ZZ20240510AMDBOM4676.0,4676.0,Airbus A320-200,05/10/2024,2024-05-10 02:56:00,2024-05-10 23:00:00,AMD,BOM,150.0,169,90,-60,79,15,30,45,60,17,9,6,8,36,19,11,17,53,28,17,25,67,36,24,31,"{'F': 9, 'P': 6}","{'C': 12, 'J': 9, 'Z': 9}","{'Q': 14, 'R': 9, 'S': 4, 'T': 4, 'H': 9, 'M': 4}","{'Y': 4, 'A': 4, 'B': 2, 'D': 2, 'E': 2, 'G': 4, 'I': 2, 'K': 4, 'L': 2, 'N': 2, 'O': 2, 'U': 4, 'V': 2, 'W': 2, 'X': 2}"
INV-ZZ-6246022,SCH-ZZ-9301492,ZZ,ZZ20240515AMDBOM4676.0,4676.0,Airbus A320-200,05/15/2024,2024-05-15 02:56:00,2024-05-15 23:00:00,AMD,BOM,150.0,166,84,-66,82,15,30,45,60,18,9,6,9,35,18,12,17,53,27,18,26,67,34,26,33,"{'F': 9, 'P': 6}","{'C': 12, 'J': 9, 'Z': 9}","{'Q': 14, 'R': 9, 'S': 4, 'T': 4, 'H': 9, 'M': 4}","{'Y': 4, 'A': 4, 'B': 2, 'D': 2, 'E': 2, 'G': 4, 'I': 2, 'K': 4, 'L': 2, 'N': 2, 'O': 2, 'U': 4, 'V': 2, 'W': 2, 'X': 2}"
INV-ZZ-2548314,SCH-ZZ-9301492,ZZ,ZZ20240517AMDBOM4676.0,4676.0,Airbus A320-200,05/17/2024,2024-05-17 02:56:00,2024-05-17 23:00:00,AMD,BOM,150.0,174,88,-62,86,15,30,45,60,17,9,6,8,34,17,13,17,52,26,19,26,70,35,25,35,"{'F': 9, 'P': 6}","{'C': 12, 'J': 9, 'Z': 9}","{'Q': 14, 'R': 9, 'S': 4, 'T': 4, 'H': 9, 'M': 4}","{'Y': 4, 'A': 4, 'B': 2, 'D': 2, 'E': 2, 'G': 4, 'I': 2, 'K': 4, 'L': 2, 'N': 2, 'O': 2, 'U': 4, 'V': 2, 'W': 2, 'X': 2}"
INV-ZZ-8946363,SCH-ZZ-9301492,ZZ,ZZ20240522AMDBOM4676.0,4676.0,Airbus A320-200,05/22/2024,2024-05-22 02:56:00,2024-05-22 23:00:00,AMD,BOM,150.0,165,83,-67,82,15,30,45,60,18,9,6,9,35,18,12,17,51,26,19,25,69,35,25,34,"{'F': 9, 'P': 6}","{'C': 12, 'J': 9, 'Z': 9}","{'Q': 14, 'R': 9, 'S': 4, 'T': 4, 'H': 9, 'M': 4}","{'Y': 4, 'A': 4, 'B': 2, 'D': 2, 'E': 2, 'G': 4, 'I': 2, 'K': 4, 'L': 2, 'N': 2, 'O': 2, 'U': 4, 'V': 2, 'W': 2, 'X': 2}"
INV-ZZ-4865327,SCH-ZZ-9301492,ZZ,ZZ20240524AMDBOM4676.0,4676.0,Airbus A320-200,05/24/2024,2024-05-24 02:56:00,2024-05-24 23:00:00,AMD,BOM,150.0,179,85,-65,94,15,30,45,60,18,9,6,9,35,17,13,18,50,24,21,26,70,33,27,37,"{'F': 9, 'P': 6}","{'C': 12, 'J': 9, 'Z': 9}","{'Q': 14, 'R': 9, 'S': 4, 'T': 4, 'H': 9, 'M': 4}","{'Y': 4, 'A': 4, 'B': 2, 'D': 2, 'E': 2, 'G': 4, 'I': 2, 'K': 4, 'L': 2, 'N': 2, 'O': 2, 'U': 4, 'V': 2, 'W': 2, 'X': 2}"
INV-ZZ-6293360,SCH-ZZ-9301492,ZZ,ZZ20240529AMDBOM4676.0,4676.0,Airbus A320-200,05/29/2024,2024-05-29 02:56:00,2024-05-29 23:00:00,AMD,BOM,150.0,170,78,-72,92,15,30,45,60,17,8,7,9,35,16,14,19,52,24,21,28,67,31,29,36,"{'F': 9, 'P': 6}","{'C': 12, 'J': 9, 'Z': 9}","{'Q': 14, 'R': 9, 'S': 4, 'T': 4, 'H': 9, 'M': 4}","{'Y': 4, 'A': 4, 'B': 2, 'D': 2, 'E': 2, 'G': 4, 'I': 2, 'K': 4, 'L': 2, 'N': 2, 'O': 2, 'U': 4, 'V': 2, 'W': 2, 'X': 2}"
INV-ZZ-1781840,SCH-ZZ-9301492,ZZ,ZZ20240531AMDBOM4676.0,4676.0,Airbus A320-200,05/31/2024,2024-05-31 02:56:00,2024-05-31 23:00:00,AMD,BOM,150.0,165,83,-67,82,15,30,45,60,17,9,6,8,33,17,13,16,53,27,18,26,71,36,24,35,"{'F': 9, 'P': 6}","{'C': 12, 'J': 9, 'Z': 9}","{'Q': 14, 'R': 9, 'S': 4, 'T': 4, 'H': 9, 'M': 4}","{'Y': 4, 'A': 4, 'B': 2, 'D': 2, 'E': 2, 'G': 4, 'I': 2, 'K': 4, 'L': 2, 'N': 2, 'O': 2, 'U': 4, 'V': 2, 'W': 2, 'X': 2}"
INV-ZZ-8677668,SCH-ZZ-9301492,ZZ,ZZ20240605AMDBOM4676.0,4676.0,Airbus A320-200,06/05/2024,2024-06-05 02:56:00,2024-06-05 23:00:00,AMD,BOM,150.0,174,79,-71,95,15,30,45,60,18,8,7,10,35,16,14,19,52,24,21,28,68,31,29,37,"{'F': 9, 'P': 6}","{'C': 12, 'J': 9, 'Z': 9}","{'Q': 14, 'R': 9, 'S': 4, 'T': 4, 'H': 9, 'M': 4}","{'Y': 4, 'A': 4, 'B': 2, 'D': 2, 'E': 2, 'G': 4, 'I': 2, 'K': 4, 'L': 2, 'N': 2, 'O': 2, 'U': 4, 'V': 2, 'W': 2, 'X': 2}"
INV-ZZ-1892796,SCH-ZZ-3443610,ZZ,ZZ20240515DELMAA3440.0,3440.0,Airbus A320-200,05/15/2024,2024-05-15 02:24:00,2024-05-16 01:00:00,DEL,MAA,150.0,165,89,-61,76,15,30,45,60,17,9,6,8,35,19,11,16,51,27,18,24,66,36,24,30,"{'F': 9, 'P': 6}","{'C': 12, 'J': 9, 'Z': 9}","{'Q': 14, 'R': 9, 'S': 4, 'T': 4, 'H': 9, 'M': 4}","{'Y': 4, 'A': 4, 'B': 2, 'D': 2, 'E': 2, 'G': 4, 'I': 2, 'K': 4, 'L': 2, 'N': 2, 'O': 2, 'U': 4, 'V': 2, 'W': 2, 'X': 2}"
INV-ZZ-9554555,SCH-ZZ-3443610,ZZ,ZZ20240516DELMAA3440.0,3440.0,Airbus A320-200,05/16/2024,2024-05-16 02:24:00,2024-05-17 01:00:00,DEL,MAA,150.0,168,89,-61,79,15,30,45,60,17,9,6,8,33,17,13,16,51,27,18,24,67,35,25,32,"{'F': 9, 'P': 6}","{'C': 12, 'J': 9, 'Z': 9}","{'Q': 14, 'R': 9, 'S': 4, 'T': 4, 'H': 9, 'M': 4}","{'Y': 4, 'A': 4, 'B': 2, 'D': 2, 'E': 2, 'G': 4, 'I': 2, 'K': 4, 'L': 2, 'N': 2, 'O': 2, 'U': 4, 'V': 2, 'W': 2, 'X': 2}"
INV-ZZ-9510104,SCH-ZZ-3443610,ZZ,ZZ20240517DELMAA3440.0,3440.0,Airbus A320-200,05/17/2024,2024-05-17 02:24:00,2024-05-18 01:00:00,DEL,MAA,150.0,175,94,-56,81,15,30,45,60,17,9,6,8,35,19,11,16,51,27,18,24,66,35,25,31,"{'F': 9, 'P': 6}","{'C': 12, 'J': 9, 'Z': 9}","{'Q': 14, 'R': 9, 'S': 4, 'T': 4, 'H': 9, 'M': 4}","{'Y': 4, 'A': 4, 'B': 2, 'D': 2, 'E': 2, 'G': 4, 'I': 2, 'K': 4, 'L': 2, 'N': 2, 'O': 2, 'U': 4, 'V': 2, 'W': 2, 'X': 2}"
INV-ZZ-9246753,SCH-ZZ-3443610,ZZ,ZZ20240522DELMAA3440.0,3440.0,Airbus A320-200,05/22/2024,2024-05-22 02:24:00,2024-05-23 01:00:00,DEL,MAA,150.0,172,83,-67,89,15,30,45,60,17,8,7,9,33,16,14,17,51,24,21,27,66,32,28,34,"{'F': 9, 'P': 6}","{'C': 12, 'J': 9, 'Z': 9}","{'Q': 14, 'R': 9, 'S': 4, 'T': 4, 'H': 9, 'M': 4}","{'Y': 4, 'A': 4, 'B': 2, 'D': 2, 'E': 2, 'G': 4, 'I': 2, 'K': 4, 'L': 2, 'N': 2, 'O': 2, 'U': 4, 'V': 2, 'W': 2, 'X': 2}"
INV-ZZ-6720023,SCH-ZZ-3443610,ZZ,ZZ20240523DELMAA3440.0,3440.0,Airbus A320-200,05/23/2024,2024-05-23 02:24:00,2024-05-24 01:00:00,DEL,MAA,150.0,178,83,-67,95,15,30,45,60,17,8,7,9,35,16,14,19,50,23,22,27,67,31,29,36,"{'F': 9, 'P': 6}","{'C': 12, 'J': 9, 'Z': 9}","{'Q': 14, 'R': 9, 'S': 4, 'T': 4, 'H': 9, 'M': 4}","{'Y': 4, 'A': 4, 'B': 2, 'D': 2, 'E': 2, 'G': 4, 'I': 2, 'K': 4, 'L': 2, 'N': 2, 'O': 2, 'U': 4, 'V': 2, 'W': 2, 'X': 2}"
INV-ZZ-6302399,SCH-ZZ-3443610,ZZ,ZZ20240524DELMAA3440.0,3440.0,Airbus A320-200,05/24/2024,2024-05-24 02:24:00,2024-05-25 01:00:00,DEL,MAA,150.0,172,89,-61,83,15,30,45,60,18,9,6,9,33,17,13,16,50,26,19,24,69,36,24,33,"{'F': 9, 'P': 6}","{'C': 12, 'J': 9, 'Z': 9}","{'Q': 14, 'R': 9, 'S': 4, 'T': 4, 'H': 9, 'M': 4}","{'Y': 4, 'A': 4, 'B': 2, 'D': 2, 'E': 2, 'G': 4, 'I': 2, 'K': 4, 'L': 2, 'N': 2, 'O': 2, 'U': 4, 'V': 2, 'W': 2, 'X': 2}"
INV-ZZ-5033296,SCH-ZZ-3443610,ZZ,ZZ20240529DELMAA3440.0,3440.0,Airbus A320-200,05/29/2024,2024-05-29 02:24:00,2024-05-30 01:00:00,DEL,MAA,150.0,174,79,-71,95,15,30,45,60,17,8,7,9,36,16,14,20,51,23,22,28,69,31,29,38,"{'F': 9, 'P': 6}","{'C': 12, 'J': 9, 'Z': 9}","{'Q': 14, 'R': 9, 'S': 4, 'T': 4, 'H': 9, 'M': 4}","{'Y': 4, 'A': 4, 'B': 2, 'D': 2, 'E': 2, 'G': 4, 'I': 2, 'K': 4, 'L': 2, 'N': 2, 'O': 2, 'U': 4, 'V': 2, 'W': 2, 'X': 2}"
INV-ZZ-9038670,SCH-ZZ-3443610,ZZ,ZZ20240530DELMAA3440.0,3440.0,Airbus A320-200,05/30/2024,2024-05-30 02:24:00,2024-05-31 01:00:00,DEL,MAA,150.0,169,82,-68,87,15,30,45,60,17,8,7,9,35,17,13,18,50,24,21,26,70,34,26,36,"{'F': 9, 'P': 6}","{'C': 12, 'J': 9, 'Z': 9}","{'Q': 14, 'R': 9, 'S': 4, 'T': 4, 'H': 9, 'M': 4}","{'Y': 4, 'A': 4, 'B': 2, 'D': 2, 'E': 2, 'G': 4, 'I': 2, 'K': 4, 'L': 2, 'N': 2, 'O': 2, 'U': 4, 'V': 2, 'W': 2, 'X': 2}"
INV-ZZ-7375134,SCH-ZZ-3443610,ZZ,ZZ20240531DELMAA3440.0,3440.0,Airbus A320-200,05/31/2024,2024-05-31 02:24:00,2024-06-01 01:00:00,DEL,MAA,150.0,165,80,-70,85,15,30,45,60,17,8,7,9,34,16,14,18,51,25,20,26,71,34,26,37,"{'F': 9, 'P': 6}","{'C': 12, 'J': 9, 'Z': 9}","{'Q': 14, 'R': 9, 'S': 4, 'T': 4, 'H': 9, 'M': 4}","{'Y': 4, 'A': 4, 'B': 2, 'D': 2, 'E': 2, 'G': 4, 'I': 2, 'K': 4, 'L': 2, 'N': 2, 'O': 2, 'U': 4, 'V': 2, 'W': 2, 'X': 2}"
INV-ZZ-1786791,SCH-ZZ-3443610,ZZ,ZZ20240605DELMAA3440.0,3440.0,Airbus A320-200,06/05/2024,2024-06-05 02:24:00,2024-06-06 01:00:00,DEL,MAA,150.0,179,85,-65,94,15,30,45,60,17,8,7,9,34,16,14,18,51,24,21,27,66,31,29,35,"{'F': 9, 'P': 6}","{'C': 12, 'J': 9, 'Z': 9}","{'Q': 14, 'R': 9, 'S': 4, 'T': 4, 'H': 9, 'M': 4}","{'Y': 4, 'A': 4, 'B': 2, 'D': 2, 'E': 2, 'G': 4, 'I': 2, 'K': 4, 'L': 2, 'N': 2, 'O': 2, 'U': 4, 'V': 2, 'W': 2, 'X': 2}"
INV-ZZ-1859179,SCH-ZZ-3443610,ZZ,ZZ20240606DELMAA3440.0,3440.0,Airbus A320-200,06/06/2024,2024-06-06 02:24:00,2024-06-07 01:00:00,DEL,MAA,150.0,179,90,-60,89,15,30,45,60,18,9,6,9,34,17,13,17,52,26,19,26,69,35,25,34,"{'F': 9, 'P': 6}","{'C': 12, 'J': 9, 'Z': 9}","{'Q': 14, 'R': 9, 'S': 4, 'T': 4, 'H': 9, 'M': 4}","{'Y': 4, 'A': 4, 'B': 2, 'D': 2, 'E': 2, 'G': 4, 'I': 2, 'K': 4, 'L': 2, 'N': 2, 'O': 2, 'U': 4, 'V': 2, 'W': 2, 'X': 2}"
INV-ZZ-3410826,SCH-ZZ-3443610,ZZ,ZZ20240607DELMAA3440.0,3440.0,Airbus A320-200,06/07/2024,2024-06-07 02:24:00,2024-06-08 01:00:00,DEL,MAA,150.0,167,73,-77,94,15,30,45,60,17,7,8,10,35,15,15,20,52,23,22,29,71,31,29,40,"{'F': 9, 'P': 6}","{'C': 12, 'J': 9, 'Z': 9}","{'Q': 14, 'R': 9, 'S': 4, 'T': 4, 'H': 9, 'M': 4}","{'Y': 4, 'A': 4, 'B': 2, 'D': 2, 'E': 2, 'G': 4, 'I': 2, 'K': 4, 'L': 2, 'N': 2, 'O': 2, 'U': 4, 'V': 2, 'W': 2, 'X': 2}"
INV-ZZ-1603985,SCH-ZZ-3443610,ZZ,ZZ20240612DELMAA3440.0,3440.0,Airbus A320-200,06/12/2024,2024-06-12 02:24:00,2024-06-13 01:00:00,DEL,MAA,150.0,175,85,-65,90,15,30,45,60,18,9,6,9,35,17,13,18,54,26,19,28,69,33,27,36,"{'F': 9, 'P': 6}","{'C': 12, 'J': 9, 'Z': 9}","{'Q': 14, 'R': 9, 'S': 4, 'T': 4, 'H': 9, 'M': 4}","{'Y': 4, 'A': 4, 'B': 2, 'D': 2, 'E': 2, 'G': 4, 'I': 2, 'K': 4, 'L': 2, 'N': 2, 'O': 2, 'U': 4, 'V': 2, 'W': 2, 'X': 2}"
INV-ZZ-7008294,SCH-ZZ-3443610,ZZ,ZZ20240613DELMAA3440.0,3440.0,Airbus A320-200,06/13/2024,2024-06-13 02:24:00,2024-06-14 01:00:00,DEL,MAA,150.0,167,76,-74,91,15,30,45,60,17,8,7,9,34,16,14,18,51,23,22,28,67,31,29,36,"{'F': 9, 'P': 6}","{'C': 12, 'J': 9, 'Z': 9}","{'Q': 14, 'R': 9, 'S': 4, 'T': 4, 'H': 9, 'M': 4}","{'Y': 4, 'A': 4, 'B': 2, 'D': 2, 'E': 2, 'G': 4, 'I': 2, 'K': 4, 'L': 2, 'N': 2, 'O': 2, 'U': 4, 'V': 2, 'W': 2, 'X': 2}"
INV-ZZ-4516873,SCH-ZZ-3443610,ZZ,ZZ20240614DELMAA3440.0,3440.0,Airbus A320-200,06/14/2024,2024-06-14 02:24:00,2024-06-15 01:00:00,DEL,MAA,150.0,168,74,-76,94,15,30,45,60,17,7,8,10,35,15,15,20,51,22,23,29,71,31,29,40,"{'F': 9, 'P': 6}","{'C': 12, 'J': 9, 'Z': 9}","{'Q': 14, 'R': 9, 'S': 4, 'T': 4, 'H': 9, 'M': 4}","{'Y': 4, 'A': 4, 'B': 2, 'D': 2, 'E': 2, 'G': 4, 'I': 2, 'K': 4, 'L': 2, 'N': 2, 'O': 2, 'U': 4, 'V': 2, 'W': 2, 'X': 2}"
INV-ZZ-9139201,SCH-ZZ-3443610,ZZ,ZZ20240619DELMAA3440.0,3440.0,Airbus A320-200,06/19/2024,2024-06-19 02:24:00,2024-06-20 01:00:00,DEL,MAA,150.0,166,77,-73,89,15,30,45,60,17,8,7,9,35,16,14,19,51,24,21,27,67,31,29,36,"{'F': 9, 'P': 6}","{'C': 12, 'J': 9, 'Z': 9}","{'Q': 14, 'R': 9, 'S': 4, 'T': 4, 'H': 9, 'M': 4}","{'Y': 4, 'A': 4, 'B': 2, 'D': 2, 'E': 2, 'G': 4, 'I': 2, 'K': 4, 'L': 2, 'N': 2, 'O': 2, 'U': 4, 'V': 2, 'W': 2, 'X': 2}"
INV-ZZ-3463700,SCH-ZZ-3443610,ZZ,ZZ20240620DELMAA3440.0,3440.0,Airbus A320-200,06/20/2024,2024-06-20 02:24:00,2024-06-21 01:00:00,DEL,MAA,150.0,175,70,-80,105,15,30,45,60,18,7,8,11,34,14,16,20,50,20,25,30,71,29,31,42,"{'F': 9, 'P': 6}","{'C': 12, 'J': 9, 'Z': 9}","{'Q': 14, 'R': 9, 'S': 4, 'T': 4, 'H': 9, 'M': 4}","{'Y': 4, 'A': 4, 'B': 2, 'D': 2, 'E': 2, 'G': 4, 'I': 2, 'K': 4, 'L': 2, 'N': 2, 'O': 2, 'U': 4, 'V': 2, 'W': 2, 'X': 2}"
INV-ZZ-1808170,SCH-ZZ-3443610,ZZ,ZZ20240621DELMAA3440.0,3440.0,Airbus A320-200,06/21/2024,2024-06-21 02:24:00,2024-06-22 01:00:00,DEL,MAA,150.0,167,76,-74,91,15,30,45,60,17,8,7,9,33,15,15,18,50,23,22,27,71,32,28,39,"{'F': 9, 'P': 6}","{'C': 12, 'J': 9, 'Z': 9}","{'Q': 14, 'R': 9, 'S': 4, 'T': 4, 'H': 9, 'M': 4}","{'Y': 4, 'A': 4, 'B': 2, 'D': 2, 'E': 2, 'G': 4, 'I': 2, 'K': 4, 'L': 2, 'N': 2, 'O': 2, 'U': 4, 'V': 2, 'W': 2, 'X': 2}"
INV-ZZ-7113422,SCH-ZZ-3443610,ZZ,ZZ20240626DELMAA3440.0,3440.0,Airbus A320-200,06/26/2024,2024-06-26 02:24:00,2024-06-27 01:00:00,DEL,MAA,150.0,170,72,-78,98,15,30,45,60,18,8,7,10,35,15,15,20,52,22,23,30,72,31,29,41,"{'F': 9, 'P': 6}","{'C': 12, 'J': 9, 'Z': 9}","{'Q': 14, 'R': 9, 'S': 4, 'T': 4, 'H': 9, 'M': 4}","{'Y': 4, 'A': 4, 'B': 2, 'D': 2, 'E': 2, 'G': 4, 'I': 2, 'K': 4, 'L': 2, 'N': 2, 'O': 2, 'U': 4, 'V': 2, 'W': 2, 'X': 2}"
INV-ZZ-4984981,SCH-ZZ-3443610,ZZ,ZZ20240627DELMAA3440.0,3440.0,Airbus A320-200,06/27/2024,2024-06-27 02:24:00,2024-06-28 01:00:00,DEL,MAA,150.0,167,72,-78,95,15,30,45,60,18,8,7,10,35,15,15,20,54,23,22,31,70,30,30,40,"{'F': 9, 'P': 6}","{'C': 12, 'J': 9, 'Z': 9}","{'Q': 14, 'R': 9, 'S': 4, 'T': 4, 'H': 9, 'M': 4}","{'Y': 4, 'A': 4, 'B': 2, 'D': 2, 'E': 2, 'G': 4, 'I': 2, 'K': 4, 'L': 2, 'N': 2, 'O': 2, 'U': 4, 'V': 2, 'W': 2, 'X': 2}"
INV-ZZ-8337689,SCH-ZZ-3443610,ZZ,ZZ20240628DELMAA3440.0,3440.0,Airbus A320-200,06/28/2024,2024-06-28 02:24:00,2024-06-29 01:00:00,DEL,MAA,150.0,173,66,-84,107,15,30,45,60,17,7,8,10,35,13,17,22,53,20,25,33,69,27,33,42,"{'F': 9, 'P': 6}","{'C': 12, 'J': 9, 'Z': 9}","{'Q': 14, 'R': 9, 'S': 4, 'T': 4, 'H': 9, 'M': 4}","{'Y': 4, 'A': 4, 'B': 2, 'D': 2, 'E': 2, 'G': 4, 'I': 2, 'K': 4, 'L': 2, 'N': 2, 'O': 2, 'U': 4, 'V': 2, 'W': 2, 'X': 2}"
INV-ZZ-4445984,SCH-ZZ-5335207,ZZ,ZZ20240502BOMHYD2933.0,2933.0,Boeing 757,05/02/2024,2024-05-02 14:57:00,2024-05-02 20:14:00,BOM,HYD,209.0,247,132,-77,115,20,41,62,83,23,12,8,11,49,26,15,23,71,38,24,33,96,51,32,45,"{'F': 12, 'P': 8}","{'C': 16, 'J': 12, 'Z': 12}","{'Q': 19, 'R': 12, 'S': 6, 'T': 6, 'H': 12, 'M': 6}","{'Y': 6, 'A': 6, 'B': 3, 'D': 3, 'E': 3, 'G': 6, 'I': 3, 'K': 6, 'L': 3, 'N': 3, 'O': 3, 'U': 6, 'V': 3, 'W': 3, 'X': 3}"
INV-ZZ-3830537,SCH-ZZ-5335207,ZZ,ZZ20240503BOMHYD2933.0,2933.0,Boeing 757,05/03/2024,2024-05-03 14:57:00,2024-05-03 20:14:00,BOM,HYD,209.0,238,125,-84,113,20,41,62,83,23,12,8,11,49,26,15,23,70,37,25,33,95,50,33,45,"{'F': 12, 'P': 8}","{'C': 16, 'J': 12, 'Z': 12}","{'Q': 19, 'R': 12, 'S': 6, 'T': 6, 'H': 12, 'M': 6}","{'Y': 6, 'A': 6, 'B': 3, 'D': 3, 'E': 3, 'G': 6, 'I': 3, 'K': 6, 'L': 3, 'N': 3, 'O': 3, 'U': 6, 'V': 3, 'W': 3, 'X': 3}"
INV-ZZ-9706010,SCH-ZZ-5335207,ZZ,ZZ20240504BOMHYD2933.0,2933.0,Boeing 757,05/04/2024,2024-05-04 14:57:00,2024-05-04 20:14:00,BOM,HYD,209.0,234,136,-73,98,20,41,62,83,24,14,6,10,46,27,14,19,72,42,20,30,98,57,26,41,"{'F': 12, 'P': 8}","{'C': 16, 'J': 12, 'Z': 12}","{'Q': 19, 'R': 12, 'S': 6, 'T': 6, 'H': 12, 'M': 6}","{'Y': 6, 'A': 6, 'B': 3, 'D': 3, 'E': 3, 'G': 6, 'I': 3, 'K': 6, 'L': 3, 'N': 3, 'O': 3, 'U': 6, 'V': 3, 'W': 3, 'X': 3}"
INV-ZZ-2599509,SCH-ZZ-5335207,ZZ,ZZ20240505BOMHYD2933.0,2933.0,Boeing 757,05/05/2024,2024-05-05 14:57:00,2024-05-05 20:14:00,BOM,HYD,209.0,237,121,-88,116,20,41,62,83,24,12,8,12,49,25,16,24,73,37,25,36,91,46,37,45,"{'F': 12, 'P': 8}","{'C': 16, 'J': 12, 'Z': 12}","{'Q': 19, 'R': 12, 'S': 6, 'T': 6, 'H': 12, 'M': 6}","{'Y': 6, 'A': 6, 'B': 3, 'D': 3, 'E': 3, 'G': 6, 'I': 3, 'K': 6, 'L': 3, 'N': 3, 'O': 3, 'U': 6, 'V': 3, 'W': 3, 'X': 3}"
INV-ZZ-6927181,SCH-ZZ-5335207,ZZ,ZZ20240507BOMHYD2933.0,2933.0,Boeing 757,05/07/2024,2024-05-07 14:57:00,2024-05-07 20:14:00,BOM,HYD,209.0,230,117,-92,113,20,41,62,83,23,12,8,11,47,24,17,23,68,35,27,33,95,48,35,47,"{'F': 12, 'P': 8}","{'C': 16, 'J': 12, 'Z': 12}","{'Q': 19, 'R': 12, 'S': 6, 'T': 6, 'H': 12, 'M': 6}","{'Y': 6, 'A': 6, 'B': 3, 'D': 3, 'E': 3, 'G': 6, 'I': 3, 'K': 6, 'L': 3, 'N': 3, 'O': 3, 'U': 6, 'V': 3, 'W': 3, 'X': 3}"
INV-ZZ-8017688,SCH-ZZ-5335207,ZZ,ZZ20240509BOMHYD2933.0,2933.0,Boeing 757,05/09/2024,2024-05-09 14:57:00,2024-05-09 20:14:00,BOM,HYD,209.0,247,138,-71,109,20,41,62,83,23,13,7,10,49,27,14,22,73,41,21,32,93,52,31,41,"{'F': 12, 'P': 8}","{'C': 16, 'J': 12, 'Z': 12}","{'Q': 19, 'R': 12, 'S': 6, 'T': 6, 'H': 12, 'M': 6}","{'Y': 6, 'A': 6, 'B': 3, 'D': 3, 'E': 3, 'G': 6, 'I': 3, 'K': 6, 'L': 3, 'N': 3, 'O': 3, 'U': 6, 'V': 3, 'W': 3, 'X': 3}"
INV-ZZ-6314061,SCH-ZZ-5335207,ZZ,ZZ20240510BOMHYD2933.0,2933.0,Boeing 757,05/10/2024,2024-05-10 14:57:00,2024-05-10 20:14:00,BOM,HYD,209.0,241,135,-74,106,20,41,62,83,22,12,8,10,47,26,15,21,69,39,23,30,99,56,27,43,"{'F': 12, 'P': 8}","{'C': 16, 'J': 12, 'Z': 12}","{'Q': 19, 'R': 12, 'S': 6, 'T': 6, 'H': 12, 'M': 6}","{'Y': 6, 'A': 6, 'B': 3, 'D': 3, 'E': 3, 'G': 6, 'I': 3, 'K': 6, 'L': 3, 'N': 3, 'O': 3, 'U': 6, 'V': 3, 'W': 3, 'X': 3}"
INV-ZZ-6113522,SCH-ZZ-5335207,ZZ,ZZ20240511BOMHYD2933.0,2933.0,Boeing 757,05/11/2024,2024-05-11 14:57:00,2024-05-11 20:14:00,BOM,HYD,209.0,241,125,-84,116,20,41,62,83,24,12,8,12,47,24,17,23,69,36,26,33,95,49,34,46,"{'F': 12, 'P': 8}","{'C': 16, 'J': 12, 'Z': 12}","{'Q': 19, 'R': 12, 'S': 6, 'T': 6, 'H': 12, 'M': 6}","{'Y': 6, 'A': 6, 'B': 3, 'D': 3, 'E': 3, 'G': 6, 'I': 3, 'K': 6, 'L': 3, 'N': 3, 'O': 3, 'U': 6, 'V': 3, 'W': 3, 'X': 3}"
INV-ZZ-6535986,SCH-ZZ-5335207,ZZ,ZZ20240512BOMHYD2933.0,2933.0,Boeing 757,05/12/2024,2024-05-12 14:57:00,2024-05-12 20:14:00,BOM,HYD,209.0,250,128,-81,122,20,41,62,83,24,12,8,12,48,25,16,23,70,36,26,34,97,50,33,47,"{'F': 12, 'P': 8}","{'C': 16, 'J': 12, 'Z': 12}","{'Q': 19, 'R': 12, 'S': 6, 'T': 6, 'H': 12, 'M': 6}","{'Y': 6, 'A': 6, 'B': 3, 'D': 3, 'E': 3, 'G': 6, 'I': 3, 'K': 6, 'L': 3, 'N': 3, 'O': 3, 'U': 6, 'V': 3, 'W': 3, 'X': 3}"
INV-ZZ-3036903,SCH-ZZ-5335207,ZZ,ZZ20240514BOMHYD2933.0,2933.0,Boeing 757,05/14/2024,2024-05-14 14:57:00,2024-05-14 20:14:00,BOM,HYD,209.0,249,126,-83,123,20,41,62,83,23,12,8,11,46,23,18,23,73,37,25,36,96,49,34,47,"{'F': 12, 'P': 8}","{'C': 16, 'J': 12, 'Z': 12}","{'Q': 19, 'R': 12, 'S': 6, 'T': 6, 'H': 12, 'M': 6}","{'Y': 6, 'A': 6, 'B': 3, 'D': 3, 'E': 3, 'G': 6, 'I': 3, 'K': 6, 'L': 3, 'N': 3, 'O': 3, 'U': 6, 'V': 3, 'W': 3, 'X': 3}"
INV-ZZ-7853910,SCH-ZZ-5335207,ZZ,ZZ20240516BOMHYD2933.0,2933.0,Boeing 757,05/16/2024,2024-05-16 14:57:00,2024-05-16 20:14:00,BOM,HYD,209.0,239,128,-81,111,20,41,62,83,23,12,8,11,48,26,15,22,72,39,23,33,96,52,31,44,"{'F': 12, 'P': 8}","{'C': 16, 'J': 12, 'Z': 12}","{'Q': 19, 'R': 12, 'S': 6, 'T': 6, 'H': 12, 'M': 6}","{'Y': 6, 'A': 6, 'B': 3, 'D': 3, 'E': 3, 'G': 6, 'I': 3, 'K': 6, 'L': 3, 'N': 3, 'O': 3, 'U': 6, 'V': 3, 'W': 3, 'X': 3}"
INV-ZZ-9635102,SCH-ZZ-5335207,ZZ,ZZ20240517BOMHYD2933.0,2933.0,Boeing 757,05/17/2024,2024-05-17 14:57:00,2024-05-17 20:14:00,BOM,HYD,209.0,230,125,-84,105,20,41,62,83,23,13,7,10,48,26,15,22,73,40,22,33,95,52,31,43,"{'F': 12, 'P': 8}","{'C': 16, 'J': 12, 'Z': 12}","{'Q': 19, 'R': 12, 'S': 6, 'T': 6, 'H': 12, 'M': 6}","{'Y': 6, 'A': 6, 'B': 3, 'D': 3, 'E': 3, 'G': 6, 'I': 3, 'K': 6, 'L': 3, 'N': 3, 'O': 3, 'U': 6, 'V': 3, 'W': 3, 'X': 3}"
INV-ZZ-9220750,SCH-ZZ-5335207,ZZ,ZZ20240518BOMHYD2933.0,2933.0,Boeing 757,05/18/2024,2024-05-18 14:57:00,2024-05-18 20:14:00,BOM,HYD,209.0,243,118,-91,125,20,41,62,83,23,11,9,12,47,23,18,24,69,33,29,36,95,46,37,49,"{'F': 12, 'P': 8}","{'C': 16, 'J': 12, 'Z': 12}","{'Q': 19, 'R': 12, 'S': 6, 'T': 6, 'H': 12, 'M': 6}","{'Y': 6, 'A': 6, 'B': 3, 'D': 3, 'E': 3, 'G': 6, 'I': 3, 'K': 6, 'L': 3, 'N': 3, 'O': 3, 'U': 6, 'V': 3, 'W': 3, 'X': 3}"
INV-ZZ-4891596,SCH-ZZ-5335207,ZZ,ZZ20240519BOMHYD2933.0,2933.0,Boeing 757,05/19/2024,2024-05-19 14:57:00,2024-05-19 20:14:00,BOM,HYD,209.0,239,114,-95,125,20,41,62,83,23,11,9,12,45,21,20,24,73,35,27,38,93,44,39,49,"{'F': 12, 'P': 8}","{'C': 16, 'J': 12, 'Z': 12}","{'Q': 19, 'R': 12, 'S': 6, 'T': 6, 'H': 12, 'M': 6}","{'Y': 6, 'A': 6, 'B': 3, 'D': 3, 'E': 3, 'G': 6, 'I': 3, 'K': 6, 'L': 3, 'N': 3, 'O': 3, 'U': 6, 'V': 3, 'W': 3, 'X': 3}"
INV-ZZ-9199013,SCH-ZZ-5335207,ZZ,ZZ20240521BOMHYD2933.0,2933.0,Boeing 757,05/21/2024,2024-05-21 14:57:00,2024-05-21 20:14:00,BOM,HYD,209.0,230,123,-86,107,20,41,62,83,23,12,8,11,46,25,16,21,69,37,25,32,95,51,32,44,"{'F': 12, 'P': 8}","{'C': 16, 'J': 12, 'Z': 12}","{'Q': 19, 'R': 12, 'S': 6, 'T': 6, 'H': 12, 'M': 6}","{'Y': 6, 'A': 6, 'B': 3, 'D': 3, 'E': 3, 'G': 6, 'I': 3, 'K': 6, 'L': 3, 'N': 3, 'O': 3, 'U': 6, 'V': 3, 'W': 3, 'X': 3}"
INV-ZZ-2239958,SCH-ZZ-5335207,ZZ,ZZ20240523BOMHYD2933.0,2933.0,Boeing 757,05/23/2024,2024-05-23 14:57:00,2024-05-23 20:14:00,BOM,HYD,209.0,243,119,-90,124,20,41,62,83,23,11,9,12,46,23,18,23,71,35,27,36,92,45,38,47,"{'F': 12, 'P': 8}","{'C': 16, 'J': 12, 'Z': 12}","{'Q': 19, 'R': 12, 'S': 6, 'T': 6, 'H': 12, 'M': 6}","{'Y': 6, 'A': 6, 'B': 3, 'D': 3, 'E': 3, 'G': 6, 'I': 3, 'K': 6, 'L': 3, 'N': 3, 'O': 3, 'U': 6, 'V': 3, 'W': 3, 'X': 3}"
INV-ZZ-6261436,SCH-ZZ-5335207,ZZ,ZZ20240524BOMHYD2933.0,2933.0,Boeing 757,05/24/2024,2024-05-24 14:57:00,2024-05-24 20:14:00,BOM,HYD,209.0,232,112,-97,120,20,41,62,83,23,11,9,12,47,23,18,24,71,34,28,37,96,46,37,50,"{'F': 12, 'P': 8}","{'C': 16, 'J': 12, 'Z': 12}","{'Q': 19, 'R': 12, 'S': 6, 'T': 6, 'H': 12, 'M': 6}","{'Y': 6, 'A': 6, 'B': 3, 'D': 3, 'E': 3, 'G': 6, 'I': 3, 'K': 6, 'L': 3, 'N': 3, 'O': 3, 'U': 6, 'V': 3, 'W': 3, 'X': 3}"
INV-ZZ-5661044,SCH-ZZ-5335207,ZZ,ZZ20240525BOMHYD2933.0,2933.0,Boeing 757,05/25/2024,2024-05-25 14:57:00,2024-05-25 20:14:00,BOM,HYD,209.0,234,113,-96,121,20,41,62,83,22,11,9,11,49,24,17,25,72,35,27,37,97,47,36,50,"{'F': 12, 'P': 8}","{'C': 16, 'J': 12, 'Z': 12}","{'Q': 19, 'R': 12, 'S': 6, 'T': 6, 'H': 12, 'M': 6}","{'Y': 6, 'A': 6, 'B': 3, 'D': 3, 'E': 3, 'G': 6, 'I': 3, 'K': 6, 'L': 3, 'N': 3, 'O': 3, 'U': 6, 'V': 3, 'W': 3, 'X': 3}"
INV-ZZ-6316176,SCH-ZZ-5335207,ZZ,ZZ20240526BOMHYD2933.0,2933.0,Boeing 757,05/26/2024,2024-05-26 14:57:00,2024-05-26 20:14:00,BOM,HYD,209.0,232,109,-100,123,20,41,62,83,22,10,10,12,46,22,19,24,73,34,28,39,95,45,38,50,"{'F': 12, 'P': 8}","{'C': 16, 'J': 12, 'Z': 12}","{'Q': 19, 'R': 12, 'S': 6, 'T': 6, 'H': 12, 'M': 6}","{'Y': 6, 'A': 6, 'B': 3, 'D': 3, 'E': 3, 'G': 6, 'I': 3, 'K': 6, 'L': 3, 'N': 3, 'O': 3, 'U': 6, 'V': 3, 'W': 3, 'X': 3}"
INV-ZZ-6409985,SCH-ZZ-5335207,ZZ,ZZ20240528BOMHYD2933.0,2933.0,Boeing 757,05/28/2024,2024-05-28 14:57:00,2024-05-28 20:14:00,BOM,HYD,209.0,232,112,-97,120,20,41,62,83,22,11,9,11,47,23,18,24,70,34,28,36,98,47,36,51,"{'F': 12, 'P': 8}","{'C': 16, 'J': 12, 'Z': 12}","{'Q': 19, 'R': 12, 'S': 6, 'T': 6, 'H': 12, 'M': 6}","{'Y': 6, 'A': 6, 'B': 3, 'D': 3, 'E': 3, 'G': 6, 'I': 3, 'K': 6, 'L': 3, 'N': 3, 'O': 3, 'U': 6, 'V': 3, 'W': 3, 'X': 3}"
INV-ZZ-1722642,SCH-ZZ-5335207,ZZ,ZZ20240530BOMHYD2933.0,2933.0,Boeing 757,05/30/2024,2024-05-30 14:57:00,2024-05-30 20:14:00,BOM,HYD,209.0,243,123,-86,120,20,41,62,83,23,12,8,11,49,25,16,24,69,35,27,34,92,47,36,45,"{'F': 12, 'P': 8}","{'C': 16, 'J': 12, 'Z': 12}","{'Q': 19, 'R': 12, 'S': 6, 'T': 6, 'H': 12, 'M': 6}","{'Y': 6, 'A': 6, 'B': 3, 'D': 3, 'E': 3, 'G': 6, 'I': 3, 'K': 6, 'L': 3, 'N': 3, 'O': 3, 'U': 6, 'V': 3, 'W': 3, 'X': 3}"
INV-ZZ-1093504,SCH-ZZ-5335207,ZZ,ZZ20240531BOMHYD2933.0,2933.0,Boeing 757,05/31/2024,2024-05-31 14:57:00,2024-05-31 20:14:00,BOM,HYD,209.0,242,121,-88,121,20,41,62,83,24,12,8,12,49,24,17,25,68,34,28,34,99,49,34,50,"{'F': 12, 'P': 8}","{'C': 16, 'J': 12, 'Z': 12}","{'Q': 19, 'R': 12, 'S': 6, 'T': 6, 'H': 12, 'M': 6}","{'Y': 6, 'A': 6, 'B': 3, 'D': 3, 'E': 3, 'G': 6, 'I': 3, 'K': 6, 'L': 3, 'N': 3, 'O': 3, 'U': 6, 'V': 3, 'W': 3, 'X': 3}"
INV-ZZ-9844695,SCH-ZZ-5335207,ZZ,ZZ20240601BOMHYD2933.0,2933.0,Boeing 757,06/01/2024,2024-06-01 14:57:00,2024-06-01 20:14:00,BOM,HYD,209.0,231,114,-95,117,20,41,62,83,22,11,9,11,48,24,17,24,73,36,26,37,98,48,35,50,"{'F': 12, 'P': 8}","{'C': 16, 'J': 12, 'Z': 12}","{'Q': 19, 'R': 12, 'S': 6, 'T': 6, 'H': 12, 'M': 6}","{'Y': 6, 'A': 6, 'B': 3, 'D': 3, 'E': 3, 'G': 6, 'I': 3, 'K': 6, 'L': 3, 'N': 3, 'O': 3, 'U': 6, 'V': 3, 'W': 3, 'X': 3}"
INV-ZZ-8663798,SCH-ZZ-5335207,ZZ,ZZ20240602BOMHYD2933.0,2933.0,Boeing 757,06/02/2024,2024-06-02 14:57:00,2024-06-02 20:14:00,BOM,HYD,209.0,245,121,-88,124,20,41,62,83,23,11,9,12,48,24,17,24,70,34,28,36,94,46,37,48,"{'F': 12, 'P': 8}","{'C': 16, 'J': 12, 'Z': 12}","{'Q': 19, 'R': 12, 'S': 6, 'T': 6, 'H': 12, 'M': 6}","{'Y': 6, 'A': 6, 'B': 3, 'D': 3, 'E': 3, 'G': 6, 'I': 3, 'K': 6, 'L': 3, 'N': 3, 'O': 3, 'U': 6, 'V': 3, 'W': 3, 'X': 3}"
INV-ZZ-7410473,SCH-ZZ-5335207,ZZ,ZZ20240604BOMHYD2933.0,2933.0,Boeing 757,06/04/2024,2024-06-04 14:57:00,2024-06-04 20:14:00,BOM,HYD,209.0,245,123,-86,122,20,41,62,83,23,12,8,11,49,25,16,24,72,36,26,36,94,47,36,47,"{'F': 12, 'P': 8}","{'C': 16, 'J': 12, 'Z': 12}","{'Q': 19, 'R': 12, 'S': 6, 'T': 6, 'H': 12, 'M': 6}","{'Y': 6, 'A': 6, 'B': 3, 'D': 3, 'E': 3, 'G': 6, 'I': 3, 'K': 6, 'L': 3, 'N': 3, 'O': 3, 'U': 6, 'V': 3, 'W': 3, 'X': 3}"
INV-ZZ-7921445,SCH-ZZ-5335207,ZZ,ZZ20240606BOMHYD2933.0,2933.0,Boeing 757,06/06/2024,2024-06-06 14:57:00,2024-06-06 20:14:00,BOM,HYD,209.0,244,107,-102,137,20,41,62,83,22,10,10,12,46,20,21,26,72,32,30,40,96,42,41,54,"{'F': 12, 'P': 8}","{'C': 16, 'J': 12, 'Z': 12}","{'Q': 19, 'R': 12, 'S': 6, 'T': 6, 'H': 12, 'M': 6}","{'Y': 6, 'A': 6, 'B': 3, 'D': 3, 'E': 3, 'G': 6, 'I': 3, 'K': 6, 'L': 3, 'N': 3, 'O': 3, 'U': 6, 'V': 3, 'W': 3, 'X': 3}"
INV-ZZ-3877329,SCH-ZZ-5335207,ZZ,ZZ20240607BOMHYD2933.0,2933.0,Boeing 757,06/07/2024,2024-06-07 14:57:00,2024-06-07 20:14:00,BOM,HYD,209.0,234,102,-107,132,20,41,62,83,24,10,10,14,48,21,20,27,73,32,30,41,95,41,42,54,"{'F': 12, 'P': 8}","{'C': 16, 'J': 12, 'Z': 12}","{'Q': 19, 'R': 12, 'S': 6, 'T': 6, 'H': 12, 'M': 6}","{'Y': 6, 'A': 6, 'B': 3, 'D': 3, 'E': 3, 'G': 6, 'I': 3, 'K': 6, 'L': 3, 'N': 3, 'O': 3, 'U': 6, 'V': 3, 'W': 3, 'X': 3}"
INV-ZZ-6273625,SCH-ZZ-5335207,ZZ,ZZ20240608BOMHYD2933.0,2933.0,Boeing 757,06/08/2024,2024-06-08 14:57:00,2024-06-08 20:14:00,BOM,HYD,209.0,232,108,-101,124,20,41,62,83,22,10,10,12,48,22,19,26,69,32,30,37,98,46,37,52,"{'F': 12, 'P': 8}","{'C': 16, 'J': 12, 'Z': 12}","{'Q': 19, 'R': 12, 'S': 6, 'T': 6, 'H': 12, 'M': 6}","{'Y': 6, 'A': 6, 'B': 3, 'D': 3, 'E': 3, 'G': 6, 'I': 3, 'K': 6, 'L': 3, 'N': 3, 'O': 3, 'U': 6, 'V': 3, 'W': 3, 'X': 3}"
INV-ZZ-4382003,SCH-ZZ-5335207,ZZ,ZZ20240609BOMHYD2933.0,2933.0,Boeing 757,06/09/2024,2024-06-09 14:57:00,2024-06-09 20:14:00,BOM,HYD,209.0,240,105,-104,135,20,41,62,83,23,10,10,13,49,21,20,28,73,32,30,41,97,43,40,54,"{'F': 12, 'P': 8}","{'C': 16, 'J': 12, 'Z': 12}","{'Q': 19, 'R': 12, 'S': 6, 'T': 6, 'H': 12, 'M': 6}","{'Y': 6, 'A': 6, 'B': 3, 'D': 3, 'E': 3, 'G': 6, 'I': 3, 'K': 6, 'L': 3, 'N': 3, 'O': 3, 'U': 6, 'V': 3, 'W': 3, 'X': 3}"
INV-ZZ-5338701,SCH-ZZ-5335207,ZZ,ZZ20240611BOMHYD2933.0,2933.0,Boeing 757,06/11/2024,2024-06-11 14:57:00,2024-06-11 20:14:00,BOM,HYD,209.0,238,104,-105,134,20,41,62,83,23,10,10,13,47,20,21,27,72,31,31,41,96,42,41,54,"{'F': 12, 'P': 8}","{'C': 16, 'J': 12, 'Z': 12}","{'Q': 19, 'R': 12, 'S': 6, 'T': 6, 'H': 12, 'M': 6}","{'Y': 6, 'A': 6, 'B': 3, 'D': 3, 'E': 3, 'G': 6, 'I': 3, 'K': 6, 'L': 3, 'N': 3, 'O': 3, 'U': 6, 'V': 3, 'W': 3, 'X': 3}"
INV-ZZ-3740130,SCH-ZZ-5335207,ZZ,ZZ20240613BOMHYD2933.0,2933.0,Boeing 757,06/13/2024,2024-06-13 14:57:00,2024-06-13 20:14:00,BOM,HYD,209.0,241,102,-107,139,20,41,62,83,22,9,11,13,47,20,21,27,72,31,31,41,94,40,43,54,"{'F': 12, 'P': 8}","{'C': 16, 'J': 12, 'Z': 12}","{'Q': 19, 'R': 12, 'S': 6, 'T': 6, 'H': 12, 'M': 6}","{'Y': 6, 'A': 6, 'B': 3, 'D': 3, 'E': 3, 'G': 6, 'I': 3, 'K': 6, 'L': 3, 'N': 3, 'O': 3, 'U': 6, 'V': 3, 'W': 3, 'X': 3}"
INV-ZZ-6869206,SCH-ZZ-5335207,ZZ,ZZ20240614BOMHYD2933.0,2933.0,Boeing 757,06/14/2024,2024-06-14 14:57:00,2024-06-14 20:14:00,BOM,HYD,209.0,236,110,-99,126,20,41,62,83,24,11,9,13,48,22,19,26,71,33,29,38,94,44,39,50,"{'F': 12, 'P': 8}","{'C': 16, 'J': 12, 'Z': 12}","{'Q': 19, 'R': 12, 'S': 6, 'T': 6, 'H': 12, 'M': 6}","{'Y': 6, 'A': 6, 'B': 3, 'D': 3, 'E': 3, 'G': 6, 'I': 3, 'K': 6, 'L': 3, 'N': 3, 'O': 3, 'U': 6, 'V': 3, 'W': 3, 'X': 3}"
INV-ZZ-1032048,SCH-ZZ-5335207,ZZ,ZZ20240615BOMHYD2933.0,2933.0,Boeing 757,06/15/2024,2024-06-15 14:57:00,2024-06-15 20:14:00,BOM,HYD,209.0,244,112,-97,132,20,41,62,83,24,11,9,13,46,21,20,25,72,33,29,39,96,44,39,52,"{'F': 12, 'P': 8}","{'C': 16, 'J': 12, 'Z': 12}","{'Q': 19, 'R': 12, 'S': 6, 'T': 6, 'H': 12, 'M': 6}","{'Y': 6, 'A': 6, 'B': 3, 'D': 3, 'E': 3, 'G': 6, 'I': 3, 'K': 6, 'L': 3, 'N': 3, 'O': 3, 'U': 6, 'V': 3, 'W': 3, 'X': 3}"
INV-ZZ-9534006,SCH-ZZ-5335207,ZZ,ZZ20240616BOMHYD2933.0,2933.0,Boeing 757,06/16/2024,2024-06-16 14:57:00,2024-06-16 20:14:00,BOM,HYD,209.0,243,100,-108,142,20,41,62,83,24,10,10,14,49,20,21,29,72,30,32,42,97,40,43,57,"{'F': 12, 'P': 8}","{'C': 16, 'J': 12, 'Z': 12}","{'Q': 19, 'R': 12, 'S': 6, 'T': 6, 'H': 12, 'M': 6}","{'Y': 6, 'A': 6, 'B': 3, 'D': 3, 'E': 3, 'G': 6, 'I': 3, 'K': 6, 'L': 3, 'N': 3, 'O': 3, 'U': 6, 'V': 3, 'W': 3, 'X': 3}"
INV-ZZ-1586845,SCH-ZZ-6980436,ZZ,ZZ20240410BOMBLR3556.0,3556.0,Boeing 777,04/10/2024,2024-04-10 22:10:00,2024-04-11 05:46:00,BOM,BLR,425.0,472,296,-129,176,42,85,127,170,50,31,11,19,95,59,26,36,145,91,36,54,192,120,50,72,"{'F': 25, 'P': 17}","{'C': 34, 'J': 26, 'Z': 26}","{'Q': 38, 'R': 25, 'S': 13, 'T': 13, 'H': 25, 'M': 13}","{'Y': 13, 'A': 13, 'B': 6, 'D': 6, 'E': 6, 'G': 13, 'I': 6, 'K': 13, 'L': 6, 'N': 6, 'O': 6, 'U': 13, 'V': 6, 'W': 6, 'X': 6}"
INV-ZZ-5354827,SCH-ZZ-6980436,ZZ,ZZ20240412BOMBLR3556.0,3556.0,Boeing 777,04/12/2024,2024-04-12 22:10:00,2024-04-13 05:46:00,BOM,BLR,425.0,498,318,-107,180,42,85,127,170,50,32,10,18,95,61,24,34,144,92,35,52,204,130,40,74,"{'F': 25, 'P': 17}","{'C': 34, 'J': 26, 'Z': 26}","{'Q': 38, 'R': 25, 'S': 13, 'T': 13, 'H': 25, 'M': 13}","{'Y': 13, 'A': 13, 'B': 6, 'D': 6, 'E': 6, 'G': 13, 'I': 6, 'K': 13, 'L': 6, 'N': 6, 'O': 6, 'U': 13, 'V': 6, 'W': 6, 'X': 6}"
INV-ZZ-9842230,SCH-ZZ-6980436,ZZ,ZZ20240415BOMBLR3556.0,3556.0,Boeing 777,04/15/2024,2024-04-15 22:10:00,2024-04-16 05:46:00,BOM,BLR,425.0,480,275,-150,205,42,85,127,170,47,27,15,20,96,55,30,41,145,83,44,62,193,110,60,83,"{'F': 25, 'P': 17}","{'C': 34, 'J': 26, 'Z': 26}","{'Q': 38, 'R': 25, 'S': 13, 'T': 13, 'H': 25, 'M': 13}","{'Y': 13, 'A': 13, 'B': 6, 'D': 6, 'E': 6, 'G': 13, 'I': 6, 'K': 13, 'L': 6, 'N': 6, 'O': 6, 'U': 13, 'V': 6, 'W': 6, 'X': 6}"
INV-ZZ-1494424,SCH-ZZ-6980436,ZZ,ZZ20240416BOMBLR3556.0,3556.0,Boeing 777,04/16/2024,2024-04-16 22:10:00,2024-04-17 05:46:00,BOM,BLR,425.0,476,288,-137,188,42,85,127,170,47,28,14,19,97,59,26,38,149,90,37,59,190,115,55,75,"{'F': 25, 'P': 17}","{'C': 34, 'J': 26, 'Z': 26}","{'Q': 38, 'R': 25, 'S': 13, 'T': 13, 'H': 25, 'M': 13}","{'Y': 13, 'A': 13, 'B': 6, 'D': 6, 'E': 6, 'G': 13, 'I': 6, 'K': 13, 'L': 6, 'N': 6, 'O': 6, 'U': 13, 'V': 6, 'W': 6, 'X': 6}"
INV-ZZ-7208280,SCH-ZZ-6980436,ZZ,ZZ20240417BOMBLR3556.0,3556.0,Boeing 777,04/17/2024,2024-04-17 22:10:00,2024-04-18 05:46:00,BOM,BLR,425.0,486,269,-156,217,42,85,127,170,48,27,15,21,96,53,32,43,144,80,47,64,200,111,59,89,"{'F': 25, 'P': 17}","{'C': 34, 'J': 26, 'Z': 26}","{'Q': 38, 'R': 25, 'S': 13, 'T': 13, 'H': 25, 'M': 13}","{'Y': 13, 'A': 13, 'B': 6, 'D': 6, 'E': 6, 'G': 13, 'I': 6, 'K': 13, 'L': 6, 'N': 6, 'O': 6, 'U': 13, 'V': 6, 'W': 6, 'X': 6}"
INV-ZZ-2324946,SCH-ZZ-6980436,ZZ,ZZ20240419BOMBLR3556.0,3556.0,Boeing 777,04/19/2024,2024-04-19 22:10:00,2024-04-20 05:46:00,BOM,BLR,425.0,505,312,-113,193,42,85,127,170,47,29,13,18,101,62,23,39,142,88,39,54,201,124,46,77,"{'F': 25, 'P': 17}","{'C': 34, 'J': 26, 'Z': 26}","{'Q': 38, 'R': 25, 'S': 13, 'T': 13, 'H': 25, 'M': 13}","{'Y': 13, 'A': 13, 'B': 6, 'D': 6, 'E': 6, 'G': 13, 'I': 6, 'K': 13, 'L': 6, 'N': 6, 'O': 6, 'U': 13, 'V': 6, 'W': 6, 'X': 6}"
INV-ZZ-7705578,SCH-ZZ-6980436,ZZ,ZZ20240422BOMBLR3556.0,3556.0,Boeing 777,04/22/2024,2024-04-22 22:10:00,2024-04-23 05:46:00,BOM,BLR,425.0,476,280,-145,196,42,85,127,170,49,29,13,20,101,59,26,42,144,85,42,59,196,115,55,81,"{'F': 25, 'P': 17}","{'C': 34, 'J': 26, 'Z': 26}","{'Q': 38, 'R': 25, 'S': 13, 'T': 13, 'H': 25, 'M': 13}","{'Y': 13, 'A': 13, 'B': 6, 'D': 6, 'E': 6, 'G': 13, 'I': 6, 'K': 13, 'L': 6, 'N': 6, 'O': 6, 'U': 13, 'V': 6, 'W': 6, 'X': 6}"
INV-ZZ-3227855,SCH-ZZ-6980436,ZZ,ZZ20240423BOMBLR3556.0,3556.0,Boeing 777,04/23/2024,2024-04-23 22:10:00,2024-04-24 05:46:00,BOM,BLR,425.0,504,312,-113,192,42,85,127,170,48,30,12,18,94,58,27,36,144,89,38,55,201,124,46,77,"{'F': 25, 'P': 17}","{'C': 34, 'J': 26, 'Z': 26}","{'Q': 38, 'R': 25, 'S': 13, 'T': 13, 'H': 25, 'M': 13}","{'Y': 13, 'A': 13, 'B': 6, 'D': 6, 'E': 6, 'G': 13, 'I': 6, 'K': 13, 'L': 6, 'N': 6, 'O': 6, 'U': 13, 'V': 6, 'W': 6, 'X': 6}"
INV-ZZ-1015666,SCH-ZZ-6980436,ZZ,ZZ20240424BOMBLR3556.0,3556.0,Boeing 777,04/24/2024,2024-04-24 22:10:00,2024-04-25 05:46:00,BOM,BLR,425.0,496,296,-129,200,42,85,127,170,48,29,13,19,101,60,25,41,147,88,39,59,189,113,57,76,"{'F': 25, 'P': 17}","{'C': 34, 'J': 26, 'Z': 26}","{'Q': 38, 'R': 25, 'S': 13, 'T': 13, 'H': 25, 'M': 13}","{'Y': 13, 'A': 13, 'B': 6, 'D': 6, 'E': 6, 'G': 13, 'I': 6, 'K': 13, 'L': 6, 'N': 6, 'O': 6, 'U': 13, 'V': 6, 'W': 6, 'X': 6}"
INV-ZZ-8167979,SCH-ZZ-6980436,ZZ,ZZ20240426BOMBLR3556.0,3556.0,Boeing 777,04/26/2024,2024-04-26 22:10:00,2024-04-27 05:46:00,BOM,BLR,425.0,478,282,-143,196,42,85,127,170,50,29,13,21,99,58,27,41,143,84,43,59,202,119,51,83,"{'F': 25, 'P': 17}","{'C': 34, 'J': 26, 'Z': 26}","{'Q': 38, 'R': 25, 'S': 13, 'T': 13, 'H': 25, 'M': 13}","{'Y': 13, 'A': 13, 'B': 6, 'D': 6, 'E': 6, 'G': 13, 'I': 6, 'K': 13, 'L': 6, 'N': 6, 'O': 6, 'U': 13, 'V': 6, 'W': 6, 'X': 6}"
INV-ZZ-1310810,SCH-ZZ-6980436,ZZ,ZZ20240429BOMBLR3556.0,3556.0,Boeing 777,04/29/2024,2024-04-29 22:10:00,2024-04-30 05:46:00,BOM,BLR,425.0,469,257,-168,212,42,85,127,170,47,26,16,21,102,56,29,46,141,77,50,64,200,110,60,90,"{'F': 25, 'P': 17}","{'C': 34, 'J': 26, 'Z': 26}","{'Q': 38, 'R': 25, 'S': 13, 'T': 13, 'H': 25, 'M': 13}","{'Y': 13, 'A': 13, 'B': 6, 'D': 6, 'E': 6, 'G': 13, 'I': 6, 'K': 13, 'L': 6, 'N': 6, 'O': 6, 'U': 13, 'V': 6, 'W': 6, 'X': 6}"
INV-ZZ-4206355,SCH-ZZ-6980436,ZZ,ZZ20240430BOMBLR3556.0,3556.0,Boeing 777,04/30/2024,2024-04-30 22:10:00,2024-05-01 05:46:00,BOM,BLR,425.0,468,248,-177,220,42,85,127,170,50,26,16,24,101,54,31,47,141,75,52,66,190,101,69,89,"{'F': 25, 'P': 17}","{'C': 34, 'J': 26, 'Z': 26}","{'Q': 38, 'R': 25, 'S': 13, 'T': 13, 'H': 25, 'M': 13}","{'Y': 13, 'A': 13, 'B': 6, 'D': 6, 'E': 6, 'G': 13, 'I': 6, 'K': 13, 'L': 6, 'N': 6, 'O': 6, 'U': 13, 'V': 6, 'W': 6, 'X': 6}"
INV-ZZ-2483256,SCH-ZZ-6980436,ZZ,ZZ20240501BOMBLR3556.0,3556.0,Boeing 777,05/01/2024,2024-05-01 22:10:00,2024-05-02 05:46:00,BOM,BLR,425.0,486,277,-148,209,42,85,127,170,47,27,15,20,97,55,30,42,147,84,43,63,192,110,60,82,"{'F': 25, 'P': 17}","{'C': 34, 'J': 26, 'Z': 26}","{'Q': 38, 'R': 25, 'S': 13, 'T': 13, 'H': 25, 'M': 13}","{'Y': 13, 'A': 13, 'B': 6, 'D': 6, 'E': 6, 'G': 13, 'I': 6, 'K': 13, 'L': 6, 'N': 6, 'O': 6, 'U': 13, 'V': 6, 'W': 6, 'X': 6}"
INV-ZZ-2612668,SCH-ZZ-6980436,ZZ,ZZ20240503BOMBLR3556.0,3556.0,Boeing 777,05/03/2024,2024-05-03 22:10:00,2024-05-04 05:46:00,BOM,BLR,425.0,468,246,-179,222,42,85,127,170,50,26,16,24,94,49,36,45,146,77,50,69,193,101,69,92,"{'F': 25, 'P': 17}","{'C': 34, 'J': 26, 'Z': 26}","{'Q': 38, 'R': 25, 'S': 13, 'T': 13, 'H': 25, 'M': 13}","{'Y': 13, 'A': 13, 'B': 6, 'D': 6, 'E': 6, 'G': 13, 'I': 6, 'K': 13, 'L': 6, 'N': 6, 'O': 6, 'U': 13, 'V': 6, 'W': 6, 'X': 6}"
INV-ZZ-9999770,SCH-ZZ-6980436,ZZ,ZZ20240506BOMBLR3556.0,3556.0,Boeing 777,05/06/2024,2024-05-06 22:10:00,2024-05-07 05:46:00,BOM,BLR,425.0,483,263,-162,220,42,85,127,170,49,27,15,22,97,53,32,44,144,78,49,66,196,107,63,89,"{'F': 25, 'P': 17}","{'C': 34, 'J': 26, 'Z': 26}","{'Q': 38, 'R': 25, 'S': 13, 'T': 13, 'H': 25, 'M': 13}","{'Y': 13, 'A': 13, 'B': 6, 'D': 6, 'E': 6, 'G': 13, 'I': 6, 'K': 13, 'L': 6, 'N': 6, 'O': 6, 'U': 13, 'V': 6, 'W': 6, 'X': 6}"
INV-ZZ-4840854,SCH-ZZ-6980436,ZZ,ZZ20240507BOMBLR3556.0,3556.0,Boeing 777,05/07/2024,2024-05-07 22:10:00,2024-05-08 05:46:00,BOM,BLR,425.0,472,268,-157,204,42,85,127,170,49,28,14,21,102,58,27,44,150,85,42,65,201,114,56,87,"{'F': 25, 'P': 17}","{'C': 34, 'J': 26, 'Z': 26}","{'Q': 38, 'R': 25, 'S': 13, 'T': 13, 'H': 25, 'M': 13}","{'Y': 13, 'A': 13, 'B': 6, 'D': 6, 'E': 6, 'G': 13, 'I': 6, 'K': 13, 'L': 6, 'N': 6, 'O': 6, 'U': 13, 'V': 6, 'W': 6, 'X': 6}"
INV-ZZ-6435937,SCH-ZZ-6980436,ZZ,ZZ20240508BOMBLR3556.0,3556.0,Boeing 777,05/08/2024,2024-05-08 22:10:00,2024-05-09 05:46:00,BOM,BLR,425.0,496,257,-168,239,42,85,127,170,49,25,17,24,94,49,36,45,141,73,54,68,190,99,71,91,"{'F': 25, 'P': 17}","{'C': 34, 'J': 26, 'Z': 26}","{'Q': 38, 'R': 25, 'S': 13, 'T': 13, 'H': 25, 'M': 13}","{'Y': 13, 'A': 13, 'B': 6, 'D': 6, 'E': 6, 'G': 13, 'I': 6, 'K': 13, 'L': 6, 'N': 6, 'O': 6, 'U': 13, 'V': 6, 'W': 6, 'X': 6}"
INV-ZZ-3160106,SCH-ZZ-6980436,ZZ,ZZ20240510BOMBLR3556.0,3556.0,Boeing 777,05/10/2024,2024-05-10 22:10:00,2024-05-11 05:46:00,BOM,BLR,425.0,471,272,-153,199,42,85,127,170,48,28,14,20,97,56,29,41,142,82,45,60,195,113,57,82,"{'F': 25, 'P': 17}","{'C': 34, 'J': 26, 'Z': 26}","{'Q': 38, 'R': 25, 'S': 13, 'T': 13, 'H': 25, 'M': 13}","{'Y': 13, 'A': 13, 'B': 6, 'D': 6, 'E': 6, 'G': 13, 'I': 6, 'K': 13, 'L': 6, 'N': 6, 'O': 6, 'U': 13, 'V': 6, 'W': 6, 'X': 6}"
INV-ZZ-4426006,SCH-ZZ-6980436,ZZ,ZZ20240513BOMBLR3556.0,3556.0,Boeing 777,05/13/2024,2024-05-13 22:10:00,2024-05-14 05:46:00,BOM,BLR,425.0,486,267,-158,219,42,85,127,170,47,26,16,21,98,54,31,44,149,82,45,67,198,109,61,89,"{'F': 25, 'P': 17}","{'C': 34, 'J': 26, 'Z': 26}","{'Q': 38, 'R': 25, 'S': 13, 'T': 13, 'H': 25, 'M': 13}","{'Y': 13, 'A': 13, 'B': 6, 'D': 6, 'E': 6, 'G': 13, 'I': 6, 'K': 13, 'L': 6, 'N': 6, 'O': 6, 'U': 13, 'V': 6, 'W': 6, 'X': 6}"
INV-ZZ-1885309,SCH-ZZ-6980436,ZZ,ZZ20240514BOMBLR3556.0,3556.0,Boeing 777,05/14/2024,2024-05-14 22:10:00,2024-05-15 05:46:00,BOM,BLR,425.0,471,243,-182,228,42,85,127,170,48,25,17,23,97,50,35,47,142,73,54,69,189,97,73,92,"{'F': 25, 'P': 17}","{'C': 34, 'J': 26, 'Z': 26}","{'Q': 38, 'R': 25, 'S': 13, 'T': 13, 'H': 25, 'M': 13}","{'Y': 13, 'A': 13, 'B': 6, 'D': 6, 'E': 6, 'G': 13, 'I': 6, 'K': 13, 'L': 6, 'N': 6, 'O': 6, 'U': 13, 'V': 6, 'W': 6, 'X': 6}"
INV-ZZ-8902924,SCH-ZZ-6980436,ZZ,ZZ20240515BOMBLR3556.0,3556.0,Boeing 777,05/15/2024,2024-05-15 22:10:00,2024-05-16 05:46:00,BOM,BLR,425.0,468,233,-192,235,42,85,127,170,47,23,19,24,97,48,37,49,146,73,54,73,188,94,76,94,"{'F': 25, 'P': 17}","{'C': 34, 'J': 26, 'Z': 26}","{'Q': 38, 'R': 25, 'S': 13, 'T': 13, 'H': 25, 'M': 13}","{'Y': 13, 'A': 13, 'B': 6, 'D': 6, 'E': 6, 'G': 13, 'I': 6, 'K': 13, 'L': 6, 'N': 6, 'O': 6, 'U': 13, 'V': 6, 'W': 6, 'X': 6}"
INV-ZZ-6607383,SCH-ZZ-6980436,ZZ,ZZ20240517BOMBLR3556.0,3556.0,Boeing 777,05/17/2024,2024-05-17 22:10:00,2024-05-18 05:46:00,BOM,BLR,425.0,469,225,-200,244,42,85,127,170,47,23,19,24,96,46,39,50,152,73,54,79,201,96,74,105,"{'F': 25, 'P': 17}","{'C': 34, 'J': 26, 'Z': 26}","{'Q': 38, 'R': 25, 'S': 13, 'T': 13, 'H': 25, 'M': 13}","{'Y': 13, 'A': 13, 'B': 6, 'D': 6, 'E': 6, 'G': 13, 'I': 6, 'K': 13, 'L': 6, 'N': 6, 'O': 6, 'U': 13, 'V': 6, 'W': 6, 'X': 6}"
INV-ZZ-6239853,SCH-ZZ-6980436,ZZ,ZZ20240520BOMBLR3556.0,3556.0,Boeing 777,05/20/2024,2024-05-20 22:10:00,2024-05-21 05:46:00,BOM,BLR,425.0,471,257,-168,214,42,85,127,170,48,26,16,22,97,53,32,44,149,81,46,68,190,104,66,86,"{'F': 25, 'P': 17}","{'C': 34, 'J': 26, 'Z': 26}","{'Q': 38, 'R': 25, 'S': 13, 'T': 13, 'H': 25, 'M': 13}","{'Y': 13, 'A': 13, 'B': 6, 'D': 6, 'E': 6, 'G': 13, 'I': 6, 'K': 13, 'L': 6, 'N': 6, 'O': 6, 'U': 13, 'V': 6, 'W': 6, 'X': 6}"
INV-ZZ-1441184,SCH-ZZ-6980436,ZZ,ZZ20240521BOMBLR3556.0,3556.0,Boeing 777,05/21/2024,2024-05-21 22:10:00,2024-05-22 05:46:00,BOM,BLR,425.0,495,268,-157,227,42,85,127,170,50,27,15,23,101,55,30,46,145,78,49,67,192,104,66,88,"{'F': 25, 'P': 17}","{'C': 34, 'J': 26, 'Z': 26}","{'Q': 38, 'R': 25, 'S': 13, 'T': 13, 'H': 25, 'M': 13}","{'Y': 13, 'A': 13, 'B': 6, 'D': 6, 'E': 6, 'G': 13, 'I': 6, 'K': 13, 'L': 6, 'N': 6, 'O': 6, 'U': 13, 'V': 6, 'W': 6, 'X': 6}"
INV-ZZ-6918651,SCH-ZZ-6980436,ZZ,ZZ20240522BOMBLR3556.0,3556.0,Boeing 777,05/22/2024,2024-05-22 22:10:00,2024-05-23 05:46:00,BOM,BLR,425.0,470,236,-189,234,42,85,127,170,48,24,18,24,94,47,38,47,148,74,53,74,204,103,67,101,"{'F': 25, 'P': 17}","{'C': 34, 'J': 26, 'Z': 26}","{'Q': 38, 'R': 25, 'S': 13, 'T': 13, 'H': 25, 'M': 13}","{'Y': 13, 'A': 13, 'B': 6, 'D': 6, 'E': 6, 'G': 13, 'I': 6, 'K': 13, 'L': 6, 'N': 6, 'O': 6, 'U': 13, 'V': 6, 'W': 6, 'X': 6}"
INV-ZZ-1779792,SCH-ZZ-6980436,ZZ,ZZ20240524BOMBLR3556.0,3556.0,Boeing 777,05/24/2024,2024-05-24 22:10:00,2024-05-25 05:46:00,BOM,BLR,425.0,480,225,-200,255,42,85,127,170,50,23,19,27,94,44,41,50,146,68,59,78,201,94,76,107,"{'F': 25, 'P': 17}","{'C': 34, 'J': 26, 'Z': 26}","{'Q': 38, 'R': 25, 'S': 13, 'T': 13, 'H': 25, 'M': 13}","{'Y': 13, 'A': 13, 'B': 6, 'D': 6, 'E': 6, 'G': 13, 'I': 6, 'K': 13, 'L': 6, 'N': 6, 'O': 6, 'U': 13, 'V': 6, 'W': 6, 'X': 6}"
INV-ZZ-3136377,SCH-ZZ-3206804,ZZ,ZZ20240429AMDCCU4995.0,4995.0,Airbus A321 Neo,04/29/2024,2024-04-29 12:41:00,2024-04-30 12:35:00,AMD,CCU,220.0,242,132,-88,110,22,44,66,88,24,13,9,11,49,27,17,22,73,40,26,33,99,54,34,45,"{'F': 13, 'P': 9}","{'C': 18, 'J': 13, 'Z': 13}","{'Q': 20, 'R': 13, 'S': 7, 'T': 7, 'H': 13, 'M': 7}","{'Y': 7, 'A': 7, 'B': 3, 'D': 3, 'E': 3, 'G': 7, 'I': 3, 'K': 7, 'L': 3, 'N': 3, 'O': 3, 'U': 7, 'V': 3, 'W': 3, 'X': 3}"
INV-ZZ-3819050,SCH-ZZ-3206804,ZZ,ZZ20240502AMDCCU4995.0,4995.0,Airbus A321 Neo,05/02/2024,2024-05-02 12:41:00,2024-05-03 12:35:00,AMD,CCU,220.0,244,138,-82,106,22,44,66,88,25,14,8,11,49,28,16,21,79,45,21,34,101,57,31,44,"{'F': 13, 'P': 9}","{'C': 18, 'J': 13, 'Z': 13}","{'Q': 20, 'R': 13, 'S': 7, 'T': 7, 'H': 13, 'M': 7}","{'Y': 7, 'A': 7, 'B': 3, 'D': 3, 'E': 3, 'G': 7, 'I': 3, 'K': 7, 'L': 3, 'N': 3, 'O': 3, 'U': 7, 'V': 3, 'W': 3, 'X': 3}"
INV-ZZ-6748663,SCH-ZZ-3206804,ZZ,ZZ20240503AMDCCU4995.0,4995.0,Airbus A321 Neo,05/03/2024,2024-05-03 12:41:00,2024-05-04 12:35:00,AMD,CCU,220.0,259,152,-68,107,22,44,66,88,26,15,7,11,50,29,15,21,77,45,21,32,99,58,30,41,"{'F': 13, 'P': 9}","{'C': 18, 'J': 13, 'Z': 13}","{'Q': 20, 'R': 13, 'S': 7, 'T': 7, 'H': 13, 'M': 7}","{'Y': 7, 'A': 7, 'B': 3, 'D': 3, 'E': 3, 'G': 7, 'I': 3, 'K': 7, 'L': 3, 'N': 3, 'O': 3, 'U': 7, 'V': 3, 'W': 3, 'X': 3}"
INV-ZZ-3367845,SCH-ZZ-3206804,ZZ,ZZ20240505AMDCCU4995.0,4995.0,Airbus A321 Neo,05/05/2024,2024-05-05 12:41:00,2024-05-06 12:35:00,AMD,CCU,220.0,247,136,-84,111,22,44,66,88,26,14,8,12,52,29,15,23,73,40,26,33,105,58,30,47,"{'F': 13, 'P': 9}","{'C': 18, 'J': 13, 'Z': 13}","{'Q': 20, 'R': 13, 'S': 7, 'T': 7, 'H': 13, 'M': 7}","{'Y': 7, 'A': 7, 'B': 3, 'D': 3, 'E': 3, 'G': 7, 'I': 3, 'K': 7, 'L': 3, 'N': 3, 'O': 3, 'U': 7, 'V': 3, 'W': 3, 'X': 3}"
INV-ZZ-9087052,SCH-ZZ-3206804,ZZ,ZZ20240506AMDCCU4995.0,4995.0,Airbus A321 Neo,05/06/2024,2024-05-06 12:41:00,2024-05-07 12:35:00,AMD,CCU,220.0,248,142,-78,106,22,44,66,88,26,15,7,11,51,29,15,22,74,42,24,32,102,59,29,43,"{'F': 13, 'P': 9}","{'C': 18, 'J': 13, 'Z': 13}","{'Q': 20, 'R': 13, 'S': 7, 'T': 7, 'H': 13, 'M': 7}","{'Y': 7, 'A': 7, 'B': 3, 'D': 3, 'E': 3, 'G': 7, 'I': 3, 'K': 7, 'L': 3, 'N': 3, 'O': 3, 'U': 7, 'V': 3, 'W': 3, 'X': 3}"
INV-ZZ-8141342,SCH-ZZ-3206804,ZZ,ZZ20240509AMDCCU4995.0,4995.0,Airbus A321 Neo,05/09/2024,2024-05-09 12:41:00,2024-05-10 12:35:00,AMD,CCU,220.0,256,146,-74,110,22,44,66,88,25,14,8,11,51,29,15,22,73,42,24,31,105,60,28,45,"{'F': 13, 'P': 9}","{'C': 18, 'J': 13, 'Z': 13}","{'Q': 20, 'R': 13, 'S': 7, 'T': 7, 'H': 13, 'M': 7}","{'Y': 7, 'A': 7, 'B': 3, 'D': 3, 'E': 3, 'G': 7, 'I': 3, 'K': 7, 'L': 3, 'N': 3, 'O': 3, 'U': 7, 'V': 3, 'W': 3, 'X': 3}"
INV-ZZ-9913086,SCH-ZZ-3206804,ZZ,ZZ20240510AMDCCU4995.0,4995.0,Airbus A321 Neo,05/10/2024,2024-05-10 12:41:00,2024-05-11 12:35:00,AMD,CCU,220.0,244,132,-88,112,22,44,66,88,26,14,8,12,51,28,16,23,77,42,24,35,98,53,35,45,"{'F': 13, 'P': 9}","{'C': 18, 'J': 13, 'Z': 13}","{'Q': 20, 'R': 13, 'S': 7, 'T': 7, 'H': 13, 'M': 7}","{'Y': 7, 'A': 7, 'B': 3, 'D': 3, 'E': 3, 'G': 7, 'I': 3, 'K': 7, 'L': 3, 'N': 3, 'O': 3, 'U': 7, 'V': 3, 'W': 3, 'X': 3}"
INV-ZZ-9265995,SCH-ZZ-3206804,ZZ,ZZ20240512AMDCCU4995.0,4995.0,Airbus A321 Neo,05/12/2024,2024-05-12 12:41:00,2024-05-13 12:35:00,AMD,CCU,220.0,248,141,-79,107,22,44,66,88,26,15,7,11,52,30,14,22,77,44,22,33,97,55,33,42,"{'F': 13, 'P': 9}","{'C': 18, 'J': 13, 'Z': 13}","{'Q': 20, 'R': 13, 'S': 7, 'T': 7, 'H': 13, 'M': 7}","{'Y': 7, 'A': 7, 'B': 3, 'D': 3, 'E': 3, 'G': 7, 'I': 3, 'K': 7, 'L': 3, 'N': 3, 'O': 3, 'U': 7, 'V': 3, 'W': 3, 'X': 3}"
INV-ZZ-5000540,SCH-ZZ-3206804,ZZ,ZZ20240513AMDCCU4995.0,4995.0,Airbus A321 Neo,05/13/2024,2024-05-13 12:41:00,2024-05-14 12:35:00,AMD,CCU,220.0,263,144,-76,119,22,44,66,88,25,14,8,11,50,27,17,23,74,40,26,34,104,57,31,47,"{'F': 13, 'P': 9}","{'C': 18, 'J': 13, 'Z': 13}","{'Q': 20, 'R': 13, 'S': 7, 'T': 7, 'H': 13, 'M': 7}","{'Y': 7, 'A': 7, 'B': 3, 'D': 3, 'E': 3, 'G': 7, 'I': 3, 'K': 7, 'L': 3, 'N': 3, 'O': 3, 'U': 7, 'V': 3, 'W': 3, 'X': 3}"
INV-ZZ-1365380,SCH-ZZ-3206804,ZZ,ZZ20240516AMDCCU4995.0,4995.0,Airbus A321 Neo,05/16/2024,2024-05-16 12:41:00,2024-05-17 12:35:00,AMD,CCU,220.0,243,131,-89,112,22,44,66,88,25,13,9,12,52,28,16,24,79,43,23,36,102,55,33,47,"{'F': 13, 'P': 9}","{'C': 18, 'J': 13, 'Z': 13}","{'Q': 20, 'R': 13, 'S': 7, 'T': 7, 'H': 13, 'M': 7}","{'Y': 7, 'A': 7, 'B': 3, 'D': 3, 'E': 3, 'G': 7, 'I': 3, 'K': 7, 'L': 3, 'N': 3, 'O': 3, 'U': 7, 'V': 3, 'W': 3, 'X': 3}"
INV-ZZ-1075441,SCH-ZZ-3206804,ZZ,ZZ20240517AMDCCU4995.0,4995.0,Airbus A321 Neo,05/17/2024,2024-05-17 12:41:00,2024-05-18 12:35:00,AMD,CCU,220.0,243,134,-86,109,22,44,66,88,26,14,8,12,50,28,16,22,77,42,24,35,98,54,34,44,"{'F': 13, 'P': 9}","{'C': 18, 'J': 13, 'Z': 13}","{'Q': 20, 'R': 13, 'S': 7, 'T': 7, 'H': 13, 'M': 7}","{'Y': 7, 'A': 7, 'B': 3, 'D': 3, 'E': 3, 'G': 7, 'I': 3, 'K': 7, 'L': 3, 'N': 3, 'O': 3, 'U': 7, 'V': 3, 'W': 3, 'X': 3}"
INV-ZZ-7444434,SCH-ZZ-3206804,ZZ,ZZ20240519AMDCCU4995.0,4995.0,Airbus A321 Neo,05/19/2024,2024-05-19 12:41:00,2024-05-20 12:35:00,AMD,CCU,220.0,244,130,-90,114,22,44,66,88,26,14,8,12,49,26,18,23,79,42,24,37,101,54,34,47,"{'F': 13, 'P': 9}","{'C': 18, 'J': 13, 'Z': 13}","{'Q': 20, 'R': 13, 'S': 7, 'T': 7, 'H': 13, 'M': 7}","{'Y': 7, 'A': 7, 'B': 3, 'D': 3, 'E': 3, 'G': 7, 'I': 3, 'K': 7, 'L': 3, 'N': 3, 'O': 3, 'U': 7, 'V': 3, 'W': 3, 'X': 3}"
INV-ZZ-7732283,SCH-ZZ-3206804,ZZ,ZZ20240520AMDCCU4995.0,4995.0,Airbus A321 Neo,05/20/2024,2024-05-20 12:41:00,2024-05-21 12:35:00,AMD,CCU,220.0,259,123,-97,136,22,44,66,88,26,12,10,14,52,25,19,27,75,36,30,39,102,49,39,53,"{'F': 13, 'P': 9}","{'C': 18, 'J': 13, 'Z': 13}","{'Q': 20, 'R': 13, 'S': 7, 'T': 7, 'H': 13, 'M': 7}","{'Y': 7, 'A': 7, 'B': 3, 'D': 3, 'E': 3, 'G': 7, 'I': 3, 'K': 7, 'L': 3, 'N': 3, 'O': 3, 'U': 7, 'V': 3, 'W': 3, 'X': 3}"
INV-ZZ-1183178,SCH-ZZ-3206804,ZZ,ZZ20240523AMDCCU4995.0,4995.0,Airbus A321 Neo,05/23/2024,2024-05-23 12:41:00,2024-05-24 12:35:00,AMD,CCU,220.0,262,133,-87,129,22,44,66,88,25,13,9,12,52,26,18,26,76,39,27,37,105,53,35,52,"{'F': 13, 'P': 9}","{'C': 18, 'J': 13, 'Z': 13}","{'Q': 20, 'R': 13, 'S': 7, 'T': 7, 'H': 13, 'M': 7}","{'Y': 7, 'A': 7, 'B': 3, 'D': 3, 'E': 3, 'G': 7, 'I': 3, 'K': 7, 'L': 3, 'N': 3, 'O': 3, 'U': 7, 'V': 3, 'W': 3, 'X': 3}"
INV-ZZ-8910177,SCH-ZZ-3206804,ZZ,ZZ20240524AMDCCU4995.0,4995.0,Airbus A321 Neo,05/24/2024,2024-05-24 12:41:00,2024-05-25 12:35:00,AMD,CCU,220.0,255,132,-88,123,22,44,66,88,26,13,9,13,52,27,17,25,78,40,26,38,105,54,34,51,"{'F': 13, 'P': 9}","{'C': 18, 'J': 13, 'Z': 13}","{'Q': 20, 'R': 13, 'S': 7, 'T': 7, 'H': 13, 'M': 7}","{'Y': 7, 'A': 7, 'B': 3, 'D': 3, 'E': 3, 'G': 7, 'I': 3, 'K': 7, 'L': 3, 'N': 3, 'O': 3, 'U': 7, 'V': 3, 'W': 3, 'X': 3}"
INV-ZZ-9586543,SCH-ZZ-3206804,ZZ,ZZ20240526AMDCCU4995.0,4995.0,Airbus A321 Neo,05/26/2024,2024-05-26 12:41:00,2024-05-27 12:35:00,AMD,CCU,220.0,244,127,-93,117,22,44,66,88,25,13,9,12,49,26,18,23,75,39,27,36,101,53,35,48,"{'F': 13, 'P': 9}","{'C': 18, 'J': 13, 'Z': 13}","{'Q': 20, 'R': 13, 'S': 7, 'T': 7, 'H': 13, 'M': 7}","{'Y': 7, 'A': 7, 'B': 3, 'D': 3, 'E': 3, 'G': 7, 'I': 3, 'K': 7, 'L': 3, 'N': 3, 'O': 3, 'U': 7, 'V': 3, 'W': 3, 'X': 3}"
INV-ZZ-6330612,SCH-ZZ-3206804,ZZ,ZZ20240527AMDCCU4995.0,4995.0,Airbus A321 Neo,05/27/2024,2024-05-27 12:41:00,2024-05-28 12:35:00,AMD,CCU,220.0,242,129,-91,113,22,44,66,88,26,14,8,12,51,27,17,24,76,40,26,36,100,53,35,47,"{'F': 13, 'P': 9}","{'C': 18, 'J': 13, 'Z': 13}","{'Q': 20, 'R': 13, 'S': 7, 'T': 7, 'H': 13, 'M': 7}","{'Y': 7, 'A': 7, 'B': 3, 'D': 3, 'E': 3, 'G': 7, 'I': 3, 'K': 7, 'L': 3, 'N': 3, 'O': 3, 'U': 7, 'V': 3, 'W': 3, 'X': 3}"
INV-ZZ-4075714,SCH-ZZ-3206804,ZZ,ZZ20240530AMDCCU4995.0,4995.0,Airbus A321 Neo,05/30/2024,2024-05-30 12:41:00,2024-05-31 12:35:00,AMD,CCU,220.0,247,128,-92,119,22,44,66,88,26,13,9,13,51,26,18,25,76,39,27,37,98,51,37,47,"{'F': 13, 'P': 9}","{'C': 18, 'J': 13, 'Z': 13}","{'Q': 20, 'R': 13, 'S': 7, 'T': 7, 'H': 13, 'M': 7}","{'Y': 7, 'A': 7, 'B': 3, 'D': 3, 'E': 3, 'G': 7, 'I': 3, 'K': 7, 'L': 3, 'N': 3, 'O': 3, 'U': 7, 'V': 3, 'W': 3, 'X': 3}"
INV-ZZ-2375827,SCH-ZZ-3206804,ZZ,ZZ20240531AMDCCU4995.0,4995.0,Airbus A321 Neo,05/31/2024,2024-05-31 12:41:00,2024-06-01 12:35:00,AMD,CCU,220.0,251,129,-91,122,22,44,66,88,26,13,9,13,52,27,17,25,76,39,27,37,104,53,35,51,"{'F': 13, 'P': 9}","{'C': 18, 'J': 13, 'Z': 13}","{'Q': 20, 'R': 13, 'S': 7, 'T': 7, 'H': 13, 'M': 7}","{'Y': 7, 'A': 7, 'B': 3, 'D': 3, 'E': 3, 'G': 7, 'I': 3, 'K': 7, 'L': 3, 'N': 3, 'O': 3, 'U': 7, 'V': 3, 'W': 3, 'X': 3}"
INV-ZZ-1474066,SCH-ZZ-3206804,ZZ,ZZ20240602AMDCCU4995.0,4995.0,Airbus A321 Neo,06/02/2024,2024-06-02 12:41:00,2024-06-03 12:35:00,AMD,CCU,220.0,247,127,-93,120,22,44,66,88,25,13,9,12,51,26,18,25,77,40,26,37,103,53,35,50,"{'F': 13, 'P': 9}","{'C': 18, 'J': 13, 'Z': 13}","{'Q': 20, 'R': 13, 'S': 7, 'T': 7, 'H': 13, 'M': 7}","{'Y': 7, 'A': 7, 'B': 3, 'D': 3, 'E': 3, 'G': 7, 'I': 3, 'K': 7, 'L': 3, 'N': 3, 'O': 3, 'U': 7, 'V': 3, 'W': 3, 'X': 3}"
INV-ZZ-6966755,SCH-ZZ-3206804,ZZ,ZZ20240603AMDCCU4995.0,4995.0,Airbus A321 Neo,06/03/2024,2024-06-03 12:41:00,2024-06-04 12:35:00,AMD,CCU,220.0,250,112,-108,138,22,44,66,88,25,11,11,14,49,22,22,27,76,34,32,42,99,44,44,55,"{'F': 13, 'P': 9}","{'C': 18, 'J': 13, 'Z': 13}","{'Q': 20, 'R': 13, 'S': 7, 'T': 7, 'H': 13, 'M': 7}","{'Y': 7, 'A': 7, 'B': 3, 'D': 3, 'E': 3, 'G': 7, 'I': 3, 'K': 7, 'L': 3, 'N': 3, 'O': 3, 'U': 7, 'V': 3, 'W': 3, 'X': 3}"
INV-ZZ-8568765,SCH-ZZ-3206804,ZZ,ZZ20240606AMDCCU4995.0,4995.0,Airbus A321 Neo,06/06/2024,2024-06-06 12:41:00,2024-06-07 12:35:00,AMD,CCU,220.0,247,109,-111,138,22,44,66,88,25,11,11,14,50,22,22,28,74,33,33,41,104,46,42,58,"{'F': 13, 'P': 9}","{'C': 18, 'J': 13, 'Z': 13}","{'Q': 20, 'R': 13, 'S': 7, 'T': 7, 'H': 13, 'M': 7}","{'Y': 7, 'A': 7, 'B': 3, 'D': 3, 'E': 3, 'G': 7, 'I': 3, 'K': 7, 'L': 3, 'N': 3, 'O': 3, 'U': 7, 'V': 3, 'W': 3, 'X': 3}"
INV-ZZ-7247164,SCH-ZZ-3206804,ZZ,ZZ20240607AMDCCU4995.0,4995.0,Airbus A321 Neo,06/07/2024,2024-06-07 12:41:00,2024-06-08 12:35:00,AMD,CCU,220.0,258,124,-96,134,22,44,66,88,26,12,10,14,50,24,20,26,76,36,30,40,98,47,41,51,"{'F': 13, 'P': 9}","{'C': 18, 'J': 13, 'Z': 13}","{'Q': 20, 'R': 13, 'S': 7, 'T': 7, 'H': 13, 'M': 7}","{'Y': 7, 'A': 7, 'B': 3, 'D': 3, 'E': 3, 'G': 7, 'I': 3, 'K': 7, 'L': 3, 'N': 3, 'O': 3, 'U': 7, 'V': 3, 'W': 3, 'X': 3}"
INV-ZZ-2456331,SCH-ZZ-3206804,ZZ,ZZ20240609AMDCCU4995.0,4995.0,Airbus A321 Neo,06/09/2024,2024-06-09 12:41:00,2024-06-10 12:35:00,AMD,CCU,220.0,247,109,-111,138,22,44,66,88,25,11,11,14,49,22,22,27,74,33,33,41,99,44,44,55,"{'F': 13, 'P': 9}","{'C': 18, 'J': 13, 'Z': 13}","{'Q': 20, 'R': 13, 'S': 7, 'T': 7, 'H': 13, 'M': 7}","{'Y': 7, 'A': 7, 'B': 3, 'D': 3, 'E': 3, 'G': 7, 'I': 3, 'K': 7, 'L': 3, 'N': 3, 'O': 3, 'U': 7, 'V': 3, 'W': 3, 'X': 3}"
INV-ZZ-1726223,SCH-ZZ-3206804,ZZ,ZZ20240610AMDCCU4995.0,4995.0,Airbus A321 Neo,06/10/2024,2024-06-10 12:41:00,2024-06-11 12:35:00,AMD,CCU,220.0,251,115,-105,136,22,44,66,88,25,11,11,14,49,23,21,26,73,34,32,39,104,48,40,56,"{'F': 13, 'P': 9}","{'C': 18, 'J': 13, 'Z': 13}","{'Q': 20, 'R': 13, 'S': 7, 'T': 7, 'H': 13, 'M': 7}","{'Y': 7, 'A': 7, 'B': 3, 'D': 3, 'E': 3, 'G': 7, 'I': 3, 'K': 7, 'L': 3, 'N': 3, 'O': 3, 'U': 7, 'V': 3, 'W': 3, 'X': 3}"
INV-ZZ-4221979,SCH-ZZ-3206804,ZZ,ZZ20240613AMDCCU4995.0,4995.0,Airbus A321 Neo,06/13/2024,2024-06-13 12:41:00,2024-06-14 12:35:00,AMD,CCU,220.0,253,106,-114,147,22,44,66,88,26,11,11,15,50,21,23,29,77,32,34,45,102,43,45,59,"{'F': 13, 'P': 9}","{'C': 18, 'J': 13, 'Z': 13}","{'Q': 20, 'R': 13, 'S': 7, 'T': 7, 'H': 13, 'M': 7}","{'Y': 7, 'A': 7, 'B': 3, 'D': 3, 'E': 3, 'G': 7, 'I': 3, 'K': 7, 'L': 3, 'N': 3, 'O': 3, 'U': 7, 'V': 3, 'W': 3, 'X': 3}"
INV-ZZ-9487531,SCH-ZZ-5334272,ZZ,ZZ20240424DELMAA2093.0,2093.0,Boeing 717,04/24/2024,2024-04-24 14:23:00,2024-04-25 04:10:00,DEL,MAA,100.0,114,68,-32,46,10,20,30,40,11,7,3,4,22,13,7,9,35,21,9,14,47,28,12,19,"{'F': 6, 'P': 4}","{'C': 8, 'J': 6, 'Z': 6}","{'Q': 9, 'R': 6, 'S': 3, 'T': 3, 'H': 6, 'M': 3}","{'Y': 3, 'A': 3, 'B': 2, 'D': 2, 'E': 2, 'G': 3, 'I': 2, 'K': 3, 'L': 2, 'N': 2, 'O': 2, 'U': 3, 'V': 2, 'W': 2, 'X': 2}"
INV-ZZ-4978944,SCH-ZZ-5334272,ZZ,ZZ20240426DELMAA2093.0,2093.0,Boeing 717,04/26/2024,2024-04-26 14:23:00,2024-04-27 04:10:00,DEL,MAA,100.0,111,68,-32,43,10,20,30,40,11,7,3,4,23,14,6,9,35,21,9,14,45,27,13,18,"{'F': 6, 'P': 4}","{'C': 8, 'J': 6, 'Z': 6}","{'Q': 9, 'R': 6, 'S': 3, 'T': 3, 'H': 6, 'M': 3}","{'Y': 3, 'A': 3, 'B': 2, 'D': 2, 'E': 2, 'G': 3, 'I': 2, 'K': 3, 'L': 2, 'N': 2, 'O': 2, 'U': 3, 'V': 2, 'W': 2, 'X': 2}"
INV-ZZ-9706670,SCH-ZZ-5334272,ZZ,ZZ20240428DELMAA2093.0,2093.0,Boeing 717,04/28/2024,2024-04-28 14:23:00,2024-04-29 04:10:00,DEL,MAA,100.0,119,72,-28,47,10,20,30,40,11,7,3,4,23,14,6,9,36,22,8,14,46,28,12,18,"{'F': 6, 'P': 4}","{'C': 8, 'J': 6, 'Z': 6}","{'Q': 9, 'R': 6, 'S': 3, 'T': 3, 'H': 6, 'M': 3}","{'Y': 3, 'A': 3, 'B': 2, 'D': 2, 'E': 2, 'G': 3, 'I': 2, 'K': 3, 'L': 2, 'N': 2, 'O': 2, 'U': 3, 'V': 2, 'W': 2, 'X': 2}"
INV-ZZ-8555111,SCH-ZZ-5334272,ZZ,ZZ20240501DELMAA2093.0,2093.0,Boeing 717,05/01/2024,2024-05-01 14:23:00,2024-05-02 04:10:00,DEL,MAA,100.0,115,59,-41,56,10,20,30,40,11,6,4,5,22,11,9,11,36,18,12,18,46,24,16,22,"{'F': 6, 'P': 4}","{'C': 8, 'J': 6, 'Z': 6}","{'Q': 9, 'R': 6, 'S': 3, 'T': 3, 'H': 6, 'M': 3}","{'Y': 3, 'A': 3, 'B': 2, 'D': 2, 'E': 2, 'G': 3, 'I': 2, 'K': 3, 'L': 2, 'N': 2, 'O': 2, 'U': 3, 'V': 2, 'W': 2, 'X': 2}"
INV-ZZ-6523521,SCH-ZZ-5334272,ZZ,ZZ20240503DELMAA2093.0,2093.0,Boeing 717,05/03/2024,2024-05-03 14:23:00,2024-05-04 04:10:00,DEL,MAA,100.0,118,61,-39,57,10,20,30,40,12,6,4,6,22,11,9,11,35,18,12,17,45,23,17,22,"{'F': 6, 'P': 4}","{'C': 8, 'J': 6, 'Z': 6}","{'Q': 9, 'R': 6, 'S': 3, 'T': 3, 'H': 6, 'M': 3}","{'Y': 3, 'A': 3, 'B': 2, 'D': 2, 'E': 2, 'G': 3, 'I': 2, 'K': 3, 'L': 2, 'N': 2, 'O': 2, 'U': 3, 'V': 2, 'W': 2, 'X': 2}"
INV-ZZ-8416416,SCH-ZZ-5334272,ZZ,ZZ20240505DELMAA2093.0,2093.0,Boeing 717,05/05/2024,2024-05-05 14:23:00,2024-05-06 04:10:00,DEL,MAA,100.0,119,60,-40,59,10,20,30,40,11,6,4,5,23,12,8,11,35,18,12,17,47,24,16,23,"{'F': 6, 'P': 4}","{'C': 8, 'J': 6, 'Z': 6}","{'Q': 9, 'R': 6, 'S': 3, 'T': 3, 'H': 6, 'M': 3}","{'Y': 3, 'A': 3, 'B': 2, 'D': 2, 'E': 2, 'G': 3, 'I': 2, 'K': 3, 'L': 2, 'N': 2, 'O': 2, 'U': 3, 'V': 2, 'W': 2, 'X': 2}"
INV-ZZ-3616414,SCH-ZZ-5334272,ZZ,ZZ20240508DELMAA2093.0,2093.0,Boeing 717,05/08/2024,2024-05-08 14:23:00,2024-05-09 04:10:00,DEL,MAA,100.0,114,62,-38,52,10,20,30,40,12,6,4,6,24,13,7,11,34,18,12,16,47,25,15,22,"{'F': 6, 'P': 4}","{'C': 8, 'J': 6, 'Z': 6}","{'Q': 9, 'R': 6, 'S': 3, 'T': 3, 'H': 6, 'M': 3}","{'Y': 3, 'A': 3, 'B': 2, 'D': 2, 'E': 2, 'G': 3, 'I': 2, 'K': 3, 'L': 2, 'N': 2, 'O': 2, 'U': 3, 'V': 2, 'W': 2, 'X': 2}"
INV-ZZ-7214735,SCH-ZZ-5334272,ZZ,ZZ20240510DELMAA2093.0,2093.0,Boeing 717,05/10/2024,2024-05-10 14:23:00,2024-05-11 04:10:00,DEL,MAA,100.0,119,61,-39,58,10,20,30,40,11,6,4,5,23,12,8,11,36,18,12,18,45,23,17,22,"{'F': 6, 'P': 4}","{'C': 8, 'J': 6, 'Z': 6}","{'Q': 9, 'R': 6, 'S': 3, 'T': 3, 'H': 6, 'M': 3}","{'Y': 3, 'A': 3, 'B': 2, 'D': 2, 'E': 2, 'G': 3, 'I': 2, 'K': 3, 'L': 2, 'N': 2, 'O': 2, 'U': 3, 'V': 2, 'W': 2, 'X': 2}"
INV-ZZ-8253996,SCH-ZZ-5334272,ZZ,ZZ20240512DELMAA2093.0,2093.0,Boeing 717,05/12/2024,2024-05-12 14:23:00,2024-05-13 04:10:00,DEL,MAA,100.0,114,65,-35,49,10,20,30,40,11,6,4,5,23,13,7,10,34,19,11,15,45,26,14,19,"{'F': 6, 'P': 4}","{'C': 8, 'J': 6, 'Z': 6}","{'Q': 9, 'R': 6, 'S': 3, 'T': 3, 'H': 6, 'M': 3}","{'Y': 3, 'A': 3, 'B': 2, 'D': 2, 'E': 2, 'G': 3, 'I': 2, 'K': 3, 'L': 2, 'N': 2, 'O': 2, 'U': 3, 'V': 2, 'W': 2, 'X': 2}"
INV-ZZ-1551927,SCH-ZZ-5334272,ZZ,ZZ20240515DELMAA2093.0,2093.0,Boeing 717,05/15/2024,2024-05-15 14:23:00,2024-05-16 04:10:00,DEL,MAA,100.0,110,61,-39,49,10,20,30,40,12,7,3,5,23,13,7,10,33,18,12,15,47,26,14,21,"{'F': 6, 'P': 4}","{'C': 8, 'J': 6, 'Z': 6}","{'Q': 9, 'R': 6, 'S': 3, 'T': 3, 'H': 6, 'M': 3}","{'Y': 3, 'A': 3, 'B': 2, 'D': 2, 'E': 2, 'G': 3, 'I': 2, 'K': 3, 'L': 2, 'N': 2, 'O': 2, 'U': 3, 'V': 2, 'W': 2, 'X': 2}"
INV-ZZ-8038416,SCH-ZZ-5334272,ZZ,ZZ20240517DELMAA2093.0,2093.0,Boeing 717,05/17/2024,2024-05-17 14:23:00,2024-05-18 04:10:00,DEL,MAA,100.0,118,63,-37,55,10,20,30,40,12,6,4,6,22,12,8,10,35,19,11,16,47,25,15,22,"{'F': 6, 'P': 4}","{'C': 8, 'J': 6, 'Z': 6}","{'Q': 9, 'R': 6, 'S': 3, 'T': 3, 'H': 6, 'M': 3}","{'Y': 3, 'A': 3, 'B': 2, 'D': 2, 'E': 2, 'G': 3, 'I': 2, 'K': 3, 'L': 2, 'N': 2, 'O': 2, 'U': 3, 'V': 2, 'W': 2, 'X': 2}"
INV-ZZ-8770835,SCH-ZZ-5334272,ZZ,ZZ20240519DELMAA2093.0,2093.0,Boeing 717,05/19/2024,2024-05-19 14:23:00,2024-05-20 04:10:00,DEL,MAA,100.0,116,59,-41,57,10,20,30,40,11,6,4,5,23,12,8,11,35,18,12,17,45,23,17,22,"{'F': 6, 'P': 4}","{'C': 8, 'J': 6, 'Z': 6}","{'Q': 9, 'R': 6, 'S': 3, 'T': 3, 'H': 6, 'M': 3}","{'Y': 3, 'A': 3, 'B': 2, 'D': 2, 'E': 2, 'G': 3, 'I': 2, 'K': 3, 'L': 2, 'N': 2, 'O': 2, 'U': 3, 'V': 2, 'W': 2, 'X': 2}"
INV-ZZ-2180405,SCH-ZZ-5334272,ZZ,ZZ20240522DELMAA2093.0,2093.0,Boeing 717,05/22/2024,2024-05-22 14:23:00,2024-05-23 04:10:00,DEL,MAA,100.0,114,59,-41,55,10,20,30,40,12,6,4,6,23,12,8,11,35,18,12,17,46,24,16,22,"{'F': 6, 'P': 4}","{'C': 8, 'J': 6, 'Z': 6}","{'Q': 9, 'R': 6, 'S': 3, 'T': 3, 'H': 6, 'M': 3}","{'Y': 3, 'A': 3, 'B': 2, 'D': 2, 'E': 2, 'G': 3, 'I': 2, 'K': 3, 'L': 2, 'N': 2, 'O': 2, 'U': 3, 'V': 2, 'W': 2, 'X': 2}"
INV-ZZ-9829970,SCH-ZZ-5334272,ZZ,ZZ20240524DELMAA2093.0,2093.0,Boeing 717,05/24/2024,2024-05-24 14:23:00,2024-05-25 04:10:00,DEL,MAA,100.0,116,60,-40,56,10,20,30,40,11,6,4,5,23,12,8,11,35,18,12,17,44,23,17,21,"{'F': 6, 'P': 4}","{'C': 8, 'J': 6, 'Z': 6}","{'Q': 9, 'R': 6, 'S': 3, 'T': 3, 'H': 6, 'M': 3}","{'Y': 3, 'A': 3, 'B': 2, 'D': 2, 'E': 2, 'G': 3, 'I': 2, 'K': 3, 'L': 2, 'N': 2, 'O': 2, 'U': 3, 'V': 2, 'W': 2, 'X': 2}"
INV-ZZ-9512340,SCH-ZZ-5334272,ZZ,ZZ20240526DELMAA2093.0,2093.0,Boeing 717,05/26/2024,2024-05-26 14:23:00,2024-05-27 04:10:00,DEL,MAA,100.0,114,57,-43,57,10,20,30,40,11,5,5,6,22,11,9,11,33,16,14,17,48,24,16,24,"{'F': 6, 'P': 4}","{'C': 8, 'J': 6, 'Z': 6}","{'Q': 9, 'R': 6, 'S': 3, 'T': 3, 'H': 6, 'M': 3}","{'Y': 3, 'A': 3, 'B': 2, 'D': 2, 'E': 2, 'G': 3, 'I': 2, 'K': 3, 'L': 2, 'N': 2, 'O': 2, 'U': 3, 'V': 2, 'W': 2, 'X': 2}"
INV-ZZ-3225189,SCH-ZZ-5334272,ZZ,ZZ20240529DELMAA2093.0,2093.0,Boeing 717,05/29/2024,2024-05-29 14:23:00,2024-05-30 04:10:00,DEL,MAA,100.0,118,62,-38,56,10,20,30,40,11,6,4,5,24,13,7,11,33,17,13,16,44,23,17,21,"{'F': 6, 'P': 4}","{'C': 8, 'J': 6, 'Z': 6}","{'Q': 9, 'R': 6, 'S': 3, 'T': 3, 'H': 6, 'M': 3}","{'Y': 3, 'A': 3, 'B': 2, 'D': 2, 'E': 2, 'G': 3, 'I': 2, 'K': 3, 'L': 2, 'N': 2, 'O': 2, 'U': 3, 'V': 2, 'W': 2, 'X': 2}"
INV-ZZ-3964201,SCH-ZZ-5334272,ZZ,ZZ20240531DELMAA2093.0,2093.0,Boeing 717,05/31/2024,2024-05-31 14:23:00,2024-06-01 04:10:00,DEL,MAA,100.0,118,53,-47,65,10,20,30,40,12,5,5,7,23,10,10,13,34,15,15,19,45,20,20,25,"{'F': 6, 'P': 4}","{'C': 8, 'J': 6, 'Z': 6}","{'Q': 9, 'R': 6, 'S': 3, 'T': 3, 'H': 6, 'M': 3}","{'Y': 3, 'A': 3, 'B': 2, 'D': 2, 'E': 2, 'G': 3, 'I': 2, 'K': 3, 'L': 2, 'N': 2, 'O': 2, 'U': 3, 'V': 2, 'W': 2, 'X': 2}"
INV-ZZ-7130791,SCH-ZZ-5334272,ZZ,ZZ20240602DELMAA2093.0,2093.0,Boeing 717,06/02/2024,2024-06-02 14:23:00,2024-06-03 04:10:00,DEL,MAA,100.0,114,55,-45,59,10,20,30,40,11,5,5,6,24,12,8,12,34,16,14,18,46,22,18,24,"{'F': 6, 'P': 4}","{'C': 8, 'J': 6, 'Z': 6}","{'Q': 9, 'R': 6, 'S': 3, 'T': 3, 'H': 6, 'M': 3}","{'Y': 3, 'A': 3, 'B': 2, 'D': 2, 'E': 2, 'G': 3, 'I': 2, 'K': 3, 'L': 2, 'N': 2, 'O': 2, 'U': 3, 'V': 2, 'W': 2, 'X': 2}"
INV-ZZ-7196755,SCH-ZZ-5334272,ZZ,ZZ20240605DELMAA2093.0,2093.0,Boeing 717,06/05/2024,2024-06-05 14:23:00,2024-06-06 04:10:00,DEL,MAA,100.0,116,53,-47,63,10,20,30,40,11,5,5,6,24,11,9,13,34,15,15,19,47,21,19,26,"{'F': 6, 'P': 4}","{'C': 8, 'J': 6, 'Z': 6}","{'Q': 9, 'R': 6, 'S': 3, 'T': 3, 'H': 6, 'M': 3}","{'Y': 3, 'A': 3, 'B': 2, 'D': 2, 'E': 2, 'G': 3, 'I': 2, 'K': 3, 'L': 2, 'N': 2, 'O': 2, 'U': 3, 'V': 2, 'W': 2, 'X': 2}"
INV-ZZ-6935458,SCH-ZZ-5334272,ZZ,ZZ20240607DELMAA2093.0,2093.0,Boeing 717,06/07/2024,2024-06-07 14:23:00,2024-06-08 04:10:00,DEL,MAA,100.0,110,50,-50,60,10,20,30,40,12,5,5,7,22,10,10,12,34,15,15,19,46,21,19,25,"{'F': 6, 'P': 4}","{'C': 8, 'J': 6, 'Z': 6}","{'Q': 9, 'R': 6, 'S': 3, 'T': 3, 'H': 6, 'M': 3}","{'Y': 3, 'A': 3, 'B': 2, 'D': 2, 'E': 2, 'G': 3, 'I': 2, 'K': 3, 'L': 2, 'N': 2, 'O': 2, 'U': 3, 'V': 2, 'W': 2, 'X': 2}"
INV-ZZ-8682830,SCH-ZZ-1839422,ZZ,ZZ20240426AMDMAA4140.0,4140.0,Boeing 787,04/26/2024,2024-04-26 13:19:00,2024-04-26 15:02:00,AMD,MAA,270.0,312,184,-86,128,27,54,81,108,31,18,9,13,59,35,19,24,97,57,24,40,119,70,38,49,"{'F': 16, 'P': 11}","{'C': 22, 'J': 16, 'Z': 16}","{'Q': 24, 'R': 16, 'S': 8, 'T': 8, 'H': 16, 'M': 8}","{'Y': 8, 'A': 8, 'B': 4, 'D': 4, 'E': 4, 'G': 8, 'I': 4, 'K': 8, 'L': 4, 'N': 4, 'O': 4, 'U': 8, 'V': 4, 'W': 4, 'X': 4}"
INV-ZZ-8550276,SCH-ZZ-1839422,ZZ,ZZ20240428AMDMAA4140.0,4140.0,Boeing 787,04/28/2024,2024-04-28 13:19:00,2024-04-28 15:02:00,AMD,MAA,270.0,310,164,-106,146,27,54,81,108,31,16,11,15,63,33,21,30,96,51,30,45,121,64,44,57,"{'F': 16, 'P': 11}","{'C': 22, 'J': 16, 'Z': 16}","{'Q': 24, 'R': 16, 'S': 8, 'T': 8, 'H': 16, 'M': 8}","{'Y': 8, 'A': 8, 'B': 4, 'D': 4, 'E': 4, 'G': 8, 'I': 4, 'K': 8, 'L': 4, 'N': 4, 'O': 4, 'U': 8, 'V': 4, 'W': 4, 'X': 4}"
INV-ZZ-2035559,SCH-ZZ-1839422,ZZ,ZZ20240429AMDMAA4140.0,4140.0,Boeing 787,04/29/2024,2024-04-29 13:19:00,2024-04-29 15:02:00,AMD,MAA,270.0,307,173,-97,134,27,54,81,108,30,17,10,13,63,36,18,27,97,55,26,42,124,70,38,54,"{'F': 16, 'P': 11}","{'C': 22, 'J': 16, 'Z': 16}","{'Q': 24, 'R': 16, 'S': 8, 'T': 8, 'H': 16, 'M': 8}","{'Y': 8, 'A': 8, 'B': 4, 'D': 4, 'E': 4, 'G': 8, 'I': 4, 'K': 8, 'L': 4, 'N': 4, 'O': 4, 'U': 8, 'V': 4, 'W': 4, 'X': 4}"
INV-ZZ-4848168,SCH-ZZ-1839422,ZZ,ZZ20240430AMDMAA4140.0,4140.0,Boeing 787,04/30/2024,2024-04-30 13:19:00,2024-04-30 15:02:00,AMD,MAA,270.0,298,169,-101,129,27,54,81,108,32,18,9,14,61,35,19,26,94,53,28,41,129,73,35,56,"{'F': 16, 'P': 11}","{'C': 22, 'J': 16, 'Z': 16}","{'Q': 24, 'R': 16, 'S': 8, 'T': 8, 'H': 16, 'M': 8}","{'Y': 8, 'A': 8, 'B': 4, 'D': 4, 'E': 4, 'G': 8, 'I': 4, 'K': 8, 'L': 4, 'N': 4, 'O': 4, 'U': 8, 'V': 4, 'W': 4, 'X': 4}"
INV-ZZ-6945295,SCH-ZZ-1839422,ZZ,ZZ20240502AMDMAA4140.0,4140.0,Boeing 787,05/02/2024,2024-05-02 13:19:00,2024-05-02 15:02:00,AMD,MAA,270.0,307,167,-103,140,27,54,81,108,31,17,10,14,62,34,20,28,90,49,32,41,121,66,42,55,"{'F': 16, 'P': 11}","{'C': 22, 'J': 16, 'Z': 16}","{'Q': 24, 'R': 16, 'S': 8, 'T': 8, 'H': 16, 'M': 8}","{'Y': 8, 'A': 8, 'B': 4, 'D': 4, 'E': 4, 'G': 8, 'I': 4, 'K': 8, 'L': 4, 'N': 4, 'O': 4, 'U': 8, 'V': 4, 'W': 4, 'X': 4}"
INV-ZZ-4477245,SCH-ZZ-1839422,ZZ,ZZ20240503AMDMAA4140.0,4140.0,Boeing 787,05/03/2024,2024-05-03 13:19:00,2024-05-03 15:02:00,AMD,MAA,270.0,313,184,-86,129,27,54,81,108,32,19,8,13,63,37,17,26,94,55,26,39,124,73,35,51,"{'F': 16, 'P': 11}","{'C': 22, 'J': 16, 'Z': 16}","{'Q': 24, 'R': 16, 'S': 8, 'T': 8, 'H': 16, 'M': 8}","{'Y': 8, 'A': 8, 'B': 4, 'D': 4, 'E': 4, 'G': 8, 'I': 4, 'K': 8, 'L': 4, 'N': 4, 'O': 4, 'U': 8, 'V': 4, 'W': 4, 'X': 4}"
INV-ZZ-7457304,SCH-ZZ-1839422,ZZ,ZZ20240505AMDMAA4140.0,4140.0,Boeing 787,05/05/2024,2024-05-05 13:19:00,2024-05-05 15:02:00,AMD,MAA,270.0,319,187,-83,132,27,54,81,108,32,19,8,13,60,35,19,25,94,55,26,39,120,70,38,50,"{'F': 16, 'P': 11}","{'C': 22, 'J': 16, 'Z': 16}","{'Q': 24, 'R': 16, 'S': 8, 'T': 8, 'H': 16, 'M': 8}","{'Y': 8, 'A': 8, 'B': 4, 'D': 4, 'E': 4, 'G': 8, 'I': 4, 'K': 8, 'L': 4, 'N': 4, 'O': 4, 'U': 8, 'V': 4, 'W': 4, 'X': 4}"
INV-ZZ-8515459,SCH-ZZ-1839422,ZZ,ZZ20240506AMDMAA4140.0,4140.0,Boeing 787,05/06/2024,2024-05-06 13:19:00,2024-05-06 15:02:00,AMD,MAA,270.0,311,157,-113,154,27,54,81,108,30,15,12,15,64,32,22,32,92,47,34,45,127,64,44,63,"{'F': 16, 'P': 11}","{'C': 22, 'J': 16, 'Z': 16}","{'Q': 24, 'R': 16, 'S': 8, 'T': 8, 'H': 16, 'M': 8}","{'Y': 8, 'A': 8, 'B': 4, 'D': 4, 'E': 4, 'G': 8, 'I': 4, 'K': 8, 'L': 4, 'N': 4, 'O': 4, 'U': 8, 'V': 4, 'W': 4, 'X': 4}"
INV-ZZ-3573027,SCH-ZZ-1839422,ZZ,ZZ20240507AMDMAA4140.0,4140.0,Boeing 787,05/07/2024,2024-05-07 13:19:00,2024-05-07 15:02:00,AMD,MAA,270.0,303,158,-112,145,27,54,81,108,32,17,10,15,63,33,21,30,91,47,34,44,124,64,44,60,"{'F': 16, 'P': 11}","{'C': 22, 'J': 16, 'Z': 16}","{'Q': 24, 'R': 16, 'S': 8, 'T': 8, 'H': 16, 'M': 8}","{'Y': 8, 'A': 8, 'B': 4, 'D': 4, 'E': 4, 'G': 8, 'I': 4, 'K': 8, 'L': 4, 'N': 4, 'O': 4, 'U': 8, 'V': 4, 'W': 4, 'X': 4}"
INV-ZZ-8660705,SCH-ZZ-1839422,ZZ,ZZ20240509AMDMAA4140.0,4140.0,Boeing 787,05/09/2024,2024-05-09 13:19:00,2024-05-09 15:02:00,AMD,MAA,270.0,312,181,-89,131,27,54,81,108,30,17,10,13,60,35,19,25,90,52,29,38,126,73,35,53,"{'F': 16, 'P': 11}","{'C': 22, 'J': 16, 'Z': 16}","{'Q': 24, 'R': 16, 'S': 8, 'T': 8, 'H': 16, 'M': 8}","{'Y': 8, 'A': 8, 'B': 4, 'D': 4, 'E': 4, 'G': 8, 'I': 4, 'K': 8, 'L': 4, 'N': 4, 'O': 4, 'U': 8, 'V': 4, 'W': 4, 'X': 4}"
INV-ZZ-8753486,SCH-ZZ-1839422,ZZ,ZZ20240510AMDMAA4140.0,4140.0,Boeing 787,05/10/2024,2024-05-10 13:19:00,2024-05-10 15:02:00,AMD,MAA,270.0,317,183,-87,134,27,54,81,108,32,18,9,14,62,36,18,26,94,54,27,40,123,71,37,52,"{'F': 16, 'P': 11}","{'C': 22, 'J': 16, 'Z': 16}","{'Q': 24, 'R': 16, 'S': 8, 'T': 8, 'H': 16, 'M': 8}","{'Y': 8, 'A': 8, 'B': 4, 'D': 4, 'E': 4, 'G': 8, 'I': 4, 'K': 8, 'L': 4, 'N': 4, 'O': 4, 'U': 8, 'V': 4, 'W': 4, 'X': 4}"
INV-ZZ-9614625,SCH-ZZ-1839422,ZZ,ZZ20240512AMDMAA4140.0,4140.0,Boeing 787,05/12/2024,2024-05-12 13:19:00,2024-05-12 15:02:00,AMD,MAA,270.0,303,168,-102,135,27,54,81,108,32,18,9,14,62,34,20,28,92,51,30,41,126,70,38,56,"{'F': 16, 'P': 11}","{'C': 22, 'J': 16, 'Z': 16}","{'Q': 24, 'R': 16, 'S': 8, 'T': 8, 'H': 16, 'M': 8}","{'Y': 8, 'A': 8, 'B': 4, 'D': 4, 'E': 4, 'G': 8, 'I': 4, 'K': 8, 'L': 4, 'N': 4, 'O': 4, 'U': 8, 'V': 4, 'W': 4, 'X': 4}"
INV-ZZ-9853634,SCH-ZZ-1839422,ZZ,ZZ20240513AMDMAA4140.0,4140.0,Boeing 787,05/13/2024,2024-05-13 13:19:00,2024-05-13 15:02:00,AMD,MAA,270.0,320,164,-106,156,27,54,81,108,30,15,12,15,59,30,24,29,92,47,34,45,124,64,44,60,"{'F': 16, 'P': 11}","{'C': 22, 'J': 16, 'Z': 16}","{'Q': 24, 'R': 16, 'S': 8, 'T': 8, 'H': 16, 'M': 8}","{'Y': 8, 'A': 8, 'B': 4, 'D': 4, 'E': 4, 'G': 8, 'I': 4, 'K': 8, 'L': 4, 'N': 4, 'O': 4, 'U': 8, 'V': 4, 'W': 4, 'X': 4}"
INV-ZZ-9801434,SCH-ZZ-1839422,ZZ,ZZ20240514AMDMAA4140.0,4140.0,Boeing 787,05/14/2024,2024-05-14 13:19:00,2024-05-14 15:02:00,AMD,MAA,270.0,306,151,-119,155,27,54,81,108,32,16,11,16,62,30,24,32,92,45,36,47,122,60,48,62,"{'F': 16, 'P': 11}","{'C': 22, 'J': 16, 'Z': 16}","{'Q': 24, 'R': 16, 'S': 8, 'T': 8, 'H': 16, 'M': 8}","{'Y': 8, 'A': 8, 'B': 4, 'D': 4, 'E': 4, 'G': 8, 'I': 4, 'K': 8, 'L': 4, 'N': 4, 'O': 4, 'U': 8, 'V': 4, 'W': 4, 'X': 4}"
INV-ZZ-2170213,SCH-ZZ-1839422,ZZ,ZZ20240516AMDMAA4140.0,4140.0,Boeing 787,05/16/2024,2024-05-16 13:19:00,2024-05-16 15:02:00,AMD,MAA,270.0,303,146,-124,157,27,54,81,108,32,15,12,17,65,31,23,34,95,46,35,49,122,59,49,63,"{'F': 16, 'P': 11}","{'C': 22, 'J': 16, 'Z': 16}","{'Q': 24, 'R': 16, 'S': 8, 'T': 8, 'H': 16, 'M': 8}","{'Y': 8, 'A': 8, 'B': 4, 'D': 4, 'E': 4, 'G': 8, 'I': 4, 'K': 8, 'L': 4, 'N': 4, 'O': 4, 'U': 8, 'V': 4, 'W': 4, 'X': 4}"
INV-ZZ-2749009,SCH-ZZ-1839422,ZZ,ZZ20240517AMDMAA4140.0,4140.0,Boeing 787,05/17/2024,2024-05-17 13:19:00,2024-05-17 15:02:00,AMD,MAA,270.0,302,164,-106,138,27,54,81,108,30,16,11,14,60,33,21,27,96,52,29,44,121,66,42,55,"{'F': 16, 'P': 11}","{'C': 22, 'J': 16, 'Z': 16}","{'Q': 24, 'R': 16, 'S': 8, 'T': 8, 'H': 16, 'M': 8}","{'Y': 8, 'A': 8, 'B': 4, 'D': 4, 'E': 4, 'G': 8, 'I': 4, 'K': 8, 'L': 4, 'N': 4, 'O': 4, 'U': 8, 'V': 4, 'W': 4, 'X': 4}"
INV-ZZ-4995007,SCH-ZZ-1839422,ZZ,ZZ20240519AMDMAA4140.0,4140.0,Boeing 787,05/19/2024,2024-05-19 13:19:00,2024-05-19 15:02:00,AMD,MAA,270.0,316,151,-119,165,27,54,81,108,32,15,12,17,60,29,25,31,91,43,38,48,124,59,49,65,"{'F': 16, 'P': 11}","{'C': 22, 'J': 16, 'Z': 16}","{'Q': 24, 'R': 16, 'S': 8, 'T': 8, 'H': 16, 'M': 8}","{'Y': 8, 'A': 8, 'B': 4, 'D': 4, 'E': 4, 'G': 8, 'I': 4, 'K': 8, 'L': 4, 'N': 4, 'O': 4, 'U': 8, 'V': 4, 'W': 4, 'X': 4}"
INV-ZZ-1096205,SCH-ZZ-1839422,ZZ,ZZ20240520AMDMAA4140.0,4140.0,Boeing 787,05/20/2024,2024-05-20 13:19:00,2024-05-20 15:02:00,AMD,MAA,270.0,303,159,-111,144,27,54,81,108,30,16,11,14,62,33,21,29,92,48,33,44,125,66,42,59,"{'F': 16, 'P': 11}","{'C': 22, 'J': 16, 'Z': 16}","{'Q': 24, 'R': 16, 'S': 8, 'T': 8, 'H': 16, 'M': 8}","{'Y': 8, 'A': 8, 'B': 4, 'D': 4, 'E': 4, 'G': 8, 'I': 4, 'K': 8, 'L': 4, 'N': 4, 'O': 4, 'U': 8, 'V': 4, 'W': 4, 'X': 4}"
INV-ZZ-7678248,SCH-ZZ-1839422,ZZ,ZZ20240521AMDMAA4140.0,4140.0,Boeing 787,05/21/2024,2024-05-21 13:19:00,2024-05-21 15:02:00,AMD,MAA,270.0,322,167,-103,155,27,54,81,108,32,17,10,15,64,33,21,31,95,49,32,46,122,63,45,59,"{'F': 16, 'P': 11}","{'C': 22, 'J': 16, 'Z': 16}","{'Q': 24, 'R': 16, 'S': 8, 'T': 8, 'H': 16, 'M': 8}","{'Y': 8, 'A': 8, 'B': 4, 'D': 4, 'E': 4, 'G': 8, 'I': 4, 'K': 8, 'L': 4, 'N': 4, 'O': 4, 'U': 8, 'V': 4, 'W': 4, 'X': 4}"
INV-ZZ-7112311,SCH-ZZ-1839422,ZZ,ZZ20240523AMDMAA4140.0,4140.0,Boeing 787,05/23/2024,2024-05-23 13:19:00,2024-05-23 15:02:00,AMD,MAA,270.0,314,146,-124,168,27,54,81,108,32,15,12,17,62,29,25,33,91,42,39,49,126,59,49,67,"{'F': 16, 'P': 11}","{'C': 22, 'J': 16, 'Z': 16}","{'Q': 24, 'R': 16, 'S': 8, 'T': 8, 'H': 16, 'M': 8}","{'Y': 8, 'A': 8, 'B': 4, 'D': 4, 'E': 4, 'G': 8, 'I': 4, 'K': 8, 'L': 4, 'N': 4, 'O': 4, 'U': 8, 'V': 4, 'W': 4, 'X': 4}"
INV-ZZ-5812619,SCH-ZZ-1839422,ZZ,ZZ20240524AMDMAA4140.0,4140.0,Boeing 787,05/24/2024,2024-05-24 13:19:00,2024-05-24 15:02:00,AMD,MAA,270.0,301,149,-121,152,27,54,81,108,31,15,12,16,62,31,23,31,96,48,33,48,128,64,44,64,"{'F': 16, 'P': 11}","{'C': 22, 'J': 16, 'Z': 16}","{'Q': 24, 'R': 16, 'S': 8, 'T': 8, 'H': 16, 'M': 8}","{'Y': 8, 'A': 8, 'B': 4, 'D': 4, 'E': 4, 'G': 8, 'I': 4, 'K': 8, 'L': 4, 'N': 4, 'O': 4, 'U': 8, 'V': 4, 'W': 4, 'X': 4}"
INV-ZZ-6937296,SCH-ZZ-1839422,ZZ,ZZ20240526AMDMAA4140.0,4140.0,Boeing 787,05/26/2024,2024-05-26 13:19:00,2024-05-26 15:02:00,AMD,MAA,270.0,316,157,-113,159,27,54,81,108,30,15,12,15,59,29,25,30,93,46,35,47,120,60,48,60,"{'F': 16, 'P': 11}","{'C': 22, 'J': 16, 'Z': 16}","{'Q': 24, 'R': 16, 'S': 8, 'T': 8, 'H': 16, 'M': 8}","{'Y': 8, 'A': 8, 'B': 4, 'D': 4, 'E': 4, 'G': 8, 'I': 4, 'K': 8, 'L': 4, 'N': 4, 'O': 4, 'U': 8, 'V': 4, 'W': 4, 'X': 4}"
INV-ZZ-3622990,SCH-ZZ-1839422,ZZ,ZZ20240527AMDMAA4140.0,4140.0,Boeing 787,05/27/2024,2024-05-27 13:19:00,2024-05-27 15:02:00,AMD,MAA,270.0,302,159,-111,143,27,54,81,108,32,17,10,15,64,34,20,30,97,51,30,46,127,67,41,60,"{'F': 16, 'P': 11}","{'C': 22, 'J': 16, 'Z': 16}","{'Q': 24, 'R': 16, 'S': 8, 'T': 8, 'H': 16, 'M': 8}","{'Y': 8, 'A': 8, 'B': 4, 'D': 4, 'E': 4, 'G': 8, 'I': 4, 'K': 8, 'L': 4, 'N': 4, 'O': 4, 'U': 8, 'V': 4, 'W': 4, 'X': 4}"
INV-ZZ-9949225,SCH-ZZ-1839422,ZZ,ZZ20240528AMDMAA4140.0,4140.0,Boeing 787,05/28/2024,2024-05-28 13:19:00,2024-05-28 15:02:00,AMD,MAA,270.0,308,143,-127,165,27,54,81,108,31,14,13,17,60,28,26,32,94,44,37,50,129,60,48,69,"{'F': 16, 'P': 11}","{'C': 22, 'J': 16, 'Z': 16}","{'Q': 24, 'R': 16, 'S': 8, 'T': 8, 'H': 16, 'M': 8}","{'Y': 8, 'A': 8, 'B': 4, 'D': 4, 'E': 4, 'G': 8, 'I': 4, 'K': 8, 'L': 4, 'N': 4, 'O': 4, 'U': 8, 'V': 4, 'W': 4, 'X': 4}"
INV-ZZ-9239436,SCH-ZZ-1839422,ZZ,ZZ20240530AMDMAA4140.0,4140.0,Boeing 787,05/30/2024,2024-05-30 13:19:00,2024-05-30 15:02:00,AMD,MAA,270.0,317,142,-128,175,27,54,81,108,31,14,13,17,61,27,27,34,97,44,37,53,126,57,51,69,"{'F': 16, 'P': 11}","{'C': 22, 'J': 16, 'Z': 16}","{'Q': 24, 'R': 16, 'S': 8, 'T': 8, 'H': 16, 'M': 8}","{'Y': 8, 'A': 8, 'B': 4, 'D': 4, 'E': 4, 'G': 8, 'I': 4, 'K': 8, 'L': 4, 'N': 4, 'O': 4, 'U': 8, 'V': 4, 'W': 4, 'X': 4}"
INV-ZZ-7058773,SCH-ZZ-1839422,ZZ,ZZ20240531AMDMAA4140.0,4140.0,Boeing 787,05/31/2024,2024-05-31 13:19:00,2024-05-31 15:02:00,AMD,MAA,270.0,319,163,-107,156,27,54,81,108,30,15,12,15,64,33,21,31,94,48,33,46,122,62,46,60,"{'F': 16, 'P': 11}","{'C': 22, 'J': 16, 'Z': 16}","{'Q': 24, 'R': 16, 'S': 8, 'T': 8, 'H': 16, 'M': 8}","{'Y': 8, 'A': 8, 'B': 4, 'D': 4, 'E': 4, 'G': 8, 'I': 4, 'K': 8, 'L': 4, 'N': 4, 'O': 4, 'U': 8, 'V': 4, 'W': 4, 'X': 4}"
INV-ZZ-8660565,SCH-ZZ-1839422,ZZ,ZZ20240602AMDMAA4140.0,4140.0,Boeing 787,06/02/2024,2024-06-02 13:19:00,2024-06-02 15:02:00,AMD,MAA,270.0,317,142,-128,175,27,54,81,108,31,14,13,17,65,29,25,36,95,43,38,52,123,55,53,68,"{'F': 16, 'P': 11}","{'C': 22, 'J': 16, 'Z': 16}","{'Q': 24, 'R': 16, 'S': 8, 'T': 8, 'H': 16, 'M': 8}","{'Y': 8, 'A': 8, 'B': 4, 'D': 4, 'E': 4, 'G': 8, 'I': 4, 'K': 8, 'L': 4, 'N': 4, 'O': 4, 'U': 8, 'V': 4, 'W': 4, 'X': 4}"
INV-ZZ-4584322,SCH-ZZ-1839422,ZZ,ZZ20240603AMDMAA4140.0,4140.0,Boeing 787,06/03/2024,2024-06-03 13:19:00,2024-06-03 15:02:00,AMD,MAA,270.0,315,159,-111,156,27,54,81,108,31,16,11,15,60,30,24,30,92,47,34,45,126,64,44,62,"{'F': 16, 'P': 11}","{'C': 22, 'J': 16, 'Z': 16}","{'Q': 24, 'R': 16, 'S': 8, 'T': 8, 'H': 16, 'M': 8}","{'Y': 8, 'A': 8, 'B': 4, 'D': 4, 'E': 4, 'G': 8, 'I': 4, 'K': 8, 'L': 4, 'N': 4, 'O': 4, 'U': 8, 'V': 4, 'W': 4, 'X': 4}"
INV-ZZ-1132221,SCH-ZZ-1839422,ZZ,ZZ20240604AMDMAA4140.0,4140.0,Boeing 787,06/04/2024,2024-06-04 13:19:00,2024-06-04 15:02:00,AMD,MAA,270.0,320,142,-128,178,27,54,81,108,31,14,13,17,64,28,26,36,96,43,38,53,122,54,54,68,"{'F': 16, 'P': 11}","{'C': 22, 'J': 16, 'Z': 16}","{'Q': 24, 'R': 16, 'S': 8, 'T': 8, 'H': 16, 'M': 8}","{'Y': 8, 'A': 8, 'B': 4, 'D': 4, 'E': 4, 'G': 8, 'I': 4, 'K': 8, 'L': 4, 'N': 4, 'O': 4, 'U': 8, 'V': 4, 'W': 4, 'X': 4}"
INV-ZZ-8022485,SCH-ZZ-1839422,ZZ,ZZ20240606AMDMAA4140.0,4140.0,Boeing 787,06/06/2024,2024-06-06 13:19:00,2024-06-06 15:02:00,AMD,MAA,270.0,308,148,-122,160,27,54,81,108,32,15,12,17,63,30,24,33,95,46,35,49,126,61,47,65,"{'F': 16, 'P': 11}","{'C': 22, 'J': 16, 'Z': 16}","{'Q': 24, 'R': 16, 'S': 8, 'T': 8, 'H': 16, 'M': 8}","{'Y': 8, 'A': 8, 'B': 4, 'D': 4, 'E': 4, 'G': 8, 'I': 4, 'K': 8, 'L': 4, 'N': 4, 'O': 4, 'U': 8, 'V': 4, 'W': 4, 'X': 4}"
INV-ZZ-7245933,SCH-ZZ-1839422,ZZ,ZZ20240607AMDMAA4140.0,4140.0,Boeing 787,06/07/2024,2024-06-07 13:19:00,2024-06-07 15:02:00,AMD,MAA,270.0,300,150,-120,150,27,54,81,108,31,15,12,16,60,30,24,30,91,45,36,46,124,62,46,62,"{'F': 16, 'P': 11}","{'C': 22, 'J': 16, 'Z': 16}","{'Q': 24, 'R': 16, 'S': 8, 'T': 8, 'H': 16, 'M': 8}","{'Y': 8, 'A': 8, 'B': 4, 'D': 4, 'E': 4, 'G': 8, 'I': 4, 'K': 8, 'L': 4, 'N': 4, 'O': 4, 'U': 8, 'V': 4, 'W': 4, 'X': 4}"
INV-ZZ-4921893,SCH-ZZ-1839422,ZZ,ZZ20240609AMDMAA4140.0,4140.0,Boeing 787,06/09/2024,2024-06-09 13:19:00,2024-06-09 15:02:00,AMD,MAA,270.0,315,151,-119,164,27,54,81,108,32,15,12,17,60,29,25,31,95,45,36,50,119,57,51,62,"{'F': 16, 'P': 11}","{'C': 22, 'J': 16, 'Z': 16}","{'Q': 24, 'R': 16, 'S': 8, 'T': 8, 'H': 16, 'M': 8}","{'Y': 8, 'A': 8, 'B': 4, 'D': 4, 'E': 4, 'G': 8, 'I': 4, 'K': 8, 'L': 4, 'N': 4, 'O': 4, 'U': 8, 'V': 4, 'W': 4, 'X': 4}"
INV-ZZ-2601188,SCH-ZZ-1839422,ZZ,ZZ20240610AMDMAA4140.0,4140.0,Boeing 787,06/10/2024,2024-06-10 13:19:00,2024-06-10 15:02:00,AMD,MAA,270.0,306,129,-141,177,27,54,81,108,31,13,14,18,60,25,29,35,95,40,41,55,128,54,54,74,"{'F': 16, 'P': 11}","{'C': 22, 'J': 16, 'Z': 16}","{'Q': 24, 'R': 16, 'S': 8, 'T': 8, 'H': 16, 'M': 8}","{'Y': 8, 'A': 8, 'B': 4, 'D': 4, 'E': 4, 'G': 8, 'I': 4, 'K': 8, 'L': 4, 'N': 4, 'O': 4, 'U': 8, 'V': 4, 'W': 4, 'X': 4}"
INV-ZZ-2949699,SCH-ZZ-7925469,ZZ,ZZ20240508BLRDEL4246.0,4246.0,Boeing 777,05/08/2024,2024-05-08 17:54:00,2024-05-09 17:16:00,BLR,DEL,425.0,493,266,-159,227,42,85,127,170,50,27,15,23,101,55,30,46,152,82,45,70,201,109,61,92,"{'F': 25, 'P': 17}","{'C': 34, 'J': 26, 'Z': 26}","{'Q': 38, 'R': 25, 'S': 13, 'T': 13, 'H': 25, 'M': 13}","{'Y': 13, 'A': 13, 'B': 6, 'D': 6, 'E': 6, 'G': 13, 'I': 6, 'K': 13, 'L': 6, 'N': 6, 'O': 6, 'U': 13, 'V': 6, 'W': 6, 'X': 6}"
INV-ZZ-1755206,SCH-ZZ-7925469,ZZ,ZZ20240509BLRDEL4246.0,4246.0,Boeing 777,05/09/2024,2024-05-09 17:54:00,2024-05-10 17:16:00,BLR,DEL,425.0,483,280,-145,203,42,85,127,170,47,27,15,20,95,55,30,40,144,84,43,60,197,114,56,83,"{'F': 25, 'P': 17}","{'C': 34, 'J': 26, 'Z': 26}","{'Q': 38, 'R': 25, 'S': 13, 'T': 13, 'H': 25, 'M': 13}","{'Y': 13, 'A': 13, 'B': 6, 'D': 6, 'E': 6, 'G': 13, 'I': 6, 'K': 13, 'L': 6, 'N': 6, 'O': 6, 'U': 13, 'V': 6, 'W': 6, 'X': 6}"
INV-ZZ-9966214,SCH-ZZ-7925469,ZZ,ZZ20240511BLRDEL4246.0,4246.0,Boeing 777,05/11/2024,2024-05-11 17:54:00,2024-05-12 17:16:00,BLR,DEL,425.0,479,243,-182,236,42,85,127,170,50,25,17,25,99,50,35,49,147,74,53,73,192,97,73,95,"{'F': 25, 'P': 17}","{'C': 34, 'J': 26, 'Z': 26}","{'Q': 38, 'R': 25, 'S': 13, 'T': 13, 'H': 25, 'M': 13}","{'Y': 13, 'A': 13, 'B': 6, 'D': 6, 'E': 6, 'G': 13, 'I': 6, 'K': 13, 'L': 6, 'N': 6, 'O': 6, 'U': 13, 'V': 6, 'W': 6, 'X': 6}"
INV-ZZ-9326711,SCH-ZZ-7925469,ZZ,ZZ20240515BLRDEL4246.0,4246.0,Boeing 777,05/15/2024,2024-05-15 17:54:00,2024-05-16 17:16:00,BLR,DEL,425.0,468,259,-166,209,42,85,127,170,48,27,15,21,97,54,31,43,142,79,48,63,199,110,60,89,"{'F': 25, 'P': 17}","{'C': 34, 'J': 26, 'Z': 26}","{'Q': 38, 'R': 25, 'S': 13, 'T': 13, 'H': 25, 'M': 13}","{'Y': 13, 'A': 13, 'B': 6, 'D': 6, 'E': 6, 'G': 13, 'I': 6, 'K': 13, 'L': 6, 'N': 6, 'O': 6, 'U': 13, 'V': 6, 'W': 6, 'X': 6}"
INV-ZZ-8293607,SCH-ZZ-7925469,ZZ,ZZ20240516BLRDEL4246.0,4246.0,Boeing 777,05/16/2024,2024-05-16 17:54:00,2024-05-17 17:16:00,BLR,DEL,425.0,475,247,-178,228,42,85,127,170,49,25,17,24,101,53,32,48,150,78,49,72,187,97,73,90,"{'F': 25, 'P': 17}","{'C': 34, 'J': 26, 'Z': 26}","{'Q': 38, 'R': 25, 'S': 13, 'T': 13, 'H': 25, 'M': 13}","{'Y': 13, 'A': 13, 'B': 6, 'D': 6, 'E': 6, 'G': 13, 'I': 6, 'K': 13, 'L': 6, 'N': 6, 'O': 6, 'U': 13, 'V': 6, 'W': 6, 'X': 6}"
INV-ZZ-5518523,SCH-ZZ-7925469,ZZ,ZZ20240518BLRDEL4246.0,4246.0,Boeing 777,05/18/2024,2024-05-18 17:54:00,2024-05-19 17:16:00,BLR,DEL,425.0,468,249,-176,219,42,85,127,170,50,27,15,23,101,54,31,47,143,76,51,67,196,104,66,92,"{'F': 25, 'P': 17}","{'C': 34, 'J': 26, 'Z': 26}","{'Q': 38, 'R': 25, 'S': 13, 'T': 13, 'H': 25, 'M': 13}","{'Y': 13, 'A': 13, 'B': 6, 'D': 6, 'E': 6, 'G': 13, 'I': 6, 'K': 13, 'L': 6, 'N': 6, 'O': 6, 'U': 13, 'V': 6, 'W': 6, 'X': 6}"
INV-ZZ-9129417,SCH-ZZ-7925469,ZZ,ZZ20240522BLRDEL4246.0,4246.0,Boeing 777,05/22/2024,2024-05-22 17:54:00,2024-05-23 17:16:00,BLR,DEL,425.0,509,259,-166,250,42,85,127,170,49,25,17,24,98,50,35,48,140,71,56,69,199,101,69,98,"{'F': 25, 'P': 17}","{'C': 34, 'J': 26, 'Z': 26}","{'Q': 38, 'R': 25, 'S': 13, 'T': 13, 'H': 25, 'M': 13}","{'Y': 13, 'A': 13, 'B': 6, 'D': 6, 'E': 6, 'G': 13, 'I': 6, 'K': 13, 'L': 6, 'N': 6, 'O': 6, 'U': 13, 'V': 6, 'W': 6, 'X': 6}"
INV-ZZ-5022740,SCH-ZZ-7925469,ZZ,ZZ20240523BLRDEL4246.0,4246.0,Boeing 777,05/23/2024,2024-05-23 17:54:00,2024-05-24 17:16:00,BLR,DEL,425.0,500,271,-154,229,42,85,127,170,48,26,16,22,97,53,32,44,142,77,50,65,194,105,65,89,"{'F': 25, 'P': 17}","{'C': 34, 'J': 26, 'Z': 26}","{'Q': 38, 'R': 25, 'S': 13, 'T': 13, 'H': 25, 'M': 13}","{'Y': 13, 'A': 13, 'B': 6, 'D': 6, 'E': 6, 'G': 13, 'I': 6, 'K': 13, 'L': 6, 'N': 6, 'O': 6, 'U': 13, 'V': 6, 'W': 6, 'X': 6}"
INV-ZZ-2691598,SCH-ZZ-7925469,ZZ,ZZ20240525BLRDEL4246.0,4246.0,Boeing 777,05/25/2024,2024-05-25 17:54:00,2024-05-26 17:16:00,BLR,DEL,425.0,501,253,-172,248,42,85,127,170,48,24,18,24,96,48,37,48,145,73,54,72,194,98,72,96,"{'F': 25, 'P': 17}","{'C': 34, 'J': 26, 'Z': 26}","{'Q': 38, 'R': 25, 'S': 13, 'T': 13, 'H': 25, 'M': 13}","{'Y': 13, 'A': 13, 'B': 6, 'D': 6, 'E': 6, 'G': 13, 'I': 6, 'K': 13, 'L': 6, 'N': 6, 'O': 6, 'U': 13, 'V': 6, 'W': 6, 'X': 6}"
INV-ZZ-3270044,SCH-ZZ-7925469,ZZ,ZZ20240529BLRDEL4246.0,4246.0,Boeing 777,05/29/2024,2024-05-29 17:54:00,2024-05-30 17:16:00,BLR,DEL,425.0,503,260,-165,243,42,85,127,170,48,25,17,23,98,51,34,47,152,79,48,73,193,100,70,93,"{'F': 25, 'P': 17}","{'C': 34, 'J': 26, 'Z': 26}","{'Q': 38, 'R': 25, 'S': 13, 'T': 13, 'H': 25, 'M': 13}","{'Y': 13, 'A': 13, 'B': 6, 'D': 6, 'E': 6, 'G': 13, 'I': 6, 'K': 13, 'L': 6, 'N': 6, 'O': 6, 'U': 13, 'V': 6, 'W': 6, 'X': 6}"
INV-ZZ-7083071,SCH-ZZ-7925469,ZZ,ZZ20240530BLRDEL4246.0,4246.0,Boeing 777,05/30/2024,2024-05-30 17:54:00,2024-05-31 17:16:00,BLR,DEL,425.0,485,237,-188,248,42,85,127,170,47,23,19,24,94,46,39,48,147,72,55,75,190,93,77,97,"{'F': 25, 'P': 17}","{'C': 34, 'J': 26, 'Z': 26}","{'Q': 38, 'R': 25, 'S': 13, 'T': 13, 'H': 25, 'M': 13}","{'Y': 13, 'A': 13, 'B': 6, 'D': 6, 'E': 6, 'G': 13, 'I': 6, 'K': 13, 'L': 6, 'N': 6, 'O': 6, 'U': 13, 'V': 6, 'W': 6, 'X': 6}"
INV-ZZ-1105949,SCH-ZZ-7925469,ZZ,ZZ20240601BLRDEL4246.0,4246.0,Boeing 777,06/01/2024,2024-06-01 17:54:00,2024-06-02 17:16:00,BLR,DEL,425.0,490,233,-192,257,42,85,127,170,48,23,19,25,101,48,37,53,142,68,59,74,189,90,80,99,"{'F': 25, 'P': 17}","{'C': 34, 'J': 26, 'Z': 26}","{'Q': 38, 'R': 25, 'S': 13, 'T': 13, 'H': 25, 'M': 13}","{'Y': 13, 'A': 13, 'B': 6, 'D': 6, 'E': 6, 'G': 13, 'I': 6, 'K': 13, 'L': 6, 'N': 6, 'O': 6, 'U': 13, 'V': 6, 'W': 6, 'X': 6}"
INV-ZZ-8334407,SCH-ZZ-7925469,ZZ,ZZ20240605BLRDEL4246.0,4246.0,Boeing 777,06/05/2024,2024-06-05 17:54:00,2024-06-06 17:16:00,BLR,DEL,425.0,496,220,-205,276,42,85,127,170,49,22,20,27,94,42,43,52,142,63,64,79,201,89,81,112,"{'F': 25, 'P': 17}","{'C': 34, 'J': 26, 'Z': 26}","{'Q': 38, 'R': 25, 'S': 13, 'T': 13, 'H': 25, 'M': 13}","{'Y': 13, 'A': 13, 'B': 6, 'D': 6, 'E': 6, 'G': 13, 'I': 6, 'K': 13, 'L': 6, 'N': 6, 'O': 6, 'U': 13, 'V': 6, 'W': 6, 'X': 6}"
INV-ZZ-3484859,SCH-ZZ-7925469,ZZ,ZZ20240606BLRDEL4246.0,4246.0,Boeing 777,06/06/2024,2024-06-06 17:54:00,2024-06-07 17:16:00,BLR,DEL,425.0,487,236,-189,251,42,85,127,170,49,24,18,25,99,48,37,51,140,68,59,72,189,91,79,98,"{'F': 25, 'P': 17}","{'C': 34, 'J': 26, 'Z': 26}","{'Q': 38, 'R': 25, 'S': 13, 'T': 13, 'H': 25, 'M': 13}","{'Y': 13, 'A': 13, 'B': 6, 'D': 6, 'E': 6, 'G': 13, 'I': 6, 'K': 13, 'L': 6, 'N': 6, 'O': 6, 'U': 13, 'V': 6, 'W': 6, 'X': 6}"
INV-ZZ-4189052,SCH-ZZ-7925469,ZZ,ZZ20240608BLRDEL4246.0,4246.0,Boeing 777,06/08/2024,2024-06-08 17:54:00,2024-06-09 17:16:00,BLR,DEL,425.0,474,201,-224,273,42,85,127,170,47,20,22,27,99,42,43,57,147,62,65,85,191,81,89,110,"{'F': 25, 'P': 17}","{'C': 34, 'J': 26, 'Z': 26}","{'Q': 38, 'R': 25, 'S': 13, 'T': 13, 'H': 25, 'M': 13}","{'Y': 13, 'A': 13, 'B': 6, 'D': 6, 'E': 6, 'G': 13, 'I': 6, 'K': 13, 'L': 6, 'N': 6, 'O': 6, 'U': 13, 'V': 6, 'W': 6, 'X': 6}"
INV-ZZ-8524605,SCH-ZZ-7925469,ZZ,ZZ20240612BLRDEL4246.0,4246.0,Boeing 777,06/12/2024,2024-06-12 17:54:00,2024-06-13 17:16:00,BLR,DEL,425.0,478,202,-223,276,42,85,127,170,50,21,21,29,100,42,43,58,151,64,63,87,188,79,91,109,"{'F': 25, 'P': 17}","{'C': 34, 'J': 26, 'Z': 26}","{'Q': 38, 'R': 25, 'S': 13, 'T': 13, 'H': 25, 'M': 13}","{'Y': 13, 'A': 13, 'B': 6, 'D': 6, 'E': 6, 'G': 13, 'I': 6, 'K': 13, 'L': 6, 'N': 6, 'O': 6, 'U': 13, 'V': 6, 'W': 6, 'X': 6}"
INV-ZZ-8655579,SCH-ZZ-7925469,ZZ,ZZ20240613BLRDEL4246.0,4246.0,Boeing 777,06/13/2024,2024-06-13 17:54:00,2024-06-14 17:16:00,BLR,DEL,425.0,490,226,-199,264,42,85,127,170,50,23,19,27,99,46,39,53,144,66,61,78,202,93,77,109,"{'F': 25, 'P': 17}","{'C': 34, 'J': 26, 'Z': 26}","{'Q': 38, 'R': 25, 'S': 13, 'T': 13, 'H': 25, 'M': 13}","{'Y': 13, 'A': 13, 'B': 6, 'D': 6, 'E': 6, 'G': 13, 'I': 6, 'K': 13, 'L': 6, 'N': 6, 'O': 6, 'U': 13, 'V': 6, 'W': 6, 'X': 6}"
INV-ZZ-1789366,SCH-ZZ-7925469,ZZ,ZZ20240615BLRDEL4246.0,4246.0,Boeing 777,06/15/2024,2024-06-15 17:54:00,2024-06-16 17:16:00,BLR,DEL,425.0,494,223,-202,271,42,85,127,170,48,22,20,26,95,43,42,52,142,64,63,78,195,88,82,107,"{'F': 25, 'P': 17}","{'C': 34, 'J': 26, 'Z': 26}","{'Q': 38, 'R': 25, 'S': 13, 'T': 13, 'H': 25, 'M': 13}","{'Y': 13, 'A': 13, 'B': 6, 'D': 6, 'E': 6, 'G': 13, 'I': 6, 'K': 13, 'L': 6, 'N': 6, 'O': 6, 'U': 13, 'V': 6, 'W': 6, 'X': 6}"
INV-ZZ-1864124,SCH-ZZ-7925469,ZZ,ZZ20240619BLRDEL4246.0,4246.0,Boeing 777,06/19/2024,2024-06-19 17:54:00,2024-06-20 17:16:00,BLR,DEL,425.0,469,203,-222,266,42,85,127,170,49,21,21,28,98,42,43,56,148,64,63,84,203,88,82,115,"{'F': 25, 'P': 17}","{'C': 34, 'J': 26, 'Z': 26}","{'Q': 38, 'R': 25, 'S': 13, 'T': 13, 'H': 25, 'M': 13}","{'Y': 13, 'A': 13, 'B': 6, 'D': 6, 'E': 6, 'G': 13, 'I': 6, 'K': 13, 'L': 6, 'N': 6, 'O': 6, 'U': 13, 'V': 6, 'W': 6, 'X': 6}"
INV-ZZ-2036984,SCH-ZZ-9040445,ZZ,ZZ20240423CCUBOM3274.0,3274.0,Boeing 717,04/23/2024,2024-04-23 19:38:00,2024-04-24 06:17:00,CCU,BOM,100.0,118,67,-33,51,10,20,30,40,11,6,4,5,23,13,7,10,33,19,11,14,46,26,14,20,"{'F': 6, 'P': 4}","{'C': 8, 'J': 6, 'Z': 6}","{'Q': 9, 'R': 6, 'S': 3, 'T': 3, 'H': 6, 'M': 3}","{'Y': 3, 'A': 3, 'B': 2, 'D': 2, 'E': 2, 'G': 3, 'I': 2, 'K': 3, 'L': 2, 'N': 2, 'O': 2, 'U': 3, 'V': 2, 'W': 2, 'X': 2}"
INV-ZZ-3199841,SCH-ZZ-9040445,ZZ,ZZ20240425CCUBOM3274.0,3274.0,Boeing 717,04/25/2024,2024-04-25 19:38:00,2024-04-26 06:17:00,CCU,BOM,100.0,116,62,-38,54,10,20,30,40,11,6,4,5,23,12,8,11,35,19,11,16,45,24,16,21,"{'F': 6, 'P': 4}","{'C': 8, 'J': 6, 'Z': 6}","{'Q': 9, 'R': 6, 'S': 3, 'T': 3, 'H': 6, 'M': 3}","{'Y': 3, 'A': 3, 'B': 2, 'D': 2, 'E': 2, 'G': 3, 'I': 2, 'K': 3, 'L': 2, 'N': 2, 'O': 2, 'U': 3, 'V': 2, 'W': 2, 'X': 2}"
INV-ZZ-4298296,SCH-ZZ-9040445,ZZ,ZZ20240427CCUBOM3274.0,3274.0,Boeing 717,04/27/2024,2024-04-27 19:38:00,2024-04-28 06:17:00,CCU,BOM,100.0,119,71,-29,48,10,20,30,40,12,7,3,5,22,13,7,9,33,20,10,13,47,28,12,19,"{'F': 6, 'P': 4}","{'C': 8, 'J': 6, 'Z': 6}","{'Q': 9, 'R': 6, 'S': 3, 'T': 3, 'H': 6, 'M': 3}","{'Y': 3, 'A': 3, 'B': 2, 'D': 2, 'E': 2, 'G': 3, 'I': 2, 'K': 3, 'L': 2, 'N': 2, 'O': 2, 'U': 3, 'V': 2, 'W': 2, 'X': 2}"
INV-ZZ-9011705,SCH-ZZ-9040445,ZZ,ZZ20240428CCUBOM3274.0,3274.0,Boeing 717,04/28/2024,2024-04-28 19:38:00,2024-04-29 06:17:00,CCU,BOM,100.0,119,63,-37,56,10,20,30,40,12,6,4,6,24,13,7,11,35,18,12,17,45,24,16,21,"{'F': 6, 'P': 4}","{'C': 8, 'J': 6, 'Z': 6}","{'Q': 9, 'R': 6, 'S': 3, 'T': 3, 'H': 6, 'M': 3}","{'Y': 3, 'A': 3, 'B': 2, 'D': 2, 'E': 2, 'G': 3, 'I': 2, 'K': 3, 'L': 2, 'N': 2, 'O': 2, 'U': 3, 'V': 2, 'W': 2, 'X': 2}"
INV-ZZ-6237431,SCH-ZZ-9040445,ZZ,ZZ20240430CCUBOM3274.0,3274.0,Boeing 717,04/30/2024,2024-04-30 19:38:00,2024-05-01 06:17:00,CCU,BOM,100.0,116,66,-34,50,10,20,30,40,12,7,3,5,24,14,6,10,35,20,10,15,47,27,13,20,"{'F': 6, 'P': 4}","{'C': 8, 'J': 6, 'Z': 6}","{'Q': 9, 'R': 6, 'S': 3, 'T': 3, 'H': 6, 'M': 3}","{'Y': 3, 'A': 3, 'B': 2, 'D': 2, 'E': 2, 'G': 3, 'I': 2, 'K': 3, 'L': 2, 'N': 2, 'O': 2, 'U': 3, 'V': 2, 'W': 2, 'X': 2}"
INV-ZZ-1279111,SCH-ZZ-9040445,ZZ,ZZ20240502CCUBOM3274.0,3274.0,Boeing 717,05/02/2024,2024-05-02 19:38:00,2024-05-03 06:17:00,CCU,BOM,100.0,113,67,-33,46,10,20,30,40,11,7,3,4,24,14,6,10,35,21,9,14,46,27,13,19,"{'F': 6, 'P': 4}","{'C': 8, 'J': 6, 'Z': 6}","{'Q': 9, 'R': 6, 'S': 3, 'T': 3, 'H': 6, 'M': 3}","{'Y': 3, 'A': 3, 'B': 2, 'D': 2, 'E': 2, 'G': 3, 'I': 2, 'K': 3, 'L': 2, 'N': 2, 'O': 2, 'U': 3, 'V': 2, 'W': 2, 'X': 2}"
INV-ZZ-7356218,SCH-ZZ-9040445,ZZ,ZZ20240504CCUBOM3274.0,3274.0,Boeing 717,05/04/2024,2024-05-04 19:38:00,2024-05-05 06:17:00,CCU,BOM,100.0,112,64,-36,48,10,20,30,40,11,6,4,5,23,13,7,10,34,20,10,14,46,26,14,20,"{'F': 6, 'P': 4}","{'C': 8, 'J': 6, 'Z': 6}","{'Q': 9, 'R': 6, 'S': 3, 'T': 3, 'H': 6, 'M': 3}","{'Y': 3, 'A': 3, 'B': 2, 'D': 2, 'E': 2, 'G': 3, 'I': 2, 'K': 3, 'L': 2, 'N': 2, 'O': 2, 'U': 3, 'V': 2, 'W': 2, 'X': 2}"
INV-ZZ-5384642,SCH-ZZ-9040445,ZZ,ZZ20240505CCUBOM3274.0,3274.0,Boeing 717,05/05/2024,2024-05-05 19:38:00,2024-05-06 06:17:00,CCU,BOM,100.0,119,60,-40,59,10,20,30,40,12,6,4,6,23,12,8,11,34,17,13,17,45,23,17,22,"{'F': 6, 'P': 4}","{'C': 8, 'J': 6, 'Z': 6}","{'Q': 9, 'R': 6, 'S': 3, 'T': 3, 'H': 6, 'M': 3}","{'Y': 3, 'A': 3, 'B': 2, 'D': 2, 'E': 2, 'G': 3, 'I': 2, 'K': 3, 'L': 2, 'N': 2, 'O': 2, 'U': 3, 'V': 2, 'W': 2, 'X': 2}"
INV-ZZ-6688844,SCH-ZZ-9040445,ZZ,ZZ20240507CCUBOM3274.0,3274.0,Boeing 717,05/07/2024,2024-05-07 19:38:00,2024-05-08 06:17:00,CCU,BOM,100.0,113,64,-36,49,10,20,30,40,11,6,4,5,24,14,6,10,34,19,11,15,46,26,14,20,"{'F': 6, 'P': 4}","{'C': 8, 'J': 6, 'Z': 6}","{'Q': 9, 'R': 6, 'S': 3, 'T': 3, 'H': 6, 'M': 3}","{'Y': 3, 'A': 3, 'B': 2, 'D': 2, 'E': 2, 'G': 3, 'I': 2, 'K': 3, 'L': 2, 'N': 2, 'O': 2, 'U': 3, 'V': 2, 'W': 2, 'X': 2}"
INV-ZZ-4119542,SCH-ZZ-9040445,ZZ,ZZ20240509CCUBOM3274.0,3274.0,Boeing 717,05/09/2024,2024-05-09 19:38:00,2024-05-10 06:17:00,CCU,BOM,100.0,119,67,-33,52,10,20,30,40,11,6,4,5,22,12,8,10,35,20,10,15,46,26,14,20,"{'F': 6, 'P': 4}","{'C': 8, 'J': 6, 'Z': 6}","{'Q': 9, 'R': 6, 'S': 3, 'T': 3, 'H': 6, 'M': 3}","{'Y': 3, 'A': 3, 'B': 2, 'D': 2, 'E': 2, 'G': 3, 'I': 2, 'K': 3, 'L': 2, 'N': 2, 'O': 2, 'U': 3, 'V': 2, 'W': 2, 'X': 2}"
INV-ZZ-7351435,SCH-ZZ-9040445,ZZ,ZZ20240511CCUBOM3274.0,3274.0,Boeing 717,05/11/2024,2024-05-11 19:38:00,2024-05-12 06:17:00,CCU,BOM,100.0,111,59,-41,52,10,20,30,40,11,6,4,5,24,13,7,11,35,19,11,16,46,25,15,21,"{'F': 6, 'P': 4}","{'C': 8, 'J': 6, 'Z': 6}","{'Q': 9, 'R': 6, 'S': 3, 'T': 3, 'H': 6, 'M': 3}","{'Y': 3, 'A': 3, 'B': 2, 'D': 2, 'E': 2, 'G': 3, 'I': 2, 'K': 3, 'L': 2, 'N': 2, 'O': 2, 'U': 3, 'V': 2, 'W': 2, 'X': 2}"
INV-ZZ-9335492,SCH-ZZ-9040445,ZZ,ZZ20240512CCUBOM3274.0,3274.0,Boeing 717,05/12/2024,2024-05-12 19:38:00,2024-05-13 06:17:00,CCU,BOM,100.0,112,63,-37,49,10,20,30,40,12,7,3,5,23,13,7,10,35,20,10,15,48,27,13,21,"{'F': 6, 'P': 4}","{'C': 8, 'J': 6, 'Z': 6}","{'Q': 9, 'R': 6, 'S': 3, 'T': 3, 'H': 6, 'M': 3}","{'Y': 3, 'A': 3, 'B': 2, 'D': 2, 'E': 2, 'G': 3, 'I': 2, 'K': 3, 'L': 2, 'N': 2, 'O': 2, 'U': 3, 'V': 2, 'W': 2, 'X': 2}"
INV-ZZ-2853561,SCH-ZZ-9040445,ZZ,ZZ20240514CCUBOM3274.0,3274.0,Boeing 717,05/14/2024,2024-05-14 19:38:00,2024-05-15 06:17:00,CCU,BOM,100.0,116,65,-35,51,10,20,30,40,12,7,3,5,22,12,8,10,34,19,11,15,45,25,15,20,"{'F': 6, 'P': 4}","{'C': 8, 'J': 6, 'Z': 6}","{'Q': 9, 'R': 6, 'S': 3, 'T': 3, 'H': 6, 'M': 3}","{'Y': 3, 'A': 3, 'B': 2, 'D': 2, 'E': 2, 'G': 3, 'I': 2, 'K': 3, 'L': 2, 'N': 2, 'O': 2, 'U': 3, 'V': 2, 'W': 2, 'X': 2}"
INV-ZZ-3450901,SCH-ZZ-9040445,ZZ,ZZ20240516CCUBOM3274.0,3274.0,Boeing 717,05/16/2024,2024-05-16 19:38:00,2024-05-17 06:17:00,CCU,BOM,100.0,119,66,-34,53,10,20,30,40,11,6,4,5,23,13,7,10,33,18,12,15,46,26,14,20,"{'F': 6, 'P': 4}","{'C': 8, 'J': 6, 'Z': 6}","{'Q': 9, 'R': 6, 'S': 3, 'T': 3, 'H': 6, 'M': 3}","{'Y': 3, 'A': 3, 'B': 2, 'D': 2, 'E': 2, 'G': 3, 'I': 2, 'K': 3, 'L': 2, 'N': 2, 'O': 2, 'U': 3, 'V': 2, 'W': 2, 'X': 2}"
INV-ZZ-7832297,SCH-ZZ-9040445,ZZ,ZZ20240518CCUBOM3274.0,3274.0,Boeing 717,05/18/2024,2024-05-18 19:38:00,2024-05-19 06:17:00,CCU,BOM,100.0,110,58,-42,52,10,20,30,40,11,6,4,5,23,12,8,11,33,17,13,16,46,24,16,22,"{'F': 6, 'P': 4}","{'C': 8, 'J': 6, 'Z': 6}","{'Q': 9, 'R': 6, 'S': 3, 'T': 3, 'H': 6, 'M': 3}","{'Y': 3, 'A': 3, 'B': 2, 'D': 2, 'E': 2, 'G': 3, 'I': 2, 'K': 3, 'L': 2, 'N': 2, 'O': 2, 'U': 3, 'V': 2, 'W': 2, 'X': 2}"
INV-ZZ-8967903,SCH-ZZ-9040445,ZZ,ZZ20240519CCUBOM3274.0,3274.0,Boeing 717,05/19/2024,2024-05-19 19:38:00,2024-05-20 06:17:00,CCU,BOM,100.0,110,58,-42,52,10,20,30,40,12,6,4,6,23,12,8,11,34,18,12,16,48,25,15,23,"{'F': 6, 'P': 4}","{'C': 8, 'J': 6, 'Z': 6}","{'Q': 9, 'R': 6, 'S': 3, 'T': 3, 'H': 6, 'M': 3}","{'Y': 3, 'A': 3, 'B': 2, 'D': 2, 'E': 2, 'G': 3, 'I': 2, 'K': 3, 'L': 2, 'N': 2, 'O': 2, 'U': 3, 'V': 2, 'W': 2, 'X': 2}"
INV-ZZ-3253326,SCH-ZZ-9040445,ZZ,ZZ20240521CCUBOM3274.0,3274.0,Boeing 717,05/21/2024,2024-05-21 19:38:00,2024-05-22 06:17:00,CCU,BOM,100.0,114,54,-46,60,10,20,30,40,11,5,5,6,23,11,9,12,33,16,14,17,45,21,19,24,"{'F': 6, 'P': 4}","{'C': 8, 'J': 6, 'Z': 6}","{'Q': 9, 'R': 6, 'S': 3, 'T': 3, 'H': 6, 'M': 3}","{'Y': 3, 'A': 3, 'B': 2, 'D': 2, 'E': 2, 'G': 3, 'I': 2, 'K': 3, 'L': 2, 'N': 2, 'O': 2, 'U': 3, 'V': 2, 'W': 2, 'X': 2}"
INV-ZZ-2242889,SCH-ZZ-9040445,ZZ,ZZ20240523CCUBOM3274.0,3274.0,Boeing 717,05/23/2024,2024-05-23 19:38:00,2024-05-24 06:17:00,CCU,BOM,100.0,116,56,-44,60,10,20,30,40,11,5,5,6,23,11,9,12,34,17,13,17,48,23,17,25,"{'F': 6, 'P': 4}","{'C': 8, 'J': 6, 'Z': 6}","{'Q': 9, 'R': 6, 'S': 3, 'T': 3, 'H': 6, 'M': 3}","{'Y': 3, 'A': 3, 'B': 2, 'D': 2, 'E': 2, 'G': 3, 'I': 2, 'K': 3, 'L': 2, 'N': 2, 'O': 2, 'U': 3, 'V': 2, 'W': 2, 'X': 2}"
INV-ZZ-4784527,SCH-ZZ-9040445,ZZ,ZZ20240525CCUBOM3274.0,3274.0,Boeing 717,05/25/2024,2024-05-25 19:38:00,2024-05-26 06:17:00,CCU,BOM,100.0,113,55,-45,58,10,20,30,40,11,5,5,6,22,11,9,11,33,16,14,17,44,22,18,22,"{'F': 6, 'P': 4}","{'C': 8, 'J': 6, 'Z': 6}","{'Q': 9, 'R': 6, 'S': 3, 'T': 3, 'H': 6, 'M': 3}","{'Y': 3, 'A': 3, 'B': 2, 'D': 2, 'E': 2, 'G': 3, 'I': 2, 'K': 3, 'L': 2, 'N': 2, 'O': 2, 'U': 3, 'V': 2, 'W': 2, 'X': 2}"
INV-ZZ-6158208,SCH-ZZ-9040445,ZZ,ZZ20240526CCUBOM3274.0,3274.0,Boeing 717,05/26/2024,2024-05-26 19:38:00,2024-05-27 06:17:00,CCU,BOM,100.0,118,58,-42,60,10,20,30,40,12,6,4,6,22,11,9,11,34,17,13,17,46,23,17,23,"{'F': 6, 'P': 4}","{'C': 8, 'J': 6, 'Z': 6}","{'Q': 9, 'R': 6, 'S': 3, 'T': 3, 'H': 6, 'M': 3}","{'Y': 3, 'A': 3, 'B': 2, 'D': 2, 'E': 2, 'G': 3, 'I': 2, 'K': 3, 'L': 2, 'N': 2, 'O': 2, 'U': 3, 'V': 2, 'W': 2, 'X': 2}"
INV-ZZ-5476649,SCH-ZZ-9040445,ZZ,ZZ20240528CCUBOM3274.0,3274.0,Boeing 717,05/28/2024,2024-05-28 19:38:00,2024-05-29 06:17:00,CCU,BOM,100.0,113,51,-49,62,10,20,30,40,12,5,5,7,23,10,10,13,34,15,15,19,46,21,19,25,"{'F': 6, 'P': 4}","{'C': 8, 'J': 6, 'Z': 6}","{'Q': 9, 'R': 6, 'S': 3, 'T': 3, 'H': 6, 'M': 3}","{'Y': 3, 'A': 3, 'B': 2, 'D': 2, 'E': 2, 'G': 3, 'I': 2, 'K': 3, 'L': 2, 'N': 2, 'O': 2, 'U': 3, 'V': 2, 'W': 2, 'X': 2}"
INV-ZZ-8356979,SCH-ZZ-9040445,ZZ,ZZ20240530CCUBOM3274.0,3274.0,Boeing 717,05/30/2024,2024-05-30 19:38:00,2024-05-31 06:17:00,CCU,BOM,100.0,117,58,-42,59,10,20,30,40,11,5,5,6,23,11,9,12,35,17,13,18,46,23,17,23,"{'F': 6, 'P': 4}","{'C': 8, 'J': 6, 'Z': 6}","{'Q': 9, 'R': 6, 'S': 3, 'T': 3, 'H': 6, 'M': 3}","{'Y': 3, 'A': 3, 'B': 2, 'D': 2, 'E': 2, 'G': 3, 'I': 2, 'K': 3, 'L': 2, 'N': 2, 'O': 2, 'U': 3, 'V': 2, 'W': 2, 'X': 2}"
INV-ZZ-3348114,SCH-ZZ-9040445,ZZ,ZZ20240601CCUBOM3274.0,3274.0,Boeing 717,06/01/2024,2024-06-01 19:38:00,2024-06-02 06:17:00,CCU,BOM,100.0,115,57,-43,58,10,20,30,40,11,5,5,6,24,12,8,12,34,17,13,17,47,23,17,24,"{'F': 6, 'P': 4}","{'C': 8, 'J': 6, 'Z': 6}","{'Q': 9, 'R': 6, 'S': 3, 'T': 3, 'H': 6, 'M': 3}","{'Y': 3, 'A': 3, 'B': 2, 'D': 2, 'E': 2, 'G': 3, 'I': 2, 'K': 3, 'L': 2, 'N': 2, 'O': 2, 'U': 3, 'V': 2, 'W': 2, 'X': 2}"
INV-ZZ-8761929,SCH-ZZ-9040445,ZZ,ZZ20240602CCUBOM3274.0,3274.0,Boeing 717,06/02/2024,2024-06-02 19:38:00,2024-06-03 06:17:00,CCU,BOM,100.0,110,52,-48,58,10,20,30,40,12,6,4,6,23,11,9,12,34,16,14,18,45,21,19,24,"{'F': 6, 'P': 4}","{'C': 8, 'J': 6, 'Z': 6}","{'Q': 9, 'R': 6, 'S': 3, 'T': 3, 'H': 6, 'M': 3}","{'Y': 3, 'A': 3, 'B': 2, 'D': 2, 'E': 2, 'G': 3, 'I': 2, 'K': 3, 'L': 2, 'N': 2, 'O': 2, 'U': 3, 'V': 2, 'W': 2, 'X': 2}"
INV-ZZ-5957500,SCH-ZZ-9040445,ZZ,ZZ20240604CCUBOM3274.0,3274.0,Boeing 717,06/04/2024,2024-06-04 19:38:00,2024-06-05 06:17:00,CCU,BOM,100.0,112,53,-47,59,10,20,30,40,12,6,4,6,22,10,10,12,34,16,14,18,45,21,19,24,"{'F': 6, 'P': 4}","{'C': 8, 'J': 6, 'Z': 6}","{'Q': 9, 'R': 6, 'S': 3, 'T': 3, 'H': 6, 'M': 3}","{'Y': 3, 'A': 3, 'B': 2, 'D': 2, 'E': 2, 'G': 3, 'I': 2, 'K': 3, 'L': 2, 'N': 2, 'O': 2, 'U': 3, 'V': 2, 'W': 2, 'X': 2}"
INV-ZZ-1728551,SCH-ZZ-9040445,ZZ,ZZ20240606CCUBOM3274.0,3274.0,Boeing 717,06/06/2024,2024-06-06 19:38:00,2024-06-07 06:17:00,CCU,BOM,100.0,114,55,-45,59,10,20,30,40,12,6,4,6,24,12,8,12,35,17,13,18,47,23,17,24,"{'F': 6, 'P': 4}","{'C': 8, 'J': 6, 'Z': 6}","{'Q': 9, 'R': 6, 'S': 3, 'T': 3, 'H': 6, 'M': 3}","{'Y': 3, 'A': 3, 'B': 2, 'D': 2, 'E': 2, 'G': 3, 'I': 2, 'K': 3, 'L': 2, 'N': 2, 'O': 2, 'U': 3, 'V': 2, 'W': 2, 'X': 2}"
INV-ZZ-9632506,SCH-ZZ-2045025,ZZ,ZZ20240507DELAMD2973.0,2973.0,Boeing 717,05/07/2024,2024-05-07 07:12:00,2024-05-08 04:27:00,DEL,AMD,100.0,113,64,-36,49,10,20,30,40,11,6,4,5,22,12,8,10,34,19,11,15,45,25,15,20,"{'F': 6, 'P': 4}","{'C': 8, 'J': 6, 'Z': 6}","{'Q': 9, 'R': 6, 'S': 3, 'T': 3, 'H': 6, 'M': 3}","{'Y': 3, 'A': 3, 'B': 2, 'D': 2, 'E': 2, 'G': 3, 'I': 2, 'K': 3, 'L': 2, 'N': 2, 'O': 2, 'U': 3, 'V': 2, 'W': 2, 'X': 2}"
INV-ZZ-1943176,SCH-ZZ-2045025,ZZ,ZZ20240508DELAMD2973.0,2973.0,Boeing 717,05/08/2024,2024-05-08 07:12:00,2024-05-09 04:27:00,DEL,AMD,100.0,115,64,-36,51,10,20,30,40,11,6,4,5,23,13,7,10,34,19,11,15,46,25,15,21,"{'F': 6, 'P': 4}","{'C': 8, 'J': 6, 'Z': 6}","{'Q': 9, 'R': 6, 'S': 3, 'T': 3, 'H': 6, 'M': 3}","{'Y': 3, 'A': 3, 'B': 2, 'D': 2, 'E': 2, 'G': 3, 'I': 2, 'K': 3, 'L': 2, 'N': 2, 'O': 2, 'U': 3, 'V': 2, 'W': 2, 'X': 2}"
INV-ZZ-3453231,SCH-ZZ-2045025,ZZ,ZZ20240509DELAMD2973.0,2973.0,Boeing 717,05/09/2024,2024-05-09 07:12:00,2024-05-10 04:27:00,DEL,AMD,100.0,113,56,-44,57,10,20,30,40,12,6,4,6,23,11,9,12,35,17,13,18,45,22,18,23,"{'F': 6, 'P': 4}","{'C': 8, 'J': 6, 'Z': 6}","{'Q': 9, 'R': 6, 'S': 3, 'T': 3, 'H': 6, 'M': 3}","{'Y': 3, 'A': 3, 'B': 2, 'D': 2, 'E': 2, 'G': 3, 'I': 2, 'K': 3, 'L': 2, 'N': 2, 'O': 2, 'U': 3, 'V': 2, 'W': 2, 'X': 2}"
INV-ZZ-8150673,SCH-ZZ-2045025,ZZ,ZZ20240510DELAMD2973.0,2973.0,Boeing 717,05/10/2024,2024-05-10 07:12:00,2024-05-11 04:27:00,DEL,AMD,100.0,114,60,-40,54,10,20,30,40,11,6,4,5,24,13,7,11,35,18,12,17,47,25,15,22,"{'F': 6, 'P': 4}","{'C': 8, 'J': 6, 'Z': 6}","{'Q': 9, 'R': 6, 'S': 3, 'T': 3, 'H': 6, 'M': 3}","{'Y': 3, 'A': 3, 'B': 2, 'D': 2, 'E': 2, 'G': 3, 'I': 2, 'K': 3, 'L': 2, 'N': 2, 'O': 2, 'U': 3, 'V': 2, 'W': 2, 'X': 2}"
INV-ZZ-2804628,SCH-ZZ-2045025,ZZ,ZZ20240513DELAMD2973.0,2973.0,Boeing 717,05/13/2024,2024-05-13 07:12:00,2024-05-14 04:27:00,DEL,AMD,100.0,115,62,-38,53,10,20,30,40,11,6,4,5,23,12,8,11,33,18,12,15,45,24,16,21,"{'F': 6, 'P': 4}","{'C': 8, 'J': 6, 'Z': 6}","{'Q': 9, 'R': 6, 'S': 3, 'T': 3, 'H': 6, 'M': 3}","{'Y': 3, 'A': 3, 'B': 2, 'D': 2, 'E': 2, 'G': 3, 'I': 2, 'K': 3, 'L': 2, 'N': 2, 'O': 2, 'U': 3, 'V': 2, 'W': 2, 'X': 2}"
INV-ZZ-3768094,SCH-ZZ-2045025,ZZ,ZZ20240514DELAMD2973.0,2973.0,Boeing 717,05/14/2024,2024-05-14 07:12:00,2024-05-15 04:27:00,DEL,AMD,100.0,112,63,-37,49,10,20,30,40,11,6,4,5,23,13,7,10,35,20,10,15,45,25,15,20,"{'F': 6, 'P': 4}","{'C': 8, 'J': 6, 'Z': 6}","{'Q': 9, 'R': 6, 'S': 3, 'T': 3, 'H': 6, 'M': 3}","{'Y': 3, 'A': 3, 'B': 2, 'D': 2, 'E': 2, 'G': 3, 'I': 2, 'K': 3, 'L': 2, 'N': 2, 'O': 2, 'U': 3, 'V': 2, 'W': 2, 'X': 2}"
INV-ZZ-2499413,SCH-ZZ-2045025,ZZ,ZZ20240515DELAMD2973.0,2973.0,Boeing 717,05/15/2024,2024-05-15 07:12:00,2024-05-16 04:27:00,DEL,AMD,100.0,114,59,-41,55,10,20,30,40,12,6,4,6,22,11,9,11,34,18,12,16,45,23,17,22,"{'F': 6, 'P': 4}","{'C': 8, 'J': 6, 'Z': 6}","{'Q': 9, 'R': 6, 'S': 3, 'T': 3, 'H': 6, 'M': 3}","{'Y': 3, 'A': 3, 'B': 2, 'D': 2, 'E': 2, 'G': 3, 'I': 2, 'K': 3, 'L': 2, 'N': 2, 'O': 2, 'U': 3, 'V': 2, 'W': 2, 'X': 2}"
INV-ZZ-2157553,SCH-ZZ-2045025,ZZ,ZZ20240516DELAMD2973.0,2973.0,Boeing 717,05/16/2024,2024-05-16 07:12:00,2024-05-17 04:27:00,DEL,AMD,100.0,112,56,-44,56,10,20,30,40,11,5,5,6,24,12,8,12,34,17,13,17,47,23,17,24,"{'F': 6, 'P': 4}","{'C': 8, 'J': 6, 'Z': 6}","{'Q': 9, 'R': 6, 'S': 3, 'T': 3, 'H': 6, 'M': 3}","{'Y': 3, 'A': 3, 'B': 2, 'D': 2, 'E': 2, 'G': 3, 'I': 2, 'K': 3, 'L': 2, 'N': 2, 'O': 2, 'U': 3, 'V': 2, 'W': 2, 'X': 2}"
INV-ZZ-6350907,SCH-ZZ-2045025,ZZ,ZZ20240517DELAMD2973.0,2973.0,Boeing 717,05/17/2024,2024-05-17 07:12:00,2024-05-18 04:27:00,DEL,AMD,100.0,119,57,-43,62,10,20,30,40,12,6,4,6,24,11,9,13,34,16,14,18,45,22,18,23,"{'F': 6, 'P': 4}","{'C': 8, 'J': 6, 'Z': 6}","{'Q': 9, 'R': 6, 'S': 3, 'T': 3, 'H': 6, 'M': 3}","{'Y': 3, 'A': 3, 'B': 2, 'D': 2, 'E': 2, 'G': 3, 'I': 2, 'K': 3, 'L': 2, 'N': 2, 'O': 2, 'U': 3, 'V': 2, 'W': 2, 'X': 2}"
INV-ZZ-1763425,SCH-ZZ-2045025,ZZ,ZZ20240520DELAMD2973.0,2973.0,Boeing 717,05/20/2024,2024-05-20 07:12:00,2024-05-21 04:27:00,DEL,AMD,100.0,112,56,-44,56,10,20,30,40,12,6,4,6,23,12,8,11,36,18,12,18,44,22,18,22,"{'F': 6, 'P': 4}","{'C': 8, 'J': 6, 'Z': 6}","{'Q': 9, 'R': 6, 'S': 3, 'T': 3, 'H': 6, 'M': 3}","{'Y': 3, 'A': 3, 'B': 2, 'D': 2, 'E': 2, 'G': 3, 'I': 2, 'K': 3, 'L': 2, 'N': 2, 'O': 2, 'U': 3, 'V': 2, 'W': 2, 'X': 2}"
INV-ZZ-3305796,SCH-ZZ-2045025,ZZ,ZZ20240521DELAMD2973.0,2973.0,Boeing 717,05/21/2024,2024-05-21 07:12:00,2024-05-22 04:27:00,DEL,AMD,100.0,116,63,-37,53,10,20,30,40,11,6,4,5,24,13,7,11,34,18,12,16,46,25,15,21,"{'F': 6, 'P': 4}","{'C': 8, 'J': 6, 'Z': 6}","{'Q': 9, 'R': 6, 'S': 3, 'T': 3, 'H': 6, 'M': 3}","{'Y': 3, 'A': 3, 'B': 2, 'D': 2, 'E': 2, 'G': 3, 'I': 2, 'K': 3, 'L': 2, 'N': 2, 'O': 2, 'U': 3, 'V': 2, 'W': 2, 'X': 2}"
INV-ZZ-5973846,SCH-ZZ-2045025,ZZ,ZZ20240522DELAMD2973.0,2973.0,Boeing 717,05/22/2024,2024-05-22 07:12:00,2024-05-23 04:27:00,DEL,AMD,100.0,118,57,-43,61,10,20,30,40,11,5,5,6,23,11,9,12,36,17,13,19,47,23,17,24,"{'F': 6, 'P': 4}","{'C': 8, 'J': 6, 'Z': 6}","{'Q': 9, 'R': 6, 'S': 3, 'T': 3, 'H': 6, 'M': 3}","{'Y': 3, 'A': 3, 'B': 2, 'D': 2, 'E': 2, 'G': 3, 'I': 2, 'K': 3, 'L': 2, 'N': 2, 'O': 2, 'U': 3, 'V': 2, 'W': 2, 'X': 2}"
INV-ZZ-8143122,SCH-ZZ-2045025,ZZ,ZZ20240523DELAMD2973.0,2973.0,Boeing 717,05/23/2024,2024-05-23 07:12:00,2024-05-24 04:27:00,DEL,AMD,100.0,111,53,-47,58,10,20,30,40,12,6,4,6,24,12,8,12,35,17,13,18,45,22,18,23,"{'F': 6, 'P': 4}","{'C': 8, 'J': 6, 'Z': 6}","{'Q': 9, 'R': 6, 'S': 3, 'T': 3, 'H': 6, 'M': 3}","{'Y': 3, 'A': 3, 'B': 2, 'D': 2, 'E': 2, 'G': 3, 'I': 2, 'K': 3, 'L': 2, 'N': 2, 'O': 2, 'U': 3, 'V': 2, 'W': 2, 'X': 2}"
INV-ZZ-7734571,SCH-ZZ-2045025,ZZ,ZZ20240524DELAMD2973.0,2973.0,Boeing 717,05/24/2024,2024-05-24 07:12:00,2024-05-25 04:27:00,DEL,AMD,100.0,114,58,-42,56,10,20,30,40,11,6,4,5,22,11,9,11,34,17,13,17,45,23,17,22,"{'F': 6, 'P': 4}","{'C': 8, 'J': 6, 'Z': 6}","{'Q': 9, 'R': 6, 'S': 3, 'T': 3, 'H': 6, 'M': 3}","{'Y': 3, 'A': 3, 'B': 2, 'D': 2, 'E': 2, 'G': 3, 'I': 2, 'K': 3, 'L': 2, 'N': 2, 'O': 2, 'U': 3, 'V': 2, 'W': 2, 'X': 2}"
INV-ZZ-8567544,SCH-ZZ-2045025,ZZ,ZZ20240527DELAMD2973.0,2973.0,Boeing 717,05/27/2024,2024-05-27 07:12:00,2024-05-28 04:27:00,DEL,AMD,100.0,112,57,-43,55,10,20,30,40,12,6,4,6,23,12,8,11,36,18,12,18,47,24,16,23,"{'F': 6, 'P': 4}","{'C': 8, 'J': 6, 'Z': 6}","{'Q': 9, 'R': 6, 'S': 3, 'T': 3, 'H': 6, 'M': 3}","{'Y': 3, 'A': 3, 'B': 2, 'D': 2, 'E': 2, 'G': 3, 'I': 2, 'K': 3, 'L': 2, 'N': 2, 'O': 2, 'U': 3, 'V': 2, 'W': 2, 'X': 2}"
INV-ZZ-3917300,SCH-ZZ-2045025,ZZ,ZZ20240528DELAMD2973.0,2973.0,Boeing 717,05/28/2024,2024-05-28 07:12:00,2024-05-29 04:27:00,DEL,AMD,100.0,118,61,-39,57,10,20,30,40,12,6,4,6,24,12,8,12,33,17,13,16,46,24,16,22,"{'F': 6, 'P': 4}","{'C': 8, 'J': 6, 'Z': 6}","{'Q': 9, 'R': 6, 'S': 3, 'T': 3, 'H': 6, 'M': 3}","{'Y': 3, 'A': 3, 'B': 2, 'D': 2, 'E': 2, 'G': 3, 'I': 2, 'K': 3, 'L': 2, 'N': 2, 'O': 2, 'U': 3, 'V': 2, 'W': 2, 'X': 2}"
INV-ZZ-7630666,SCH-ZZ-2045025,ZZ,ZZ20240529DELAMD2973.0,2973.0,Boeing 717,05/29/2024,2024-05-29 07:12:00,2024-05-30 04:27:00,DEL,AMD,100.0,116,54,-46,62,10,20,30,40,12,6,4,6,22,10,10,12,35,16,14,19,48,22,18,26,"{'F': 6, 'P': 4}","{'C': 8, 'J': 6, 'Z': 6}","{'Q': 9, 'R': 6, 'S': 3, 'T': 3, 'H': 6, 'M': 3}","{'Y': 3, 'A': 3, 'B': 2, 'D': 2, 'E': 2, 'G': 3, 'I': 2, 'K': 3, 'L': 2, 'N': 2, 'O': 2, 'U': 3, 'V': 2, 'W': 2, 'X': 2}"
INV-ZZ-6114706,SCH-ZZ-2045025,ZZ,ZZ20240530DELAMD2973.0,2973.0,Boeing 717,05/30/2024,2024-05-30 07:12:00,2024-05-31 04:27:00,DEL,AMD,100.0,119,54,-46,65,10,20,30,40,12,5,5,7,24,11,9,13,35,16,14,19,45,21,19,24,"{'F': 6, 'P': 4}","{'C': 8, 'J': 6, 'Z': 6}","{'Q': 9, 'R': 6, 'S': 3, 'T': 3, 'H': 6, 'M': 3}","{'Y': 3, 'A': 3, 'B': 2, 'D': 2, 'E': 2, 'G': 3, 'I': 2, 'K': 3, 'L': 2, 'N': 2, 'O': 2, 'U': 3, 'V': 2, 'W': 2, 'X': 2}"
INV-ZZ-5846222,SCH-ZZ-2045025,ZZ,ZZ20240531DELAMD2973.0,2973.0,Boeing 717,05/31/2024,2024-05-31 07:12:00,2024-06-01 04:27:00,DEL,AMD,100.0,114,51,-49,63,10,20,30,40,12,5,5,7,23,10,10,13,36,16,14,20,47,21,19,26,"{'F': 6, 'P': 4}","{'C': 8, 'J': 6, 'Z': 6}","{'Q': 9, 'R': 6, 'S': 3, 'T': 3, 'H': 6, 'M': 3}","{'Y': 3, 'A': 3, 'B': 2, 'D': 2, 'E': 2, 'G': 3, 'I': 2, 'K': 3, 'L': 2, 'N': 2, 'O': 2, 'U': 3, 'V': 2, 'W': 2, 'X': 2}"
INV-ZZ-5154629,SCH-ZZ-2045025,ZZ,ZZ20240603DELAMD2973.0,2973.0,Boeing 717,06/03/2024,2024-06-03 07:12:00,2024-06-04 04:27:00,DEL,AMD,100.0,110,50,-50,60,10,20,30,40,11,5,5,6,23,10,10,13,35,16,14,19,46,21,19,25,"{'F': 6, 'P': 4}","{'C': 8, 'J': 6, 'Z': 6}","{'Q': 9, 'R': 6, 'S': 3, 'T': 3, 'H': 6, 'M': 3}","{'Y': 3, 'A': 3, 'B': 2, 'D': 2, 'E': 2, 'G': 3, 'I': 2, 'K': 3, 'L': 2, 'N': 2, 'O': 2, 'U': 3, 'V': 2, 'W': 2, 'X': 2}"
INV-ZZ-9341020,SCH-ZZ-2045025,ZZ,ZZ20240604DELAMD2973.0,2973.0,Boeing 717,06/04/2024,2024-06-04 07:12:00,2024-06-05 04:27:00,DEL,AMD,100.0,110,50,-50,60,10,20,30,40,11,5,5,6,23,10,10,13,35,16,14,19,47,21,19,26,"{'F': 6, 'P': 4}","{'C': 8, 'J': 6, 'Z': 6}","{'Q': 9, 'R': 6, 'S': 3, 'T': 3, 'H': 6, 'M': 3}","{'Y': 3, 'A': 3, 'B': 2, 'D': 2, 'E': 2, 'G': 3, 'I': 2, 'K': 3, 'L': 2, 'N': 2, 'O': 2, 'U': 3, 'V': 2, 'W': 2, 'X': 2}"
INV-ZZ-1328481,SCH-ZZ-2045025,ZZ,ZZ20240605DELAMD2973.0,2973.0,Boeing 717,06/05/2024,2024-06-05 07:12:00,2024-06-06 04:27:00,DEL,AMD,100.0,115,57,-43,58,10,20,30,40,12,6,4,6,22,11,9,11,34,17,13,17,44,22,18,22,"{'F': 6, 'P': 4}","{'C': 8, 'J': 6, 'Z': 6}","{'Q': 9, 'R': 6, 'S': 3, 'T': 3, 'H': 6, 'M': 3}","{'Y': 3, 'A': 3, 'B': 2, 'D': 2, 'E': 2, 'G': 3, 'I': 2, 'K': 3, 'L': 2, 'N': 2, 'O': 2, 'U': 3, 'V': 2, 'W': 2, 'X': 2}"
INV-ZZ-1322767,SCH-ZZ-2045025,ZZ,ZZ20240606DELAMD2973.0,2973.0,Boeing 717,06/06/2024,2024-06-06 07:12:00,2024-06-07 04:27:00,DEL,AMD,100.0,116,52,-48,64,10,20,30,40,12,5,5,7,24,11,9,13,34,15,15,19,46,21,19,25,"{'F': 6, 'P': 4}","{'C': 8, 'J': 6, 'Z': 6}","{'Q': 9, 'R': 6, 'S': 3, 'T': 3, 'H': 6, 'M': 3}","{'Y': 3, 'A': 3, 'B': 2, 'D': 2, 'E': 2, 'G': 3, 'I': 2, 'K': 3, 'L': 2, 'N': 2, 'O': 2, 'U': 3, 'V': 2, 'W': 2, 'X': 2}"
INV-ZZ-4076298,SCH-ZZ-2045025,ZZ,ZZ20240607DELAMD2973.0,2973.0,Boeing 717,06/07/2024,2024-06-07 07:12:00,2024-06-08 04:27:00,DEL,AMD,100.0,113,49,-51,64,10,20,30,40,12,5,5,7,24,10,10,14,35,15,15,20,47,20,20,27,"{'F': 6, 'P': 4}","{'C': 8, 'J': 6, 'Z': 6}","{'Q': 9, 'R': 6, 'S': 3, 'T': 3, 'H': 6, 'M': 3}","{'Y': 3, 'A': 3, 'B': 2, 'D': 2, 'E': 2, 'G': 3, 'I': 2, 'K': 3, 'L': 2, 'N': 2, 'O': 2, 'U': 3, 'V': 2, 'W': 2, 'X': 2}"
INV-ZZ-2798431,SCH-ZZ-2045025,ZZ,ZZ20240610DELAMD2973.0,2973.0,Boeing 717,06/10/2024,2024-06-10 07:12:00,2024-06-11 04:27:00,DEL,AMD,100.0,115,50,-50,65,10,20,30,40,12,5,5,7,23,10,10,13,34,15,15,19,46,20,20,26,"{'F': 6, 'P': 4}","{'C': 8, 'J': 6, 'Z': 6}","{'Q': 9, 'R': 6, 'S': 3, 'T': 3, 'H': 6, 'M': 3}","{'Y': 3, 'A': 3, 'B': 2, 'D': 2, 'E': 2, 'G': 3, 'I': 2, 'K': 3, 'L': 2, 'N': 2, 'O': 2, 'U': 3, 'V': 2, 'W': 2, 'X': 2}"
INV-ZZ-3669360,SCH-ZZ-2045025,ZZ,ZZ20240611DELAMD2973.0,2973.0,Boeing 717,06/11/2024,2024-06-11 07:12:00,2024-06-12 04:27:00,DEL,AMD,100.0,116,53,-47,63,10,20,30,40,11,5,5,6,23,11,9,12,33,15,15,18,47,22,18,25,"{'F': 6, 'P': 4}","{'C': 8, 'J': 6, 'Z': 6}","{'Q': 9, 'R': 6, 'S': 3, 'T': 3, 'H': 6, 'M': 3}","{'Y': 3, 'A': 3, 'B': 2, 'D': 2, 'E': 2, 'G': 3, 'I': 2, 'K': 3, 'L': 2, 'N': 2, 'O': 2, 'U': 3, 'V': 2, 'W': 2, 'X': 2}"
INV-ZZ-7605113,SCH-ZZ-2045025,ZZ,ZZ20240612DELAMD2973.0,2973.0,Boeing 717,06/12/2024,2024-06-12 07:12:00,2024-06-13 04:27:00,DEL,AMD,100.0,119,52,-48,67,10,20,30,40,12,5,5,7,23,10,10,13,33,14,16,19,45,20,20,25,"{'F': 6, 'P': 4}","{'C': 8, 'J': 6, 'Z': 6}","{'Q': 9, 'R': 6, 'S': 3, 'T': 3, 'H': 6, 'M': 3}","{'Y': 3, 'A': 3, 'B': 2, 'D': 2, 'E': 2, 'G': 3, 'I': 2, 'K': 3, 'L': 2, 'N': 2, 'O': 2, 'U': 3, 'V': 2, 'W': 2, 'X': 2}"
INV-ZZ-3443796,SCH-ZZ-2045025,ZZ,ZZ20240613DELAMD2973.0,2973.0,Boeing 717,06/13/2024,2024-06-13 07:12:00,2024-06-14 04:27:00,DEL,AMD,100.0,116,50,-50,66,10,20,30,40,12,5,5,7,22,10,10,12,34,15,15,19,45,20,20,25,"{'F': 6, 'P': 4}","{'C': 8, 'J': 6, 'Z': 6}","{'Q': 9, 'R': 6, 'S': 3, 'T': 3, 'H': 6, 'M': 3}","{'Y': 3, 'A': 3, 'B': 2, 'D': 2, 'E': 2, 'G': 3, 'I': 2, 'K': 3, 'L': 2, 'N': 2, 'O': 2, 'U': 3, 'V': 2, 'W': 2, 'X': 2}"
INV-ZZ-3121584,SCH-ZZ-2045025,ZZ,ZZ20240614DELAMD2973.0,2973.0,Boeing 717,06/14/2024,2024-06-14 07:12:00,2024-06-15 04:27:00,DEL,AMD,100.0,114,55,-45,59,10,20,30,40,12,6,4,6,23,11,9,12,35,17,13,18,46,22,18,24,"{'F': 6, 'P': 4}","{'C': 8, 'J': 6, 'Z': 6}","{'Q': 9, 'R': 6, 'S': 3, 'T': 3, 'H': 6, 'M': 3}","{'Y': 3, 'A': 3, 'B': 2, 'D': 2, 'E': 2, 'G': 3, 'I': 2, 'K': 3, 'L': 2, 'N': 2, 'O': 2, 'U': 3, 'V': 2, 'W': 2, 'X': 2}"
INV-ZZ-1761593,SCH-ZZ-2045025,ZZ,ZZ20240617DELAMD2973.0,2973.0,Boeing 717,06/17/2024,2024-06-17 07:12:00,2024-06-18 04:27:00,DEL,AMD,100.0,112,46,-54,66,10,20,30,40,11,5,5,6,22,9,11,13,36,15,15,21,46,19,21,27,"{'F': 6, 'P': 4}","{'C': 8, 'J': 6, 'Z': 6}","{'Q': 9, 'R': 6, 'S': 3, 'T': 3, 'H': 6, 'M': 3}","{'Y': 3, 'A': 3, 'B': 2, 'D': 2, 'E': 2, 'G': 3, 'I': 2, 'K': 3, 'L': 2, 'N': 2, 'O': 2, 'U': 3, 'V': 2, 'W': 2, 'X': 2}"
INV-ZZ-8062861,SCH-ZZ-2045025,ZZ,ZZ20240618DELAMD2973.0,2973.0,Boeing 717,06/18/2024,2024-06-18 07:12:00,2024-06-19 04:27:00,DEL,AMD,100.0,116,50,-50,66,10,20,30,40,12,5,5,7,23,10,10,13,36,16,14,20,46,20,20,26,"{'F': 6, 'P': 4}","{'C': 8, 'J': 6, 'Z': 6}","{'Q': 9, 'R': 6, 'S': 3, 'T': 3, 'H': 6, 'M': 3}","{'Y': 3, 'A': 3, 'B': 2, 'D': 2, 'E': 2, 'G': 3, 'I': 2, 'K': 3, 'L': 2, 'N': 2, 'O': 2, 'U': 3, 'V': 2, 'W': 2, 'X': 2}"
INV-ZZ-9800411,SCH-ZZ-2045025,ZZ,ZZ20240619DELAMD2973.0,2973.0,Boeing 717,06/19/2024,2024-06-19 07:12:00,2024-06-20 04:27:00,DEL,AMD,100.0,117,52,-48,65,10,20,30,40,11,5,5,6,22,10,10,12,35,15,15,20,45,20,20,25,"{'F': 6, 'P': 4}","{'C': 8, 'J': 6, 'Z': 6}","{'Q': 9, 'R': 6, 'S': 3, 'T': 3, 'H': 6, 'M': 3}","{'Y': 3, 'A': 3, 'B': 2, 'D': 2, 'E': 2, 'G': 3, 'I': 2, 'K': 3, 'L': 2, 'N': 2, 'O': 2, 'U': 3, 'V': 2, 'W': 2, 'X': 2}"
INV-ZZ-4482441,SCH-ZZ-2045025,ZZ,ZZ20240620DELAMD2973.0,2973.0,Boeing 717,06/20/2024,2024-06-20 07:12:00,2024-06-21 04:27:00,DEL,AMD,100.0,113,51,-49,62,10,20,30,40,12,5,5,7,22,10,10,12,35,16,14,19,44,20,20,24,"{'F': 6, 'P': 4}","{'C': 8, 'J': 6, 'Z': 6}","{'Q': 9, 'R': 6, 'S': 3, 'T': 3, 'H': 6, 'M': 3}","{'Y': 3, 'A': 3, 'B': 2, 'D': 2, 'E': 2, 'G': 3, 'I': 2, 'K': 3, 'L': 2, 'N': 2, 'O': 2, 'U': 3, 'V': 2, 'W': 2, 'X': 2}"
INV-ZZ-5113110,SCH-ZZ-2045025,ZZ,ZZ20240621DELAMD2973.0,2973.0,Boeing 717,06/21/2024,2024-06-21 07:12:00,2024-06-22 04:27:00,DEL,AMD,100.0,117,51,-49,66,10,20,30,40,11,5,5,6,23,10,10,13,35,15,15,20,46,20,20,26,"{'F': 6, 'P': 4}","{'C': 8, 'J': 6, 'Z': 6}","{'Q': 9, 'R': 6, 'S': 3, 'T': 3, 'H': 6, 'M': 3}","{'Y': 3, 'A': 3, 'B': 2, 'D': 2, 'E': 2, 'G': 3, 'I': 2, 'K': 3, 'L': 2, 'N': 2, 'O': 2, 'U': 3, 'V': 2, 'W': 2, 'X': 2}"
INV-ZZ-4068368,SCH-ZZ-8013583,ZZ,ZZ20240425BLRBOM2024.0,2024.0,Boeing 777-300,04/25/2024,2024-04-25 14:01:00,2024-04-26 11:07:00,BLR,BOM,360.0,415,237,-123,178,36,72,108,144,42,24,12,18,84,48,24,36,126,72,36,54,172,98,46,74,"{'F': 22, 'P': 14}","{'C': 29, 'J': 22, 'Z': 22}","{'Q': 32, 'R': 22, 'S': 11, 'T': 11, 'H': 22, 'M': 11}","{'Y': 11, 'A': 11, 'B': 5, 'D': 5, 'E': 5, 'G': 11, 'I': 5, 'K': 11, 'L': 5, 'N': 5, 'O': 5, 'U': 11, 'V': 5, 'W': 5, 'X': 5}"
INV-ZZ-2917373,SCH-ZZ-8013583,ZZ,ZZ20240427BLRBOM2024.0,2024.0,Boeing 777-300,04/27/2024,2024-04-27 14:01:00,2024-04-28 11:07:00,BLR,BOM,360.0,424,240,-120,184,36,72,108,144,40,23,13,17,84,48,24,36,128,73,35,55,168,95,49,73,"{'F': 22, 'P': 14}","{'C': 29, 'J': 22, 'Z': 22}","{'Q': 32, 'R': 22, 'S': 11, 'T': 11, 'H': 22, 'M': 11}","{'Y': 11, 'A': 11, 'B': 5, 'D': 5, 'E': 5, 'G': 11, 'I': 5, 'K': 11, 'L': 5, 'N': 5, 'O': 5, 'U': 11, 'V': 5, 'W': 5, 'X': 5}"
INV-ZZ-1845516,SCH-ZZ-8013583,ZZ,ZZ20240428BLRBOM2024.0,2024.0,Boeing 777-300,04/28/2024,2024-04-28 14:01:00,2024-04-29 11:07:00,BLR,BOM,360.0,412,216,-144,196,36,72,108,144,41,21,15,20,86,45,27,41,122,64,44,58,167,87,57,80,"{'F': 22, 'P': 14}","{'C': 29, 'J': 22, 'Z': 22}","{'Q': 32, 'R': 22, 'S': 11, 'T': 11, 'H': 22, 'M': 11}","{'Y': 11, 'A': 11, 'B': 5, 'D': 5, 'E': 5, 'G': 11, 'I': 5, 'K': 11, 'L': 5, 'N': 5, 'O': 5, 'U': 11, 'V': 5, 'W': 5, 'X': 5}"
INV-ZZ-8748106,SCH-ZZ-8013583,ZZ,ZZ20240502BLRBOM2024.0,2024.0,Boeing 777-300,05/02/2024,2024-05-02 14:01:00,2024-05-03 11:07:00,BLR,BOM,360.0,406,225,-135,181,36,72,108,144,41,23,13,18,82,46,26,36,121,67,41,54,172,95,49,77,"{'F': 22, 'P': 14}","{'C': 29, 'J': 22, 'Z': 22}","{'Q': 32, 'R': 22, 'S': 11, 'T': 11, 'H': 22, 'M': 11}","{'Y': 11, 'A': 11, 'B': 5, 'D': 5, 'E': 5, 'G': 11, 'I': 5, 'K': 11, 'L': 5, 'N': 5, 'O': 5, 'U': 11, 'V': 5, 'W': 5, 'X': 5}"
INV-ZZ-1646777,SCH-ZZ-8013583,ZZ,ZZ20240504BLRBOM2024.0,2024.0,Boeing 777-300,05/04/2024,2024-05-04 14:01:00,2024-05-05 11:07:00,BLR,BOM,360.0,422,225,-135,197,36,72,108,144,40,21,15,19,85,45,27,40,122,65,43,57,162,86,58,76,"{'F': 22, 'P': 14}","{'C': 29, 'J': 22, 'Z': 22}","{'Q': 32, 'R': 22, 'S': 11, 'T': 11, 'H': 22, 'M': 11}","{'Y': 11, 'A': 11, 'B': 5, 'D': 5, 'E': 5, 'G': 11, 'I': 5, 'K': 11, 'L': 5, 'N': 5, 'O': 5, 'U': 11, 'V': 5, 'W': 5, 'X': 5}"
INV-ZZ-9219423,SCH-ZZ-8013583,ZZ,ZZ20240505BLRBOM2024.0,2024.0,Boeing 777-300,05/05/2024,2024-05-05 14:01:00,2024-05-06 11:07:00,BLR,BOM,360.0,407,215,-145,192,36,72,108,144,43,23,13,20,82,43,29,39,127,67,41,60,161,85,59,76,"{'F': 22, 'P': 14}","{'C': 29, 'J': 22, 'Z': 22}","{'Q': 32, 'R': 22, 'S': 11, 'T': 11, 'H': 22, 'M': 11}","{'Y': 11, 'A': 11, 'B': 5, 'D': 5, 'E': 5, 'G': 11, 'I': 5, 'K': 11, 'L': 5, 'N': 5, 'O': 5, 'U': 11, 'V': 5, 'W': 5, 'X': 5}"
INV-ZZ-3968376,SCH-ZZ-8013583,ZZ,ZZ20240509BLRBOM2024.0,2024.0,Boeing 777-300,05/09/2024,2024-05-09 14:01:00,2024-05-10 11:07:00,BLR,BOM,360.0,410,226,-134,184,36,72,108,144,41,23,13,18,82,45,27,37,127,70,38,57,170,94,50,76,"{'F': 22, 'P': 14}","{'C': 29, 'J': 22, 'Z': 22}","{'Q': 32, 'R': 22, 'S': 11, 'T': 11, 'H': 22, 'M': 11}","{'Y': 11, 'A': 11, 'B': 5, 'D': 5, 'E': 5, 'G': 11, 'I': 5, 'K': 11, 'L': 5, 'N': 5, 'O': 5, 'U': 11, 'V': 5, 'W': 5, 'X': 5}"
INV-ZZ-6165176,SCH-ZZ-8013583,ZZ,ZZ20240511BLRBOM2024.0,2024.0,Boeing 777-300,05/11/2024,2024-05-11 14:01:00,2024-05-12 11:07:00,BLR,BOM,360.0,405,222,-138,183,36,72,108,144,42,23,13,19,83,46,26,37,120,66,42,54,166,91,53,75,"{'F': 22, 'P': 14}","{'C': 29, 'J': 22, 'Z': 22}","{'Q': 32, 'R': 22, 'S': 11, 'T': 11, 'H': 22, 'M': 11}","{'Y': 11, 'A': 11, 'B': 5, 'D': 5, 'E': 5, 'G': 11, 'I': 5, 'K': 11, 'L': 5, 'N': 5, 'O': 5, 'U': 11, 'V': 5, 'W': 5, 'X': 5}"
INV-ZZ-6858167,SCH-ZZ-8013583,ZZ,ZZ20240512BLRBOM2024.0,2024.0,Boeing 777-300,05/12/2024,2024-05-12 14:01:00,2024-05-13 11:07:00,BLR,BOM,360.0,413,224,-136,188,36,72,108,144,41,22,14,19,82,45,27,37,121,66,42,55,169,92,52,77,"{'F': 22, 'P': 14}","{'C': 29, 'J': 22, 'Z': 22}","{'Q': 32, 'R': 22, 'S': 11, 'T': 11, 'H': 22, 'M': 11}","{'Y': 11, 'A': 11, 'B': 5, 'D': 5, 'E': 5, 'G': 11, 'I': 5, 'K': 11, 'L': 5, 'N': 5, 'O': 5, 'U': 11, 'V': 5, 'W': 5, 'X': 5}"
INV-ZZ-6720387,SCH-ZZ-8013583,ZZ,ZZ20240516BLRBOM2024.0,2024.0,Boeing 777-300,05/16/2024,2024-05-16 14:01:00,2024-05-17 11:07:00,BLR,BOM,360.0,428,225,-135,203,36,72,108,144,40,21,15,19,82,43,29,39,125,66,42,59,165,87,57,78,"{'F': 22, 'P': 14}","{'C': 29, 'J': 22, 'Z': 22}","{'Q': 32, 'R': 22, 'S': 11, 'T': 11, 'H': 22, 'M': 11}","{'Y': 11, 'A': 11, 'B': 5, 'D': 5, 'E': 5, 'G': 11, 'I': 5, 'K': 11, 'L': 5, 'N': 5, 'O': 5, 'U': 11, 'V': 5, 'W': 5, 'X': 5}"
INV-ZZ-3079016,SCH-ZZ-8013583,ZZ,ZZ20240518BLRBOM2024.0,2024.0,Boeing 777-300,05/18/2024,2024-05-18 14:01:00,2024-05-19 11:07:00,BLR,BOM,360.0,406,205,-155,201,36,72,108,144,42,21,15,21,81,41,31,40,126,64,44,62,168,85,59,83,"{'F': 22, 'P': 14}","{'C': 29, 'J': 22, 'Z': 22}","{'Q': 32, 'R': 22, 'S': 11, 'T': 11, 'H': 22, 'M': 11}","{'Y': 11, 'A': 11, 'B': 5, 'D': 5, 'E': 5, 'G': 11, 'I': 5, 'K': 11, 'L': 5, 'N': 5, 'O': 5, 'U': 11, 'V': 5, 'W': 5, 'X': 5}"
INV-ZZ-8249458,SCH-ZZ-8013583,ZZ,ZZ20240519BLRBOM2024.0,2024.0,Boeing 777-300,05/19/2024,2024-05-19 14:01:00,2024-05-20 11:07:00,BLR,BOM,360.0,402,215,-145,187,36,72,108,144,40,21,15,19,85,45,27,40,120,64,44,56,172,92,52,80,"{'F': 22, 'P': 14}","{'C': 29, 'J': 22, 'Z': 22}","{'Q': 32, 'R': 22, 'S': 11, 'T': 11, 'H': 22, 'M': 11}","{'Y': 11, 'A': 11, 'B': 5, 'D': 5, 'E': 5, 'G': 11, 'I': 5, 'K': 11, 'L': 5, 'N': 5, 'O': 5, 'U': 11, 'V': 5, 'W': 5, 'X': 5}"
INV-ZZ-8568209,SCH-ZZ-8013583,ZZ,ZZ20240523BLRBOM2024.0,2024.0,Boeing 777-300,05/23/2024,2024-05-23 14:01:00,2024-05-24 11:07:00,BLR,BOM,360.0,396,197,-163,199,36,72,108,144,41,20,16,21,83,41,31,42,122,61,47,61,165,82,62,83,"{'F': 22, 'P': 14}","{'C': 29, 'J': 22, 'Z': 22}","{'Q': 32, 'R': 22, 'S': 11, 'T': 11, 'H': 22, 'M': 11}","{'Y': 11, 'A': 11, 'B': 5, 'D': 5, 'E': 5, 'G': 11, 'I': 5, 'K': 11, 'L': 5, 'N': 5, 'O': 5, 'U': 11, 'V': 5, 'W': 5, 'X': 5}"
INV-ZZ-4577664,SCH-ZZ-8013583,ZZ,ZZ20240525BLRBOM2024.0,2024.0,Boeing 777-300,05/25/2024,2024-05-25 14:01:00,2024-05-26 11:07:00,BLR,BOM,360.0,422,197,-163,225,36,72,108,144,41,19,17,22,83,39,33,44,128,60,48,68,166,78,66,88,"{'F': 22, 'P': 14}","{'C': 29, 'J': 22, 'Z': 22}","{'Q': 32, 'R': 22, 'S': 11, 'T': 11, 'H': 22, 'M': 11}","{'Y': 11, 'A': 11, 'B': 5, 'D': 5, 'E': 5, 'G': 11, 'I': 5, 'K': 11, 'L': 5, 'N': 5, 'O': 5, 'U': 11, 'V': 5, 'W': 5, 'X': 5}"
INV-ZZ-7898825,SCH-ZZ-8013583,ZZ,ZZ20240526BLRBOM2024.0,2024.0,Boeing 777-300,05/26/2024,2024-05-26 14:01:00,2024-05-27 11:07:00,BLR,BOM,360.0,398,189,-171,209,36,72,108,144,43,20,16,23,86,41,31,45,125,59,49,66,159,75,69,84,"{'F': 22, 'P': 14}","{'C': 29, 'J': 22, 'Z': 22}","{'Q': 32, 'R': 22, 'S': 11, 'T': 11, 'H': 22, 'M': 11}","{'Y': 11, 'A': 11, 'B': 5, 'D': 5, 'E': 5, 'G': 11, 'I': 5, 'K': 11, 'L': 5, 'N': 5, 'O': 5, 'U': 11, 'V': 5, 'W': 5, 'X': 5}"
INV-ZZ-8169031,SCH-ZZ-8013583,ZZ,ZZ20240530BLRBOM2024.0,2024.0,Boeing 777-300,05/30/2024,2024-05-30 14:01:00,2024-05-31 11:07:00,BLR,BOM,360.0,420,202,-158,218,36,72,108,144,41,20,16,21,82,39,33,43,122,59,49,63,162,78,66,84,"{'F': 22, 'P': 14}","{'C': 29, 'J': 22, 'Z': 22}","{'Q': 32, 'R': 22, 'S': 11, 'T': 11, 'H': 22, 'M': 11}","{'Y': 11, 'A': 11, 'B': 5, 'D': 5, 'E': 5, 'G': 11, 'I': 5, 'K': 11, 'L': 5, 'N': 5, 'O': 5, 'U': 11, 'V': 5, 'W': 5, 'X': 5}"
INV-ZZ-7553010,SCH-ZZ-8013583,ZZ,ZZ20240601BLRBOM2024.0,2024.0,Boeing 777-300,06/01/2024,2024-06-01 14:01:00,2024-06-02 11:07:00,BLR,BOM,360.0,416,188,-172,228,36,72,108,144,40,18,18,22,86,39,33,47,120,54,54,66,169,76,68,93,"{'F': 22, 'P': 14}","{'C': 29, 'J': 22, 'Z': 22}","{'Q': 32, 'R': 22, 'S': 11, 'T': 11, 'H': 22, 'M': 11}","{'Y': 11, 'A': 11, 'B': 5, 'D': 5, 'E': 5, 'G': 11, 'I': 5, 'K': 11, 'L': 5, 'N': 5, 'O': 5, 'U': 11, 'V': 5, 'W': 5, 'X': 5}"
INV-ZZ-8244501,SCH-ZZ-8013583,ZZ,ZZ20240602BLRBOM2024.0,2024.0,Boeing 777-300,06/02/2024,2024-06-02 14:01:00,2024-06-03 11:07:00,BLR,BOM,360.0,419,199,-161,220,36,72,108,144,42,20,16,22,80,38,34,42,119,56,52,63,167,79,65,88,"{'F': 22, 'P': 14}","{'C': 29, 'J': 22, 'Z': 22}","{'Q': 32, 'R': 22, 'S': 11, 'T': 11, 'H': 22, 'M': 11}","{'Y': 11, 'A': 11, 'B': 5, 'D': 5, 'E': 5, 'G': 11, 'I': 5, 'K': 11, 'L': 5, 'N': 5, 'O': 5, 'U': 11, 'V': 5, 'W': 5, 'X': 5}"
INV-ZZ-4196566,SCH-ZZ-8013583,ZZ,ZZ20240606BLRBOM2024.0,2024.0,Boeing 777-300,06/06/2024,2024-06-06 14:01:00,2024-06-07 11:07:00,BLR,BOM,360.0,414,199,-161,215,36,72,108,144,41,20,16,21,86,41,31,45,122,59,49,63,167,80,64,87,"{'F': 22, 'P': 14}","{'C': 29, 'J': 22, 'Z': 22}","{'Q': 32, 'R': 22, 'S': 11, 'T': 11, 'H': 22, 'M': 11}","{'Y': 11, 'A': 11, 'B': 5, 'D': 5, 'E': 5, 'G': 11, 'I': 5, 'K': 11, 'L': 5, 'N': 5, 'O': 5, 'U': 11, 'V': 5, 'W': 5, 'X': 5}"
INV-ZZ-9915874,SCH-ZZ-1849853,ZZ,ZZ20240513CCUMAA4688.0,4688.0,Airbus A320 Neo,05/13/2024,2024-05-13 19:36:00,2024-05-13 22:50:00,CCU,MAA,180.0,198,100,-80,98,18,36,54,72,21,11,7,10,41,21,15,20,60,30,24,30,85,43,29,42,"{'F': 11, 'P': 7}","{'C': 14, 'J': 11, 'Z': 11}","{'Q': 16, 'R': 11, 'S': 5, 'T': 5, 'H': 11, 'M': 5}","{'Y': 5, 'A': 5, 'B': 3, 'D': 3, 'E': 3, 'G': 5, 'I': 3, 'K': 5, 'L': 3, 'N': 3, 'O': 3, 'U': 5, 'V': 3, 'W': 3, 'X': 3}"
INV-ZZ-1593278,SCH-ZZ-1849853,ZZ,ZZ20240520CCUMAA4688.0,4688.0,Airbus A320 Neo,05/20/2024,2024-05-20 19:36:00,2024-05-20 22:50:00,CCU,MAA,180.0,203,96,-84,107,18,36,54,72,20,9,9,11,40,19,17,21,62,29,25,33,83,39,33,44,"{'F': 11, 'P': 7}","{'C': 14, 'J': 11, 'Z': 11}","{'Q': 16, 'R': 11, 'S': 5, 'T': 5, 'H': 11, 'M': 5}","{'Y': 5, 'A': 5, 'B': 3, 'D': 3, 'E': 3, 'G': 5, 'I': 3, 'K': 5, 'L': 3, 'N': 3, 'O': 3, 'U': 5, 'V': 3, 'W': 3, 'X': 3}"
INV-ZZ-6545466,SCH-ZZ-1849853,ZZ,ZZ20240527CCUMAA4688.0,4688.0,Airbus A320 Neo,05/27/2024,2024-05-27 19:36:00,2024-05-27 22:50:00,CCU,MAA,180.0,210,98,-82,112,18,36,54,72,20,9,9,11,42,20,16,22,61,29,25,32,83,39,33,44,"{'F': 11, 'P': 7}","{'C': 14, 'J': 11, 'Z': 11}","{'Q': 16, 'R': 11, 'S': 5, 'T': 5, 'H': 11, 'M': 5}","{'Y': 5, 'A': 5, 'B': 3, 'D': 3, 'E': 3, 'G': 5, 'I': 3, 'K': 5, 'L': 3, 'N': 3, 'O': 3, 'U': 5, 'V': 3, 'W': 3, 'X': 3}"
INV-ZZ-9462762,SCH-ZZ-1849853,ZZ,ZZ20240603CCUMAA4688.0,4688.0,Airbus A320 Neo,06/03/2024,2024-06-03 19:36:00,2024-06-03 22:50:00,CCU,MAA,180.0,207,106,-74,101,18,36,54,72,21,11,7,10,43,22,14,21,62,32,22,30,82,42,30,40,"{'F': 11, 'P': 7}","{'C': 14, 'J': 11, 'Z': 11}","{'Q': 16, 'R': 11, 'S': 5, 'T': 5, 'H': 11, 'M': 5}","{'Y': 5, 'A': 5, 'B': 3, 'D': 3, 'E': 3, 'G': 5, 'I': 3, 'K': 5, 'L': 3, 'N': 3, 'O': 3, 'U': 5, 'V': 3, 'W': 3, 'X': 3}"
INV-ZZ-7803326,SCH-ZZ-1849853,ZZ,ZZ20240610CCUMAA4688.0,4688.0,Airbus A320 Neo,06/10/2024,2024-06-10 19:36:00,2024-06-10 22:50:00,CCU,MAA,180.0,208,95,-85,113,18,36,54,72,21,10,8,11,40,18,18,22,60,27,27,33,84,38,34,46,"{'F': 11, 'P': 7}","{'C': 14, 'J': 11, 'Z': 11}","{'Q': 16, 'R': 11, 'S': 5, 'T': 5, 'H': 11, 'M': 5}","{'Y': 5, 'A': 5, 'B': 3, 'D': 3, 'E': 3, 'G': 5, 'I': 3, 'K': 5, 'L': 3, 'N': 3, 'O': 3, 'U': 5, 'V': 3, 'W': 3, 'X': 3}"
INV-ZZ-2536995,SCH-ZZ-1849853,ZZ,ZZ20240617CCUMAA4688.0,4688.0,Airbus A320 Neo,06/17/2024,2024-06-17 19:36:00,2024-06-17 22:50:00,CCU,MAA,180.0,210,92,-88,118,18,36,54,72,21,9,9,12,40,18,18,22,62,27,27,35,84,37,35,47,"{'F': 11, 'P': 7}","{'C': 14, 'J': 11, 'Z': 11}","{'Q': 16, 'R': 11, 'S': 5, 'T': 5, 'H': 11, 'M': 5}","{'Y': 5, 'A': 5, 'B': 3, 'D': 3, 'E': 3, 'G': 5, 'I': 3, 'K': 5, 'L': 3, 'N': 3, 'O': 3, 'U': 5, 'V': 3, 'W': 3, 'X': 3}"
INV-ZZ-6773014,SCH-ZZ-1849853,ZZ,ZZ20240624CCUMAA4688.0,4688.0,Airbus A320 Neo,06/24/2024,2024-06-24 19:36:00,2024-06-24 22:50:00,CCU,MAA,180.0,202,83,-97,119,18,36,54,72,21,9,9,12,42,17,19,25,60,25,29,35,86,35,37,51,"{'F': 11, 'P': 7}","{'C': 14, 'J': 11, 'Z': 11}","{'Q': 16, 'R': 11, 'S': 5, 'T': 5, 'H': 11, 'M': 5}","{'Y': 5, 'A': 5, 'B': 3, 'D': 3, 'E': 3, 'G': 5, 'I': 3, 'K': 5, 'L': 3, 'N': 3, 'O': 3, 'U': 5, 'V': 3, 'W': 3, 'X': 3}"
INV-ZZ-5889973,SCH-ZZ-4295870,ZZ,ZZ20240503BLRHYD2811.0,2811.0,Boeing 717,05/03/2024,2024-05-03 14:16:00,2024-05-04 07:15:00,BLR,HYD,100.0,115,63,-37,52,10,20,30,40,12,7,3,5,24,13,7,11,36,20,10,16,46,25,15,21,"{'F': 6, 'P': 4}","{'C': 8, 'J': 6, 'Z': 6}","{'Q': 9, 'R': 6, 'S': 3, 'T': 3, 'H': 6, 'M': 3}","{'Y': 3, 'A': 3, 'B': 2, 'D': 2, 'E': 2, 'G': 3, 'I': 2, 'K': 3, 'L': 2, 'N': 2, 'O': 2, 'U': 3, 'V': 2, 'W': 2, 'X': 2}"
INV-ZZ-2392716,SCH-ZZ-4295870,ZZ,ZZ20240504BLRHYD2811.0,2811.0,Boeing 717,05/04/2024,2024-05-04 14:16:00,2024-05-05 07:15:00,BLR,HYD,100.0,117,66,-34,51,10,20,30,40,11,6,4,5,23,13,7,10,36,20,10,16,48,27,13,21,"{'F': 6, 'P': 4}","{'C': 8, 'J': 6, 'Z': 6}","{'Q': 9, 'R': 6, 'S': 3, 'T': 3, 'H': 6, 'M': 3}","{'Y': 3, 'A': 3, 'B': 2, 'D': 2, 'E': 2, 'G': 3, 'I': 2, 'K': 3, 'L': 2, 'N': 2, 'O': 2, 'U': 3, 'V': 2, 'W': 2, 'X': 2}"
INV-ZZ-7763907,SCH-ZZ-4295870,ZZ,ZZ20240507BLRHYD2811.0,2811.0,Boeing 717,05/07/2024,2024-05-07 14:16:00,2024-05-08 07:15:00,BLR,HYD,100.0,117,63,-37,54,10,20,30,40,11,6,4,5,22,12,8,10,35,19,11,16,48,26,14,22,"{'F': 6, 'P': 4}","{'C': 8, 'J': 6, 'Z': 6}","{'Q': 9, 'R': 6, 'S': 3, 'T': 3, 'H': 6, 'M': 3}","{'Y': 3, 'A': 3, 'B': 2, 'D': 2, 'E': 2, 'G': 3, 'I': 2, 'K': 3, 'L': 2, 'N': 2, 'O': 2, 'U': 3, 'V': 2, 'W': 2, 'X': 2}"
INV-ZZ-9176409,SCH-ZZ-4295870,ZZ,ZZ20240510BLRHYD2811.0,2811.0,Boeing 717,05/10/2024,2024-05-10 14:16:00,2024-05-11 07:15:00,BLR,HYD,100.0,118,60,-40,58,10,20,30,40,11,6,4,5,23,12,8,11,35,18,12,17,44,22,18,22,"{'F': 6, 'P': 4}","{'C': 8, 'J': 6, 'Z': 6}","{'Q': 9, 'R': 6, 'S': 3, 'T': 3, 'H': 6, 'M': 3}","{'Y': 3, 'A': 3, 'B': 2, 'D': 2, 'E': 2, 'G': 3, 'I': 2, 'K': 3, 'L': 2, 'N': 2, 'O': 2, 'U': 3, 'V': 2, 'W': 2, 'X': 2}"
INV-ZZ-3080843,SCH-ZZ-4295870,ZZ,ZZ20240511BLRHYD2811.0,2811.0,Boeing 717,05/11/2024,2024-05-11 14:16:00,2024-05-12 07:15:00,BLR,HYD,100.0,115,60,-40,55,10,20,30,40,11,6,4,5,23,12,8,11,33,17,13,16,46,24,16,22,"{'F': 6, 'P': 4}","{'C': 8, 'J': 6, 'Z': 6}","{'Q': 9, 'R': 6, 'S': 3, 'T': 3, 'H': 6, 'M': 3}","{'Y': 3, 'A': 3, 'B': 2, 'D': 2, 'E': 2, 'G': 3, 'I': 2, 'K': 3, 'L': 2, 'N': 2, 'O': 2, 'U': 3, 'V': 2, 'W': 2, 'X': 2}"
INV-ZZ-7721018,SCH-ZZ-4295870,ZZ,ZZ20240514BLRHYD2811.0,2811.0,Boeing 717,05/14/2024,2024-05-14 14:16:00,2024-05-15 07:15:00,BLR,HYD,100.0,113,55,-45,58,10,20,30,40,12,6,4,6,24,12,8,12,34,17,13,17,45,22,18,23,"{'F': 6, 'P': 4}","{'C': 8, 'J': 6, 'Z': 6}","{'Q': 9, 'R': 6, 'S': 3, 'T': 3, 'H': 6, 'M': 3}","{'Y': 3, 'A': 3, 'B': 2, 'D': 2, 'E': 2, 'G': 3, 'I': 2, 'K': 3, 'L': 2, 'N': 2, 'O': 2, 'U': 3, 'V': 2, 'W': 2, 'X': 2}"
INV-ZZ-5634659,SCH-ZZ-4295870,ZZ,ZZ20240517BLRHYD2811.0,2811.0,Boeing 717,05/17/2024,2024-05-17 14:16:00,2024-05-18 07:15:00,BLR,HYD,100.0,112,55,-45,57,10,20,30,40,11,5,5,6,23,11,9,12,35,17,13,18,47,23,17,24,"{'F': 6, 'P': 4}","{'C': 8, 'J': 6, 'Z': 6}","{'Q': 9, 'R': 6, 'S': 3, 'T': 3, 'H': 6, 'M': 3}","{'Y': 3, 'A': 3, 'B': 2, 'D': 2, 'E': 2, 'G': 3, 'I': 2, 'K': 3, 'L': 2, 'N': 2, 'O': 2, 'U': 3, 'V': 2, 'W': 2, 'X': 2}"
INV-ZZ-9873963,SCH-ZZ-4295870,ZZ,ZZ20240518BLRHYD2811.0,2811.0,Boeing 717,05/18/2024,2024-05-18 14:16:00,2024-05-19 07:15:00,BLR,HYD,100.0,119,57,-43,62,10,20,30,40,12,6,4,6,23,11,9,12,35,17,13,18,48,23,17,25,"{'F': 6, 'P': 4}","{'C': 8, 'J': 6, 'Z': 6}","{'Q': 9, 'R': 6, 'S': 3, 'T': 3, 'H': 6, 'M': 3}","{'Y': 3, 'A': 3, 'B': 2, 'D': 2, 'E': 2, 'G': 3, 'I': 2, 'K': 3, 'L': 2, 'N': 2, 'O': 2, 'U': 3, 'V': 2, 'W': 2, 'X': 2}"
INV-ZZ-2253993,SCH-ZZ-4295870,ZZ,ZZ20240521BLRHYD2811.0,2811.0,Boeing 717,05/21/2024,2024-05-21 14:16:00,2024-05-22 07:15:00,BLR,HYD,100.0,119,57,-43,62,10,20,30,40,11,5,5,6,23,11,9,12,33,16,14,17,46,22,18,24,"{'F': 6, 'P': 4}","{'C': 8, 'J': 6, 'Z': 6}","{'Q': 9, 'R': 6, 'S': 3, 'T': 3, 'H': 6, 'M': 3}","{'Y': 3, 'A': 3, 'B': 2, 'D': 2, 'E': 2, 'G': 3, 'I': 2, 'K': 3, 'L': 2, 'N': 2, 'O': 2, 'U': 3, 'V': 2, 'W': 2, 'X': 2}"
INV-ZZ-6802261,SCH-ZZ-4295870,ZZ,ZZ20240524BLRHYD2811.0,2811.0,Boeing 717,05/24/2024,2024-05-24 14:16:00,2024-05-25 07:15:00,BLR,HYD,100.0,114,53,-47,61,10,20,30,40,12,6,4,6,23,11,9,12,35,16,14,19,48,22,18,26,"{'F': 6, 'P': 4}","{'C': 8, 'J': 6, 'Z': 6}","{'Q': 9, 'R': 6, 'S': 3, 'T': 3, 'H': 6, 'M': 3}","{'Y': 3, 'A': 3, 'B': 2, 'D': 2, 'E': 2, 'G': 3, 'I': 2, 'K': 3, 'L': 2, 'N': 2, 'O': 2, 'U': 3, 'V': 2, 'W': 2, 'X': 2}"
INV-ZZ-8926917,SCH-ZZ-4295870,ZZ,ZZ20240525BLRHYD2811.0,2811.0,Boeing 717,05/25/2024,2024-05-25 14:16:00,2024-05-26 07:15:00,BLR,HYD,100.0,117,62,-38,55,10,20,30,40,12,6,4,6,22,12,8,10,36,19,11,17,46,24,16,22,"{'F': 6, 'P': 4}","{'C': 8, 'J': 6, 'Z': 6}","{'Q': 9, 'R': 6, 'S': 3, 'T': 3, 'H': 6, 'M': 3}","{'Y': 3, 'A': 3, 'B': 2, 'D': 2, 'E': 2, 'G': 3, 'I': 2, 'K': 3, 'L': 2, 'N': 2, 'O': 2, 'U': 3, 'V': 2, 'W': 2, 'X': 2}"
INV-ZZ-3650861,SCH-ZZ-4295870,ZZ,ZZ20240528BLRHYD2811.0,2811.0,Boeing 717,05/28/2024,2024-05-28 14:16:00,2024-05-29 07:15:00,BLR,HYD,100.0,110,50,-50,60,10,20,30,40,11,5,5,6,24,11,9,13,36,17,13,19,48,22,18,26,"{'F': 6, 'P': 4}","{'C': 8, 'J': 6, 'Z': 6}","{'Q': 9, 'R': 6, 'S': 3, 'T': 3, 'H': 6, 'M': 3}","{'Y': 3, 'A': 3, 'B': 2, 'D': 2, 'E': 2, 'G': 3, 'I': 2, 'K': 3, 'L': 2, 'N': 2, 'O': 2, 'U': 3, 'V': 2, 'W': 2, 'X': 2}"
INV-ZZ-6703142,SCH-ZZ-4295870,ZZ,ZZ20240531BLRHYD2811.0,2811.0,Boeing 717,05/31/2024,2024-05-31 14:16:00,2024-06-01 07:15:00,BLR,HYD,100.0,114,53,-47,61,10,20,30,40,11,5,5,6,23,11,9,12,34,16,14,18,46,21,19,25,"{'F': 6, 'P': 4}","{'C': 8, 'J': 6, 'Z': 6}","{'Q': 9, 'R': 6, 'S': 3, 'T': 3, 'H': 6, 'M': 3}","{'Y': 3, 'A': 3, 'B': 2, 'D': 2, 'E': 2, 'G': 3, 'I': 2, 'K': 3, 'L': 2, 'N': 2, 'O': 2, 'U': 3, 'V': 2, 'W': 2, 'X': 2}"
INV-ZZ-5606836,SCH-ZZ-4295870,ZZ,ZZ20240601BLRHYD2811.0,2811.0,Boeing 717,06/01/2024,2024-06-01 14:16:00,2024-06-02 07:15:00,BLR,HYD,100.0,116,55,-45,61,10,20,30,40,12,6,4,6,24,11,9,13,34,16,14,18,45,21,19,24,"{'F': 6, 'P': 4}","{'C': 8, 'J': 6, 'Z': 6}","{'Q': 9, 'R': 6, 'S': 3, 'T': 3, 'H': 6, 'M': 3}","{'Y': 3, 'A': 3, 'B': 2, 'D': 2, 'E': 2, 'G': 3, 'I': 2, 'K': 3, 'L': 2, 'N': 2, 'O': 2, 'U': 3, 'V': 2, 'W': 2, 'X': 2}"
INV-ZZ-5898356,SCH-ZZ-4295870,ZZ,ZZ20240604BLRHYD2811.0,2811.0,Boeing 717,06/04/2024,2024-06-04 14:16:00,2024-06-05 07:15:00,BLR,HYD,100.0,110,55,-45,55,10,20,30,40,11,6,4,5,24,12,8,12,36,18,12,18,45,23,17,22,"{'F': 6, 'P': 4}","{'C': 8, 'J': 6, 'Z': 6}","{'Q': 9, 'R': 6, 'S': 3, 'T': 3, 'H': 6, 'M': 3}","{'Y': 3, 'A': 3, 'B': 2, 'D': 2, 'E': 2, 'G': 3, 'I': 2, 'K': 3, 'L': 2, 'N': 2, 'O': 2, 'U': 3, 'V': 2, 'W': 2, 'X': 2}"
INV-ZZ-8814312,SCH-ZZ-4295870,ZZ,ZZ20240607BLRHYD2811.0,2811.0,Boeing 717,06/07/2024,2024-06-07 14:16:00,2024-06-08 07:15:00,BLR,HYD,100.0,116,58,-42,58,10,20,30,40,12,6,4,6,24,12,8,12,35,18,12,17,45,23,17,22,"{'F': 6, 'P': 4}","{'C': 8, 'J': 6, 'Z': 6}","{'Q': 9, 'R': 6, 'S': 3, 'T': 3, 'H': 6, 'M': 3}","{'Y': 3, 'A': 3, 'B': 2, 'D': 2, 'E': 2, 'G': 3, 'I': 2, 'K': 3, 'L': 2, 'N': 2, 'O': 2, 'U': 3, 'V': 2, 'W': 2, 'X': 2}"
INV-ZZ-1980882,SCH-ZZ-4295870,ZZ,ZZ20240608BLRHYD2811.0,2811.0,Boeing 717,06/08/2024,2024-06-08 14:16:00,2024-06-09 07:15:00,BLR,HYD,100.0,110,48,-52,62,10,20,30,40,11,5,5,6,23,10,10,13,35,15,15,20,46,20,20,26,"{'F': 6, 'P': 4}","{'C': 8, 'J': 6, 'Z': 6}","{'Q': 9, 'R': 6, 'S': 3, 'T': 3, 'H': 6, 'M': 3}","{'Y': 3, 'A': 3, 'B': 2, 'D': 2, 'E': 2, 'G': 3, 'I': 2, 'K': 3, 'L': 2, 'N': 2, 'O': 2, 'U': 3, 'V': 2, 'W': 2, 'X': 2}"
INV-ZZ-3521439,SCH-ZZ-4295870,ZZ,ZZ20240611BLRHYD2811.0,2811.0,Boeing 717,06/11/2024,2024-06-11 14:16:00,2024-06-12 07:15:00,BLR,HYD,100.0,116,56,-44,60,10,20,30,40,12,6,4,6,23,11,9,12,35,17,13,18,44,21,19,23,"{'F': 6, 'P': 4}","{'C': 8, 'J': 6, 'Z': 6}","{'Q': 9, 'R': 6, 'S': 3, 'T': 3, 'H': 6, 'M': 3}","{'Y': 3, 'A': 3, 'B': 2, 'D': 2, 'E': 2, 'G': 3, 'I': 2, 'K': 3, 'L': 2, 'N': 2, 'O': 2, 'U': 3, 'V': 2, 'W': 2, 'X': 2}"
INV-ZZ-7281166,SCH-ZZ-4295870,ZZ,ZZ20240614BLRHYD2811.0,2811.0,Boeing 717,06/14/2024,2024-06-14 14:16:00,2024-06-15 07:15:00,BLR,HYD,100.0,115,52,-48,63,10,20,30,40,12,5,5,7,23,10,10,13,34,15,15,19,45,20,20,25,"{'F': 6, 'P': 4}","{'C': 8, 'J': 6, 'Z': 6}","{'Q': 9, 'R': 6, 'S': 3, 'T': 3, 'H': 6, 'M': 3}","{'Y': 3, 'A': 3, 'B': 2, 'D': 2, 'E': 2, 'G': 3, 'I': 2, 'K': 3, 'L': 2, 'N': 2, 'O': 2, 'U': 3, 'V': 2, 'W': 2, 'X': 2}"
INV-ZZ-6119512,SCH-ZZ-4295870,ZZ,ZZ20240615BLRHYD2811.0,2811.0,Boeing 717,06/15/2024,2024-06-15 14:16:00,2024-06-16 07:15:00,BLR,HYD,100.0,117,55,-45,62,10,20,30,40,11,5,5,6,23,11,9,12,34,16,14,18,47,22,18,25,"{'F': 6, 'P': 4}","{'C': 8, 'J': 6, 'Z': 6}","{'Q': 9, 'R': 6, 'S': 3, 'T': 3, 'H': 6, 'M': 3}","{'Y': 3, 'A': 3, 'B': 2, 'D': 2, 'E': 2, 'G': 3, 'I': 2, 'K': 3, 'L': 2, 'N': 2, 'O': 2, 'U': 3, 'V': 2, 'W': 2, 'X': 2}"
INV-ZZ-9851798,SCH-ZZ-6469147,ZZ,ZZ20240416HYDAMD2299.0,2299.0,Airbus A321 Neo,04/16/2024,2024-04-16 01:59:00,2024-04-16 21:45:00,HYD,AMD,220.0,251,150,-70,101,22,44,66,88,25,15,7,10,50,30,14,20,77,46,20,31,99,59,29,40,"{'F': 13, 'P': 9}","{'C': 18, 'J': 13, 'Z': 13}","{'Q': 20, 'R': 13, 'S': 7, 'T': 7, 'H': 13, 'M': 7}","{'Y': 7, 'A': 7, 'B': 3, 'D': 3, 'E': 3, 'G': 7, 'I': 3, 'K': 7, 'L': 3, 'N': 3, 'O': 3, 'U': 7, 'V': 3, 'W': 3, 'X': 3}"
INV-ZZ-5467478,SCH-ZZ-6469147,ZZ,ZZ20240417HYDAMD2299.0,2299.0,Airbus A321 Neo,04/17/2024,2024-04-17 01:59:00,2024-04-17 21:45:00,HYD,AMD,220.0,252,150,-70,102,22,44,66,88,26,15,7,11,52,31,13,21,77,46,20,31,103,61,27,42,"{'F': 13, 'P': 9}","{'C': 18, 'J': 13, 'Z': 13}","{'Q': 20, 'R': 13, 'S': 7, 'T': 7, 'H': 13, 'M': 7}","{'Y': 7, 'A': 7, 'B': 3, 'D': 3, 'E': 3, 'G': 7, 'I': 3, 'K': 7, 'L': 3, 'N': 3, 'O': 3, 'U': 7, 'V': 3, 'W': 3, 'X': 3}"
INV-ZZ-7465065,SCH-ZZ-6469147,ZZ,ZZ20240419HYDAMD2299.0,2299.0,Airbus A321 Neo,04/19/2024,2024-04-19 01:59:00,2024-04-19 21:45:00,HYD,AMD,220.0,248,146,-74,102,22,44,66,88,26,15,7,11,50,29,15,21,76,45,21,31,101,59,29,42,"{'F': 13, 'P': 9}","{'C': 18, 'J': 13, 'Z': 13}","{'Q': 20, 'R': 13, 'S': 7, 'T': 7, 'H': 13, 'M': 7}","{'Y': 7, 'A': 7, 'B': 3, 'D': 3, 'E': 3, 'G': 7, 'I': 3, 'K': 7, 'L': 3, 'N': 3, 'O': 3, 'U': 7, 'V': 3, 'W': 3, 'X': 3}"
INV-ZZ-2445370,SCH-ZZ-6469147,ZZ,ZZ20240421HYDAMD2299.0,2299.0,Airbus A321 Neo,04/21/2024,2024-04-21 01:59:00,2024-04-21 21:45:00,HYD,AMD,220.0,250,145,-75,105,22,44,66,88,26,15,7,11,53,31,13,22,74,43,23,31,98,57,31,41,"{'F': 13, 'P': 9}","{'C': 18, 'J': 13, 'Z': 13}","{'Q': 20, 'R': 13, 'S': 7, 'T': 7, 'H': 13, 'M': 7}","{'Y': 7, 'A': 7, 'B': 3, 'D': 3, 'E': 3, 'G': 7, 'I': 3, 'K': 7, 'L': 3, 'N': 3, 'O': 3, 'U': 7, 'V': 3, 'W': 3, 'X': 3}"
INV-ZZ-6621713,SCH-ZZ-6469147,ZZ,ZZ20240422HYDAMD2299.0,2299.0,Airbus A321 Neo,04/22/2024,2024-04-22 01:59:00,2024-04-22 21:45:00,HYD,AMD,220.0,262,158,-62,104,22,44,66,88,26,16,6,10,53,32,12,21,74,45,21,29,102,62,26,40,"{'F': 13, 'P': 9}","{'C': 18, 'J': 13, 'Z': 13}","{'Q': 20, 'R': 13, 'S': 7, 'T': 7, 'H': 13, 'M': 7}","{'Y': 7, 'A': 7, 'B': 3, 'D': 3, 'E': 3, 'G': 7, 'I': 3, 'K': 7, 'L': 3, 'N': 3, 'O': 3, 'U': 7, 'V': 3, 'W': 3, 'X': 3}"
INV-ZZ-6649525,SCH-ZZ-6469147,ZZ,ZZ20240423HYDAMD2299.0,2299.0,Airbus A321 Neo,04/23/2024,2024-04-23 01:59:00,2024-04-23 21:45:00,HYD,AMD,220.0,255,144,-76,111,22,44,66,88,24,14,8,10,49,28,16,21,76,43,23,33,98,56,32,42,"{'F': 13, 'P': 9}","{'C': 18, 'J': 13, 'Z': 13}","{'Q': 20, 'R': 13, 'S': 7, 'T': 7, 'H': 13, 'M': 7}","{'Y': 7, 'A': 7, 'B': 3, 'D': 3, 'E': 3, 'G': 7, 'I': 3, 'K': 7, 'L': 3, 'N': 3, 'O': 3, 'U': 7, 'V': 3, 'W': 3, 'X': 3}"
INV-ZZ-5049255,SCH-ZZ-6469147,ZZ,ZZ20240424HYDAMD2299.0,2299.0,Airbus A321 Neo,04/24/2024,2024-04-24 01:59:00,2024-04-24 21:45:00,HYD,AMD,220.0,247,132,-88,115,22,44,66,88,26,14,8,12,50,27,17,23,74,40,26,34,105,56,32,49,"{'F': 13, 'P': 9}","{'C': 18, 'J': 13, 'Z': 13}","{'Q': 20, 'R': 13, 'S': 7, 'T': 7, 'H': 13, 'M': 7}","{'Y': 7, 'A': 7, 'B': 3, 'D': 3, 'E': 3, 'G': 7, 'I': 3, 'K': 7, 'L': 3, 'N': 3, 'O': 3, 'U': 7, 'V': 3, 'W': 3, 'X': 3}"
INV-ZZ-3381943,SCH-ZZ-6469147,ZZ,ZZ20240426HYDAMD2299.0,2299.0,Airbus A321 Neo,04/26/2024,2024-04-26 01:59:00,2024-04-26 21:45:00,HYD,AMD,220.0,246,137,-83,109,22,44,66,88,25,14,8,11,49,27,17,22,75,42,24,33,102,57,31,45,"{'F': 13, 'P': 9}","{'C': 18, 'J': 13, 'Z': 13}","{'Q': 20, 'R': 13, 'S': 7, 'T': 7, 'H': 13, 'M': 7}","{'Y': 7, 'A': 7, 'B': 3, 'D': 3, 'E': 3, 'G': 7, 'I': 3, 'K': 7, 'L': 3, 'N': 3, 'O': 3, 'U': 7, 'V': 3, 'W': 3, 'X': 3}"
INV-ZZ-8532545,SCH-ZZ-6469147,ZZ,ZZ20240428HYDAMD2299.0,2299.0,Airbus A321 Neo,04/28/2024,2024-04-28 01:59:00,2024-04-28 21:45:00,HYD,AMD,220.0,243,138,-82,105,22,44,66,88,25,14,8,11,50,28,16,22,79,45,21,34,102,58,30,44,"{'F': 13, 'P': 9}","{'C': 18, 'J': 13, 'Z': 13}","{'Q': 20, 'R': 13, 'S': 7, 'T': 7, 'H': 13, 'M': 7}","{'Y': 7, 'A': 7, 'B': 3, 'D': 3, 'E': 3, 'G': 7, 'I': 3, 'K': 7, 'L': 3, 'N': 3, 'O': 3, 'U': 7, 'V': 3, 'W': 3, 'X': 3}"
INV-ZZ-7691499,SCH-ZZ-6469147,ZZ,ZZ20240429HYDAMD2299.0,2299.0,Airbus A321 Neo,04/29/2024,2024-04-29 01:59:00,2024-04-29 21:45:00,HYD,AMD,220.0,254,150,-70,104,22,44,66,88,25,15,7,10,49,29,15,20,74,44,22,30,98,58,30,40,"{'F': 13, 'P': 9}","{'C': 18, 'J': 13, 'Z': 13}","{'Q': 20, 'R': 13, 'S': 7, 'T': 7, 'H': 13, 'M': 7}","{'Y': 7, 'A': 7, 'B': 3, 'D': 3, 'E': 3, 'G': 7, 'I': 3, 'K': 7, 'L': 3, 'N': 3, 'O': 3, 'U': 7, 'V': 3, 'W': 3, 'X': 3}"
INV-ZZ-3106448,SCH-ZZ-6469147,ZZ,ZZ20240430HYDAMD2299.0,2299.0,Airbus A321 Neo,04/30/2024,2024-04-30 01:59:00,2024-04-30 21:45:00,HYD,AMD,220.0,247,140,-80,107,22,44,66,88,26,15,7,11,50,28,16,22,79,45,21,34,102,58,30,44,"{'F': 13, 'P': 9}","{'C': 18, 'J': 13, 'Z': 13}","{'Q': 20, 'R': 13, 'S': 7, 'T': 7, 'H': 13, 'M': 7}","{'Y': 7, 'A': 7, 'B': 3, 'D': 3, 'E': 3, 'G': 7, 'I': 3, 'K': 7, 'L': 3, 'N': 3, 'O': 3, 'U': 7, 'V': 3, 'W': 3, 'X': 3}"
INV-ZZ-1572464,SCH-ZZ-6469147,ZZ,ZZ20240501HYDAMD2299.0,2299.0,Airbus A321 Neo,05/01/2024,2024-05-01 01:59:00,2024-05-01 21:45:00,HYD,AMD,220.0,260,150,-70,110,22,44,66,88,25,14,8,11,50,29,15,21,79,46,20,33,106,61,27,45,"{'F': 13, 'P': 9}","{'C': 18, 'J': 13, 'Z': 13}","{'Q': 20, 'R': 13, 'S': 7, 'T': 7, 'H': 13, 'M': 7}","{'Y': 7, 'A': 7, 'B': 3, 'D': 3, 'E': 3, 'G': 7, 'I': 3, 'K': 7, 'L': 3, 'N': 3, 'O': 3, 'U': 7, 'V': 3, 'W': 3, 'X': 3}"
INV-ZZ-5934612,SCH-ZZ-6469147,ZZ,ZZ20240503HYDAMD2299.0,2299.0,Airbus A321 Neo,05/03/2024,2024-05-03 01:59:00,2024-05-03 21:45:00,HYD,AMD,220.0,245,125,-95,120,22,44,66,88,26,13,9,13,50,25,19,25,77,39,27,38,102,52,36,50,"{'F': 13, 'P': 9}","{'C': 18, 'J': 13, 'Z': 13}","{'Q': 20, 'R': 13, 'S': 7, 'T': 7, 'H': 13, 'M': 7}","{'Y': 7, 'A': 7, 'B': 3, 'D': 3, 'E': 3, 'G': 7, 'I': 3, 'K': 7, 'L': 3, 'N': 3, 'O': 3, 'U': 7, 'V': 3, 'W': 3, 'X': 3}"
INV-ZZ-3162191,SCH-ZZ-6469147,ZZ,ZZ20240505HYDAMD2299.0,2299.0,Airbus A321 Neo,05/05/2024,2024-05-05 01:59:00,2024-05-05 21:45:00,HYD,AMD,220.0,250,128,-92,122,22,44,66,88,25,13,9,12,50,26,18,24,78,40,26,38,98,50,38,48,"{'F': 13, 'P': 9}","{'C': 18, 'J': 13, 'Z': 13}","{'Q': 20, 'R': 13, 'S': 7, 'T': 7, 'H': 13, 'M': 7}","{'Y': 7, 'A': 7, 'B': 3, 'D': 3, 'E': 3, 'G': 7, 'I': 3, 'K': 7, 'L': 3, 'N': 3, 'O': 3, 'U': 7, 'V': 3, 'W': 3, 'X': 3}"
INV-ZZ-5862096,SCH-ZZ-6469147,ZZ,ZZ20240506HYDAMD2299.0,2299.0,Airbus A321 Neo,05/06/2024,2024-05-06 01:59:00,2024-05-06 21:45:00,HYD,AMD,220.0,254,146,-74,108,22,44,66,88,25,14,8,11,50,29,15,21,77,44,22,33,97,56,32,41,"{'F': 13, 'P': 9}","{'C': 18, 'J': 13, 'Z': 13}","{'Q': 20, 'R': 13, 'S': 7, 'T': 7, 'H': 13, 'M': 7}","{'Y': 7, 'A': 7, 'B': 3, 'D': 3, 'E': 3, 'G': 7, 'I': 3, 'K': 7, 'L': 3, 'N': 3, 'O': 3, 'U': 7, 'V': 3, 'W': 3, 'X': 3}"
INV-ZZ-2060532,SCH-ZZ-6469147,ZZ,ZZ20240507HYDAMD2299.0,2299.0,Airbus A321 Neo,05/07/2024,2024-05-07 01:59:00,2024-05-07 21:45:00,HYD,AMD,220.0,243,124,-96,118,22,44,66,88,25,13,9,12,50,26,18,24,74,38,28,36,102,52,36,50,"{'F': 13, 'P': 9}","{'C': 18, 'J': 13, 'Z': 13}","{'Q': 20, 'R': 13, 'S': 7, 'T': 7, 'H': 13, 'M': 7}","{'Y': 7, 'A': 7, 'B': 3, 'D': 3, 'E': 3, 'G': 7, 'I': 3, 'K': 7, 'L': 3, 'N': 3, 'O': 3, 'U': 7, 'V': 3, 'W': 3, 'X': 3}"
INV-ZZ-8735063,SCH-ZZ-6469147,ZZ,ZZ20240508HYDAMD2299.0,2299.0,Airbus A321 Neo,05/08/2024,2024-05-08 01:59:00,2024-05-08 21:45:00,HYD,AMD,220.0,258,131,-89,127,22,44,66,88,25,13,9,12,50,25,19,25,78,40,26,38,98,50,38,48,"{'F': 13, 'P': 9}","{'C': 18, 'J': 13, 'Z': 13}","{'Q': 20, 'R': 13, 'S': 7, 'T': 7, 'H': 13, 'M': 7}","{'Y': 7, 'A': 7, 'B': 3, 'D': 3, 'E': 3, 'G': 7, 'I': 3, 'K': 7, 'L': 3, 'N': 3, 'O': 3, 'U': 7, 'V': 3, 'W': 3, 'X': 3}"
INV-ZZ-3182805,SCH-ZZ-6469147,ZZ,ZZ20240510HYDAMD2299.0,2299.0,Airbus A321 Neo,05/10/2024,2024-05-10 01:59:00,2024-05-10 21:45:00,HYD,AMD,220.0,263,147,-73,116,22,44,66,88,25,14,8,11,51,28,16,23,77,43,23,34,104,58,30,46,"{'F': 13, 'P': 9}","{'C': 18, 'J': 13, 'Z': 13}","{'Q': 20, 'R': 13, 'S': 7, 'T': 7, 'H': 13, 'M': 7}","{'Y': 7, 'A': 7, 'B': 3, 'D': 3, 'E': 3, 'G': 7, 'I': 3, 'K': 7, 'L': 3, 'N': 3, 'O': 3, 'U': 7, 'V': 3, 'W': 3, 'X': 3}"
INV-ZZ-4574120,SCH-ZZ-6469147,ZZ,ZZ20240512HYDAMD2299.0,2299.0,Airbus A321 Neo,05/12/2024,2024-05-12 01:59:00,2024-05-12 21:45:00,HYD,AMD,220.0,244,126,-94,118,22,44,66,88,26,13,9,13,52,27,17,25,79,41,25,38,98,51,37,47,"{'F': 13, 'P': 9}","{'C': 18, 'J': 13, 'Z': 13}","{'Q': 20, 'R': 13, 'S': 7, 'T': 7, 'H': 13, 'M': 7}","{'Y': 7, 'A': 7, 'B': 3, 'D': 3, 'E': 3, 'G': 7, 'I': 3, 'K': 7, 'L': 3, 'N': 3, 'O': 3, 'U': 7, 'V': 3, 'W': 3, 'X': 3}"
INV-ZZ-4173904,SCH-ZZ-6469147,ZZ,ZZ20240513HYDAMD2299.0,2299.0,Airbus A321 Neo,05/13/2024,2024-05-13 01:59:00,2024-05-13 21:45:00,HYD,AMD,220.0,261,134,-86,127,22,44,66,88,24,12,10,12,49,25,19,24,77,40,26,37,99,51,37,48,"{'F': 13, 'P': 9}","{'C': 18, 'J': 13, 'Z': 13}","{'Q': 20, 'R': 13, 'S': 7, 'T': 7, 'H': 13, 'M': 7}","{'Y': 7, 'A': 7, 'B': 3, 'D': 3, 'E': 3, 'G': 7, 'I': 3, 'K': 7, 'L': 3, 'N': 3, 'O': 3, 'U': 7, 'V': 3, 'W': 3, 'X': 3}"
INV-ZZ-1093151,SCH-ZZ-6469147,ZZ,ZZ20240514HYDAMD2299.0,2299.0,Airbus A321 Neo,05/14/2024,2024-05-14 01:59:00,2024-05-14 21:45:00,HYD,AMD,220.0,261,126,-94,135,22,44,66,88,25,12,10,13,51,25,19,26,75,36,30,39,104,50,38,54,"{'F': 13, 'P': 9}","{'C': 18, 'J': 13, 'Z': 13}","{'Q': 20, 'R': 13, 'S': 7, 'T': 7, 'H': 13, 'M': 7}","{'Y': 7, 'A': 7, 'B': 3, 'D': 3, 'E': 3, 'G': 7, 'I': 3, 'K': 7, 'L': 3, 'N': 3, 'O': 3, 'U': 7, 'V': 3, 'W': 3, 'X': 3}"
INV-ZZ-6448069,SCH-ZZ-6469147,ZZ,ZZ20240515HYDAMD2299.0,2299.0,Airbus A321 Neo,05/15/2024,2024-05-15 01:59:00,2024-05-15 21:45:00,HYD,AMD,220.0,249,130,-90,119,22,44,66,88,24,13,9,11,52,27,17,25,79,41,25,38,101,53,35,48,"{'F': 13, 'P': 9}","{'C': 18, 'J': 13, 'Z': 13}","{'Q': 20, 'R': 13, 'S': 7, 'T': 7, 'H': 13, 'M': 7}","{'Y': 7, 'A': 7, 'B': 3, 'D': 3, 'E': 3, 'G': 7, 'I': 3, 'K': 7, 'L': 3, 'N': 3, 'O': 3, 'U': 7, 'V': 3, 'W': 3, 'X': 3}"
INV-ZZ-6895189,SCH-ZZ-6469147,ZZ,ZZ20240517HYDAMD2299.0,2299.0,Airbus A321 Neo,05/17/2024,2024-05-17 01:59:00,2024-05-17 21:45:00,HYD,AMD,220.0,249,124,-96,125,22,44,66,88,25,12,10,13,51,25,19,26,77,38,28,39,101,50,38,51,"{'F': 13, 'P': 9}","{'C': 18, 'J': 13, 'Z': 13}","{'Q': 20, 'R': 13, 'S': 7, 'T': 7, 'H': 13, 'M': 7}","{'Y': 7, 'A': 7, 'B': 3, 'D': 3, 'E': 3, 'G': 7, 'I': 3, 'K': 7, 'L': 3, 'N': 3, 'O': 3, 'U': 7, 'V': 3, 'W': 3, 'X': 3}"
INV-ZZ-9723952,SCH-ZZ-6469147,ZZ,ZZ20240519HYDAMD2299.0,2299.0,Airbus A321 Neo,05/19/2024,2024-05-19 01:59:00,2024-05-19 21:45:00,HYD,AMD,220.0,262,144,-76,118,22,44,66,88,24,13,9,11,52,28,16,24,73,40,26,33,100,55,33,45,"{'F': 13, 'P': 9}","{'C': 18, 'J': 13, 'Z': 13}","{'Q': 20, 'R': 13, 'S': 7, 'T': 7, 'H': 13, 'M': 7}","{'Y': 7, 'A': 7, 'B': 3, 'D': 3, 'E': 3, 'G': 7, 'I': 3, 'K': 7, 'L': 3, 'N': 3, 'O': 3, 'U': 7, 'V': 3, 'W': 3, 'X': 3}"
INV-ZZ-4574593,SCH-ZZ-6469147,ZZ,ZZ20240520HYDAMD2299.0,2299.0,Airbus A321 Neo,05/20/2024,2024-05-20 01:59:00,2024-05-20 21:45:00,HYD,AMD,220.0,259,122,-98,137,22,44,66,88,26,12,10,14,49,23,21,26,78,37,29,41,98,46,42,52,"{'F': 13, 'P': 9}","{'C': 18, 'J': 13, 'Z': 13}","{'Q': 20, 'R': 13, 'S': 7, 'T': 7, 'H': 13, 'M': 7}","{'Y': 7, 'A': 7, 'B': 3, 'D': 3, 'E': 3, 'G': 7, 'I': 3, 'K': 7, 'L': 3, 'N': 3, 'O': 3, 'U': 7, 'V': 3, 'W': 3, 'X': 3}"
INV-ZZ-7577593,SCH-ZZ-6469147,ZZ,ZZ20240521HYDAMD2299.0,2299.0,Airbus A321 Neo,05/21/2024,2024-05-21 01:59:00,2024-05-21 21:45:00,HYD,AMD,220.0,253,127,-93,126,22,44,66,88,26,13,9,13,49,25,19,24,75,38,28,37,99,50,38,49,"{'F': 13, 'P': 9}","{'C': 18, 'J': 13, 'Z': 13}","{'Q': 20, 'R': 13, 'S': 7, 'T': 7, 'H': 13, 'M': 7}","{'Y': 7, 'A': 7, 'B': 3, 'D': 3, 'E': 3, 'G': 7, 'I': 3, 'K': 7, 'L': 3, 'N': 3, 'O': 3, 'U': 7, 'V': 3, 'W': 3, 'X': 3}"
INV-ZZ-5768253,SCH-ZZ-6469147,ZZ,ZZ20240522HYDAMD2299.0,2299.0,Airbus A321 Neo,05/22/2024,2024-05-22 01:59:00,2024-05-22 21:45:00,HYD,AMD,220.0,250,123,-97,127,22,44,66,88,25,12,10,13,51,25,19,26,73,36,30,37,105,52,36,53,"{'F': 13, 'P': 9}","{'C': 18, 'J': 13, 'Z': 13}","{'Q': 20, 'R': 13, 'S': 7, 'T': 7, 'H': 13, 'M': 7}","{'Y': 7, 'A': 7, 'B': 3, 'D': 3, 'E': 3, 'G': 7, 'I': 3, 'K': 7, 'L': 3, 'N': 3, 'O': 3, 'U': 7, 'V': 3, 'W': 3, 'X': 3}"
INV-ZZ-6439837,SCH-ZZ-6469147,ZZ,ZZ20240524HYDAMD2299.0,2299.0,Airbus A321 Neo,05/24/2024,2024-05-24 01:59:00,2024-05-24 21:45:00,HYD,AMD,220.0,242,122,-98,120,22,44,66,88,25,13,9,12,49,25,19,24,74,37,29,37,105,53,35,52,"{'F': 13, 'P': 9}","{'C': 18, 'J': 13, 'Z': 13}","{'Q': 20, 'R': 13, 'S': 7, 'T': 7, 'H': 13, 'M': 7}","{'Y': 7, 'A': 7, 'B': 3, 'D': 3, 'E': 3, 'G': 7, 'I': 3, 'K': 7, 'L': 3, 'N': 3, 'O': 3, 'U': 7, 'V': 3, 'W': 3, 'X': 3}"
INV-ZZ-9813049,SCH-ZZ-6469147,ZZ,ZZ20240526HYDAMD2299.0,2299.0,Airbus A321 Neo,05/26/2024,2024-05-26 01:59:00,2024-05-26 21:45:00,HYD,AMD,220.0,257,127,-93,130,22,44,66,88,26,13,9,13,50,25,19,25,78,39,27,39,100,49,39,51,"{'F': 13, 'P': 9}","{'C': 18, 'J': 13, 'Z': 13}","{'Q': 20, 'R': 13, 'S': 7, 'T': 7, 'H': 13, 'M': 7}","{'Y': 7, 'A': 7, 'B': 3, 'D': 3, 'E': 3, 'G': 7, 'I': 3, 'K': 7, 'L': 3, 'N': 3, 'O': 3, 'U': 7, 'V': 3, 'W': 3, 'X': 3}"
INV-ZZ-3550044,SCH-ZZ-6469147,ZZ,ZZ20240527HYDAMD2299.0,2299.0,Airbus A321 Neo,05/27/2024,2024-05-27 01:59:00,2024-05-27 21:45:00,HYD,AMD,220.0,258,123,-97,135,22,44,66,88,25,12,10,13,49,23,21,26,74,35,31,39,99,47,41,52,"{'F': 13, 'P': 9}","{'C': 18, 'J': 13, 'Z': 13}","{'Q': 20, 'R': 13, 'S': 7, 'T': 7, 'H': 13, 'M': 7}","{'Y': 7, 'A': 7, 'B': 3, 'D': 3, 'E': 3, 'G': 7, 'I': 3, 'K': 7, 'L': 3, 'N': 3, 'O': 3, 'U': 7, 'V': 3, 'W': 3, 'X': 3}"
INV-ZZ-7574061,SCH-ZZ-6469147,ZZ,ZZ20240528HYDAMD2299.0,2299.0,Airbus A321 Neo,05/28/2024,2024-05-28 01:59:00,2024-05-28 21:45:00,HYD,AMD,220.0,251,130,-90,121,22,44,66,88,24,12,10,12,51,26,18,25,75,39,27,36,102,53,35,49,"{'F': 13, 'P': 9}","{'C': 18, 'J': 13, 'Z': 13}","{'Q': 20, 'R': 13, 'S': 7, 'T': 7, 'H': 13, 'M': 7}","{'Y': 7, 'A': 7, 'B': 3, 'D': 3, 'E': 3, 'G': 7, 'I': 3, 'K': 7, 'L': 3, 'N': 3, 'O': 3, 'U': 7, 'V': 3, 'W': 3, 'X': 3}"
INV-ZZ-8744369,SCH-ZZ-6469147,ZZ,ZZ20240529HYDAMD2299.0,2299.0,Airbus A321 Neo,05/29/2024,2024-05-29 01:59:00,2024-05-29 21:45:00,HYD,AMD,220.0,248,123,-97,125,22,44,66,88,24,12,10,12,52,26,18,26,79,39,27,40,104,51,37,53,"{'F': 13, 'P': 9}","{'C': 18, 'J': 13, 'Z': 13}","{'Q': 20, 'R': 13, 'S': 7, 'T': 7, 'H': 13, 'M': 7}","{'Y': 7, 'A': 7, 'B': 3, 'D': 3, 'E': 3, 'G': 7, 'I': 3, 'K': 7, 'L': 3, 'N': 3, 'O': 3, 'U': 7, 'V': 3, 'W': 3, 'X': 3}"
INV-ZZ-5522329,SCH-ZZ-6469147,ZZ,ZZ20240531HYDAMD2299.0,2299.0,Airbus A321 Neo,05/31/2024,2024-05-31 01:59:00,2024-05-31 21:45:00,HYD,AMD,220.0,243,114,-106,129,22,44,66,88,26,12,10,14,52,24,20,28,79,37,29,42,105,49,39,56,"{'F': 13, 'P': 9}","{'C': 18, 'J': 13, 'Z': 13}","{'Q': 20, 'R': 13, 'S': 7, 'T': 7, 'H': 13, 'M': 7}","{'Y': 7, 'A': 7, 'B': 3, 'D': 3, 'E': 3, 'G': 7, 'I': 3, 'K': 7, 'L': 3, 'N': 3, 'O': 3, 'U': 7, 'V': 3, 'W': 3, 'X': 3}"
INV-ZZ-7707471,SCH-ZZ-1898733,ZZ,ZZ20240504MAACCU4838.0,4838.0,Boeing 777-300,05/04/2024,2024-05-04 08:02:00,2024-05-05 00:39:00,MAA,CCU,360.0,397,207,-153,190,36,72,108,144,42,22,14,20,84,44,28,40,120,63,45,57,164,86,58,78,"{'F': 22, 'P': 14}","{'C': 29, 'J': 22, 'Z': 22}","{'Q': 32, 'R': 22, 'S': 11, 'T': 11, 'H': 22, 'M': 11}","{'Y': 11, 'A': 11, 'B': 5, 'D': 5, 'E': 5, 'G': 11, 'I': 5, 'K': 11, 'L': 5, 'N': 5, 'O': 5, 'U': 11, 'V': 5, 'W': 5, 'X': 5}"
INV-ZZ-6424564,SCH-ZZ-1898733,ZZ,ZZ20240506MAACCU4838.0,4838.0,Boeing 777-300,05/06/2024,2024-05-06 08:02:00,2024-05-07 00:39:00,MAA,CCU,360.0,415,209,-151,206,36,72,108,144,41,21,15,20,80,40,32,40,129,65,43,64,165,83,61,82,"{'F': 22, 'P': 14}","{'C': 29, 'J': 22, 'Z': 22}","{'Q': 32, 'R': 22, 'S': 11, 'T': 11, 'H': 22, 'M': 11}","{'Y': 11, 'A': 11, 'B': 5, 'D': 5, 'E': 5, 'G': 11, 'I': 5, 'K': 11, 'L': 5, 'N': 5, 'O': 5, 'U': 11, 'V': 5, 'W': 5, 'X': 5}"
INV-ZZ-5572999,SCH-ZZ-1898733,ZZ,ZZ20240508MAACCU4838.0,4838.0,Boeing 777-300,05/08/2024,2024-05-08 08:02:00,2024-05-09 00:39:00,MAA,CCU,360.0,426,216,-144,210,36,72,108,144,42,21,15,21,86,44,28,42,123,62,46,61,162,82,62,80,"{'F': 22, 'P': 14}","{'C': 29, 'J': 22, 'Z': 22}","{'Q': 32, 'R': 22, 'S': 11, 'T': 11, 'H': 22, 'M': 11}","{'Y': 11, 'A': 11, 'B': 5, 'D': 5, 'E': 5, 'G': 11, 'I': 5, 'K': 11, 'L': 5, 'N': 5, 'O': 5, 'U': 11, 'V': 5, 'W': 5, 'X': 5}"
INV-ZZ-6810999,SCH-ZZ-1898733,ZZ,ZZ20240511MAACCU4838.0,4838.0,Boeing 777-300,05/11/2024,2024-05-11 08:02:00,2024-05-12 00:39:00,MAA,CCU,360.0,416,221,-139,195,36,72,108,144,43,23,13,20,85,45,27,40,126,67,41,59,160,85,59,75,"{'F': 22, 'P': 14}","{'C': 29, 'J': 22, 'Z': 22}","{'Q': 32, 'R': 22, 'S': 11, 'T': 11, 'H': 22, 'M': 11}","{'Y': 11, 'A': 11, 'B': 5, 'D': 5, 'E': 5, 'G': 11, 'I': 5, 'K': 11, 'L': 5, 'N': 5, 'O': 5, 'U': 11, 'V': 5, 'W': 5, 'X': 5}"
INV-ZZ-7782554,SCH-ZZ-1898733,ZZ,ZZ20240513MAACCU4838.0,4838.0,Boeing 777-300,05/13/2024,2024-05-13 08:02:00,2024-05-14 00:39:00,MAA,CCU,360.0,427,237,-123,190,36,72,108,144,41,23,13,18,83,46,26,37,124,69,39,55,167,93,51,74,"{'F': 22, 'P': 14}","{'C': 29, 'J': 22, 'Z': 22}","{'Q': 32, 'R': 22, 'S': 11, 'T': 11, 'H': 22, 'M': 11}","{'Y': 11, 'A': 11, 'B': 5, 'D': 5, 'E': 5, 'G': 11, 'I': 5, 'K': 11, 'L': 5, 'N': 5, 'O': 5, 'U': 11, 'V': 5, 'W': 5, 'X': 5}"
INV-ZZ-1013501,SCH-ZZ-1898733,ZZ,ZZ20240515MAACCU4838.0,4838.0,Boeing 777-300,05/15/2024,2024-05-15 08:02:00,2024-05-16 00:39:00,MAA,CCU,360.0,430,234,-126,196,36,72,108,144,40,22,14,18,85,46,26,39,129,70,38,59,159,86,58,73,"{'F': 22, 'P': 14}","{'C': 29, 'J': 22, 'Z': 22}","{'Q': 32, 'R': 22, 'S': 11, 'T': 11, 'H': 22, 'M': 11}","{'Y': 11, 'A': 11, 'B': 5, 'D': 5, 'E': 5, 'G': 11, 'I': 5, 'K': 11, 'L': 5, 'N': 5, 'O': 5, 'U': 11, 'V': 5, 'W': 5, 'X': 5}"
INV-ZZ-6434935,SCH-ZZ-1898733,ZZ,ZZ20240518MAACCU4838.0,4838.0,Boeing 777-300,05/18/2024,2024-05-18 08:02:00,2024-05-19 00:39:00,MAA,CCU,360.0,406,214,-146,192,36,72,108,144,42,22,14,20,85,45,27,40,122,64,44,58,161,85,59,76,"{'F': 22, 'P': 14}","{'C': 29, 'J': 22, 'Z': 22}","{'Q': 32, 'R': 22, 'S': 11, 'T': 11, 'H': 22, 'M': 11}","{'Y': 11, 'A': 11, 'B': 5, 'D': 5, 'E': 5, 'G': 11, 'I': 5, 'K': 11, 'L': 5, 'N': 5, 'O': 5, 'U': 11, 'V': 5, 'W': 5, 'X': 5}"
INV-ZZ-3823706,SCH-ZZ-1898733,ZZ,ZZ20240520MAACCU4838.0,4838.0,Boeing 777-300,05/20/2024,2024-05-20 08:02:00,2024-05-21 00:39:00,MAA,CCU,360.0,408,201,-159,207,36,72,108,144,42,21,15,21,82,40,32,42,123,61,47,62,172,85,59,87,"{'F': 22, 'P': 14}","{'C': 29, 'J': 22, 'Z': 22}","{'Q': 32, 'R': 22, 'S': 11, 'T': 11, 'H': 22, 'M': 11}","{'Y': 11, 'A': 11, 'B': 5, 'D': 5, 'E': 5, 'G': 11, 'I': 5, 'K': 11, 'L': 5, 'N': 5, 'O': 5, 'U': 11, 'V': 5, 'W': 5, 'X': 5}"
INV-ZZ-5536960,SCH-ZZ-1898733,ZZ,ZZ20240522MAACCU4838.0,4838.0,Boeing 777-300,05/22/2024,2024-05-22 08:02:00,2024-05-23 00:39:00,MAA,CCU,360.0,401,214,-146,187,36,72,108,144,42,22,14,20,86,46,26,40,128,68,40,60,160,86,58,74,"{'F': 22, 'P': 14}","{'C': 29, 'J': 22, 'Z': 22}","{'Q': 32, 'R': 22, 'S': 11, 'T': 11, 'H': 22, 'M': 11}","{'Y': 11, 'A': 11, 'B': 5, 'D': 5, 'E': 5, 'G': 11, 'I': 5, 'K': 11, 'L': 5, 'N': 5, 'O': 5, 'U': 11, 'V': 5, 'W': 5, 'X': 5}"
INV-ZZ-8946118,SCH-ZZ-1898733,ZZ,ZZ20240525MAACCU4838.0,4838.0,Boeing 777-300,05/25/2024,2024-05-25 08:02:00,2024-05-26 00:39:00,MAA,CCU,360.0,406,211,-149,195,36,72,108,144,43,22,14,21,86,45,27,41,124,64,44,60,172,89,55,83,"{'F': 22, 'P': 14}","{'C': 29, 'J': 22, 'Z': 22}","{'Q': 32, 'R': 22, 'S': 11, 'T': 11, 'H': 22, 'M': 11}","{'Y': 11, 'A': 11, 'B': 5, 'D': 5, 'E': 5, 'G': 11, 'I': 5, 'K': 11, 'L': 5, 'N': 5, 'O': 5, 'U': 11, 'V': 5, 'W': 5, 'X': 5}"
INV-ZZ-7103705,SCH-ZZ-1898733,ZZ,ZZ20240527MAACCU4838.0,4838.0,Boeing 777-300,05/27/2024,2024-05-27 08:02:00,2024-05-28 00:39:00,MAA,CCU,360.0,424,207,-153,217,36,72,108,144,40,20,16,20,80,39,33,41,125,61,47,64,160,78,66,82,"{'F': 22, 'P': 14}","{'C': 29, 'J': 22, 'Z': 22}","{'Q': 32, 'R': 22, 'S': 11, 'T': 11, 'H': 22, 'M': 11}","{'Y': 11, 'A': 11, 'B': 5, 'D': 5, 'E': 5, 'G': 11, 'I': 5, 'K': 11, 'L': 5, 'N': 5, 'O': 5, 'U': 11, 'V': 5, 'W': 5, 'X': 5}"
INV-ZZ-1739981,SCH-ZZ-1898733,ZZ,ZZ20240529MAACCU4838.0,4838.0,Boeing 777-300,05/29/2024,2024-05-29 08:02:00,2024-05-30 00:39:00,MAA,CCU,360.0,427,211,-149,216,36,72,108,144,43,21,15,22,82,41,31,41,121,60,48,61,166,82,62,84,"{'F': 22, 'P': 14}","{'C': 29, 'J': 22, 'Z': 22}","{'Q': 32, 'R': 22, 'S': 11, 'T': 11, 'H': 22, 'M': 11}","{'Y': 11, 'A': 11, 'B': 5, 'D': 5, 'E': 5, 'G': 11, 'I': 5, 'K': 11, 'L': 5, 'N': 5, 'O': 5, 'U': 11, 'V': 5, 'W': 5, 'X': 5}"
INV-ZZ-3181348,SCH-ZZ-1898733,ZZ,ZZ20240601MAACCU4838.0,4838.0,Boeing 777-300,06/01/2024,2024-06-01 08:02:00,2024-06-02 00:39:00,MAA,CCU,360.0,415,196,-164,219,36,72,108,144,40,19,17,21,81,38,34,43,126,59,49,67,161,76,68,85,"{'F': 22, 'P': 14}","{'C': 29, 'J': 22, 'Z': 22}","{'Q': 32, 'R': 22, 'S': 11, 'T': 11, 'H': 22, 'M': 11}","{'Y': 11, 'A': 11, 'B': 5, 'D': 5, 'E': 5, 'G': 11, 'I': 5, 'K': 11, 'L': 5, 'N': 5, 'O': 5, 'U': 11, 'V': 5, 'W': 5, 'X': 5}"
INV-ZZ-8073365,SCH-ZZ-1898733,ZZ,ZZ20240603MAACCU4838.0,4838.0,Boeing 777-300,06/03/2024,2024-06-03 08:02:00,2024-06-04 00:39:00,MAA,CCU,360.0,427,201,-159,226,36,72,108,144,42,20,16,22,83,39,33,44,121,57,51,64,171,80,64,91,"{'F': 22, 'P': 14}","{'C': 29, 'J': 22, 'Z': 22}","{'Q': 32, 'R': 22, 'S': 11, 'T': 11, 'H': 22, 'M': 11}","{'Y': 11, 'A': 11, 'B': 5, 'D': 5, 'E': 5, 'G': 11, 'I': 5, 'K': 11, 'L': 5, 'N': 5, 'O': 5, 'U': 11, 'V': 5, 'W': 5, 'X': 5}"
INV-ZZ-3251391,SCH-ZZ-1898733,ZZ,ZZ20240605MAACCU4838.0,4838.0,Boeing 777-300,06/05/2024,2024-06-05 08:02:00,2024-06-06 00:39:00,MAA,CCU,360.0,422,210,-150,212,36,72,108,144,41,20,16,21,82,41,31,41,119,59,49,60,161,80,64,81,"{'F': 22, 'P': 14}","{'C': 29, 'J': 22, 'Z': 22}","{'Q': 32, 'R': 22, 'S': 11, 'T': 11, 'H': 22, 'M': 11}","{'Y': 11, 'A': 11, 'B': 5, 'D': 5, 'E': 5, 'G': 11, 'I': 5, 'K': 11, 'L': 5, 'N': 5, 'O': 5, 'U': 11, 'V': 5, 'W': 5, 'X': 5}"
INV-ZZ-3012347,SCH-ZZ-1898733,ZZ,ZZ20240608MAACCU4838.0,4838.0,Boeing 777-300,06/08/2024,2024-06-08 08:02:00,2024-06-09 00:39:00,MAA,CCU,360.0,404,173,-187,231,36,72,108,144,42,18,18,24,85,36,36,49,123,53,55,70,159,68,76,91,"{'F': 22, 'P': 14}","{'C': 29, 'J': 22, 'Z': 22}","{'Q': 32, 'R': 22, 'S': 11, 'T': 11, 'H': 22, 'M': 11}","{'Y': 11, 'A': 11, 'B': 5, 'D': 5, 'E': 5, 'G': 11, 'I': 5, 'K': 11, 'L': 5, 'N': 5, 'O': 5, 'U': 11, 'V': 5, 'W': 5, 'X': 5}"
INV-ZZ-6163754,SCH-ZZ-1898733,ZZ,ZZ20240610MAACCU4838.0,4838.0,Boeing 777-300,06/10/2024,2024-06-10 08:02:00,2024-06-11 00:39:00,MAA,CCU,360.0,404,179,-181,225,36,72,108,144,42,19,17,23,85,38,34,47,123,55,53,68,160,71,73,89,"{'F': 22, 'P': 14}","{'C': 29, 'J': 22, 'Z': 22}","{'Q': 32, 'R': 22, 'S': 11, 'T': 11, 'H': 22, 'M': 11}","{'Y': 11, 'A': 11, 'B': 5, 'D': 5, 'E': 5, 'G': 11, 'I': 5, 'K': 11, 'L': 5, 'N': 5, 'O': 5, 'U': 11, 'V': 5, 'W': 5, 'X': 5}"
INV-ZZ-7804195,SCH-ZZ-1898733,ZZ,ZZ20240612MAACCU4838.0,4838.0,Boeing 777-300,06/12/2024,2024-06-12 08:02:00,2024-06-13 00:39:00,MAA,CCU,360.0,424,199,-161,225,36,72,108,144,41,19,17,22,86,40,32,46,121,57,51,64,161,76,68,85,"{'F': 22, 'P': 14}","{'C': 29, 'J': 22, 'Z': 22}","{'Q': 32, 'R': 22, 'S': 11, 'T': 11, 'H': 22, 'M': 11}","{'Y': 11, 'A': 11, 'B': 5, 'D': 5, 'E': 5, 'G': 11, 'I': 5, 'K': 11, 'L': 5, 'N': 5, 'O': 5, 'U': 11, 'V': 5, 'W': 5, 'X': 5}"
INV-ZZ-4323656,SCH-ZZ-1898733,ZZ,ZZ20240615MAACCU4838.0,4838.0,Boeing 777-300,06/15/2024,2024-06-15 08:02:00,2024-06-16 00:39:00,MAA,CCU,360.0,426,189,-171,237,36,72,108,144,40,18,18,22,81,36,36,45,129,57,51,72,172,76,68,96,"{'F': 22, 'P': 14}","{'C': 29, 'J': 22, 'Z': 22}","{'Q': 32, 'R': 22, 'S': 11, 'T': 11, 'H': 22, 'M': 11}","{'Y': 11, 'A': 11, 'B': 5, 'D': 5, 'E': 5, 'G': 11, 'I': 5, 'K': 11, 'L': 5, 'N': 5, 'O': 5, 'U': 11, 'V': 5, 'W': 5, 'X': 5}"
INV-ZZ-5347107,SCH-ZZ-1589980,ZZ,ZZ20240421BOMDEL2019.0,2019.0,Airbus A320 Neo,04/21/2024,2024-04-21 16:42:00,2024-04-22 04:40:00,BOM,DEL,180.0,203,116,-64,87,18,36,54,72,21,12,6,9,42,24,12,18,61,35,19,26,81,46,26,35,"{'F': 11, 'P': 7}","{'C': 14, 'J': 11, 'Z': 11}","{'Q': 16, 'R': 11, 'S': 5, 'T': 5, 'H': 11, 'M': 5}","{'Y': 5, 'A': 5, 'B': 3, 'D': 3, 'E': 3, 'G': 5, 'I': 3, 'K': 5, 'L': 3, 'N': 3, 'O': 3, 'U': 5, 'V': 3, 'W': 3, 'X': 3}"
INV-ZZ-4434695,SCH-ZZ-1589980,ZZ,ZZ20240422BOMDEL2019.0,2019.0,Airbus A320 Neo,04/22/2024,2024-04-22 16:42:00,2024-04-23 04:40:00,BOM,DEL,180.0,208,128,-52,80,18,36,54,72,20,12,6,8,43,26,10,17,62,38,16,24,83,51,21,32,"{'F': 11, 'P': 7}","{'C': 14, 'J': 11, 'Z': 11}","{'Q': 16, 'R': 11, 'S': 5, 'T': 5, 'H': 11, 'M': 5}","{'Y': 5, 'A': 5, 'B': 3, 'D': 3, 'E': 3, 'G': 5, 'I': 3, 'K': 5, 'L': 3, 'N': 3, 'O': 3, 'U': 5, 'V': 3, 'W': 3, 'X': 3}"
INV-ZZ-3384707,SCH-ZZ-1589980,ZZ,ZZ20240424BOMDEL2019.0,2019.0,Airbus A320 Neo,04/24/2024,2024-04-24 16:42:00,2024-04-25 04:40:00,BOM,DEL,180.0,204,123,-57,81,18,36,54,72,21,13,5,8,42,25,11,17,62,37,17,25,83,50,22,33,"{'F': 11, 'P': 7}","{'C': 14, 'J': 11, 'Z': 11}","{'Q': 16, 'R': 11, 'S': 5, 'T': 5, 'H': 11, 'M': 5}","{'Y': 5, 'A': 5, 'B': 3, 'D': 3, 'E': 3, 'G': 5, 'I': 3, 'K': 5, 'L': 3, 'N': 3, 'O': 3, 'U': 5, 'V': 3, 'W': 3, 'X': 3}"
INV-ZZ-5961863,SCH-ZZ-1589980,ZZ,ZZ20240425BOMDEL2019.0,2019.0,Airbus A320 Neo,04/25/2024,2024-04-25 16:42:00,2024-04-26 04:40:00,BOM,DEL,180.0,212,125,-55,87,18,36,54,72,20,12,6,8,42,25,11,17,61,36,18,25,81,48,24,33,"{'F': 11, 'P': 7}","{'C': 14, 'J': 11, 'Z': 11}","{'Q': 16, 'R': 11, 'S': 5, 'T': 5, 'H': 11, 'M': 5}","{'Y': 5, 'A': 5, 'B': 3, 'D': 3, 'E': 3, 'G': 5, 'I': 3, 'K': 5, 'L': 3, 'N': 3, 'O': 3, 'U': 5, 'V': 3, 'W': 3, 'X': 3}"
INV-ZZ-8076299,SCH-ZZ-1589980,ZZ,ZZ20240426BOMDEL2019.0,2019.0,Airbus A320 Neo,04/26/2024,2024-04-26 16:42:00,2024-04-27 04:40:00,BOM,DEL,180.0,204,121,-59,83,18,36,54,72,21,12,6,9,42,25,11,17,63,37,17,26,82,49,23,33,"{'F': 11, 'P': 7}","{'C': 14, 'J': 11, 'Z': 11}","{'Q': 16, 'R': 11, 'S': 5, 'T': 5, 'H': 11, 'M': 5}","{'Y': 5, 'A': 5, 'B': 3, 'D': 3, 'E': 3, 'G': 5, 'I': 3, 'K': 5, 'L': 3, 'N': 3, 'O': 3, 'U': 5, 'V': 3, 'W': 3, 'X': 3}"
INV-ZZ-9771525,SCH-ZZ-1589980,ZZ,ZZ20240427BOMDEL2019.0,2019.0,Airbus A320 Neo,04/27/2024,2024-04-27 16:42:00,2024-04-28 04:40:00,BOM,DEL,180.0,206,117,-63,89,18,36,54,72,21,12,6,9,41,23,13,18,64,36,18,28,83,47,25,36,"{'F': 11, 'P': 7}","{'C': 14, 'J': 11, 'Z': 11}","{'Q': 16, 'R': 11, 'S': 5, 'T': 5, 'H': 11, 'M': 5}","{'Y': 5, 'A': 5, 'B': 3, 'D': 3, 'E': 3, 'G': 5, 'I': 3, 'K': 5, 'L': 3, 'N': 3, 'O': 3, 'U': 5, 'V': 3, 'W': 3, 'X': 3}"
INV-ZZ-1548562,SCH-ZZ-1589980,ZZ,ZZ20240428BOMDEL2019.0,2019.0,Airbus A320 Neo,04/28/2024,2024-04-28 16:42:00,2024-04-29 04:40:00,BOM,DEL,180.0,215,112,-68,103,18,36,54,72,21,11,7,10,41,21,15,20,62,32,22,30,82,43,29,39,"{'F': 11, 'P': 7}","{'C': 14, 'J': 11, 'Z': 11}","{'Q': 16, 'R': 11, 'S': 5, 'T': 5, 'H': 11, 'M': 5}","{'Y': 5, 'A': 5, 'B': 3, 'D': 3, 'E': 3, 'G': 5, 'I': 3, 'K': 5, 'L': 3, 'N': 3, 'O': 3, 'U': 5, 'V': 3, 'W': 3, 'X': 3}"
INV-ZZ-4216782,SCH-ZZ-1589980,ZZ,ZZ20240429BOMDEL2019.0,2019.0,Airbus A320 Neo,04/29/2024,2024-04-29 16:42:00,2024-04-30 04:40:00,BOM,DEL,180.0,202,114,-66,88,18,36,54,72,21,12,6,9,43,24,12,19,63,36,18,27,84,47,25,37,"{'F': 11, 'P': 7}","{'C': 14, 'J': 11, 'Z': 11}","{'Q': 16, 'R': 11, 'S': 5, 'T': 5, 'H': 11, 'M': 5}","{'Y': 5, 'A': 5, 'B': 3, 'D': 3, 'E': 3, 'G': 5, 'I': 3, 'K': 5, 'L': 3, 'N': 3, 'O': 3, 'U': 5, 'V': 3, 'W': 3, 'X': 3}"
INV-ZZ-7210908,SCH-ZZ-1589980,ZZ,ZZ20240501BOMDEL2019.0,2019.0,Airbus A320 Neo,05/01/2024,2024-05-01 16:42:00,2024-05-02 04:40:00,BOM,DEL,180.0,201,117,-63,84,18,36,54,72,22,13,5,9,42,24,12,18,64,37,17,27,80,47,25,33,"{'F': 11, 'P': 7}","{'C': 14, 'J': 11, 'Z': 11}","{'Q': 16, 'R': 11, 'S': 5, 'T': 5, 'H': 11, 'M': 5}","{'Y': 5, 'A': 5, 'B': 3, 'D': 3, 'E': 3, 'G': 5, 'I': 3, 'K': 5, 'L': 3, 'N': 3, 'O': 3, 'U': 5, 'V': 3, 'W': 3, 'X': 3}"
INV-ZZ-6845331,SCH-ZZ-1589980,ZZ,ZZ20240502BOMDEL2019.0,2019.0,Airbus A320 Neo,05/02/2024,2024-05-02 16:42:00,2024-05-03 04:40:00,BOM,DEL,180.0,199,112,-68,87,18,36,54,72,20,11,7,9,42,24,12,18,60,34,20,26,86,48,24,38,"{'F': 11, 'P': 7}","{'C': 14, 'J': 11, 'Z': 11}","{'Q': 16, 'R': 11, 'S': 5, 'T': 5, 'H': 11, 'M': 5}","{'Y': 5, 'A': 5, 'B': 3, 'D': 3, 'E': 3, 'G': 5, 'I': 3, 'K': 5, 'L': 3, 'N': 3, 'O': 3, 'U': 5, 'V': 3, 'W': 3, 'X': 3}"
INV-ZZ-7625532,SCH-ZZ-1589980,ZZ,ZZ20240503BOMDEL2019.0,2019.0,Airbus A320 Neo,05/03/2024,2024-05-03 16:42:00,2024-05-04 04:40:00,BOM,DEL,180.0,215,114,-66,101,18,36,54,72,20,11,7,9,41,22,14,19,65,34,20,31,86,45,27,41,"{'F': 11, 'P': 7}","{'C': 14, 'J': 11, 'Z': 11}","{'Q': 16, 'R': 11, 'S': 5, 'T': 5, 'H': 11, 'M': 5}","{'Y': 5, 'A': 5, 'B': 3, 'D': 3, 'E': 3, 'G': 5, 'I': 3, 'K': 5, 'L': 3, 'N': 3, 'O': 3, 'U': 5, 'V': 3, 'W': 3, 'X': 3}"
INV-ZZ-7490389,SCH-ZZ-1589980,ZZ,ZZ20240504BOMDEL2019.0,2019.0,Airbus A320 Neo,05/04/2024,2024-05-04 16:42:00,2024-05-05 04:40:00,BOM,DEL,180.0,210,115,-65,95,18,36,54,72,21,11,7,10,43,24,12,19,63,34,20,29,85,47,25,38,"{'F': 11, 'P': 7}","{'C': 14, 'J': 11, 'Z': 11}","{'Q': 16, 'R': 11, 'S': 5, 'T': 5, 'H': 11, 'M': 5}","{'Y': 5, 'A': 5, 'B': 3, 'D': 3, 'E': 3, 'G': 5, 'I': 3, 'K': 5, 'L': 3, 'N': 3, 'O': 3, 'U': 5, 'V': 3, 'W': 3, 'X': 3}"
INV-ZZ-8292072,SCH-ZZ-1589980,ZZ,ZZ20240505BOMDEL2019.0,2019.0,Airbus A320 Neo,05/05/2024,2024-05-05 16:42:00,2024-05-06 04:40:00,BOM,DEL,180.0,200,104,-76,96,18,36,54,72,22,11,7,11,42,22,14,20,61,32,22,29,82,43,29,39,"{'F': 11, 'P': 7}","{'C': 14, 'J': 11, 'Z': 11}","{'Q': 16, 'R': 11, 'S': 5, 'T': 5, 'H': 11, 'M': 5}","{'Y': 5, 'A': 5, 'B': 3, 'D': 3, 'E': 3, 'G': 5, 'I': 3, 'K': 5, 'L': 3, 'N': 3, 'O': 3, 'U': 5, 'V': 3, 'W': 3, 'X': 3}"
INV-ZZ-8427920,SCH-ZZ-1589980,ZZ,ZZ20240506BOMDEL2019.0,2019.0,Airbus A320 Neo,05/06/2024,2024-05-06 16:42:00,2024-05-07 04:40:00,BOM,DEL,180.0,201,118,-62,83,18,36,54,72,20,12,6,8,40,24,12,16,61,36,18,25,84,49,23,35,"{'F': 11, 'P': 7}","{'C': 14, 'J': 11, 'Z': 11}","{'Q': 16, 'R': 11, 'S': 5, 'T': 5, 'H': 11, 'M': 5}","{'Y': 5, 'A': 5, 'B': 3, 'D': 3, 'E': 3, 'G': 5, 'I': 3, 'K': 5, 'L': 3, 'N': 3, 'O': 3, 'U': 5, 'V': 3, 'W': 3, 'X': 3}"
INV-ZZ-2080355,SCH-ZZ-1589980,ZZ,ZZ20240508BOMDEL2019.0,2019.0,Airbus A320 Neo,05/08/2024,2024-05-08 16:42:00,2024-05-09 04:40:00,BOM,DEL,180.0,211,117,-63,94,18,36,54,72,20,11,7,9,43,24,12,19,61,34,20,27,86,48,24,38,"{'F': 11, 'P': 7}","{'C': 14, 'J': 11, 'Z': 11}","{'Q': 16, 'R': 11, 'S': 5, 'T': 5, 'H': 11, 'M': 5}","{'Y': 5, 'A': 5, 'B': 3, 'D': 3, 'E': 3, 'G': 5, 'I': 3, 'K': 5, 'L': 3, 'N': 3, 'O': 3, 'U': 5, 'V': 3, 'W': 3, 'X': 3}"
INV-ZZ-9384535,SCH-ZZ-1589980,ZZ,ZZ20240509BOMDEL2019.0,2019.0,Airbus A320 Neo,05/09/2024,2024-05-09 16:42:00,2024-05-10 04:40:00,BOM,DEL,180.0,208,115,-65,93,18,36,54,72,22,12,6,10,43,24,12,19,64,35,19,29,81,45,27,36,"{'F': 11, 'P': 7}","{'C': 14, 'J': 11, 'Z': 11}","{'Q': 16, 'R': 11, 'S': 5, 'T': 5, 'H': 11, 'M': 5}","{'Y': 5, 'A': 5, 'B': 3, 'D': 3, 'E': 3, 'G': 5, 'I': 3, 'K': 5, 'L': 3, 'N': 3, 'O': 3, 'U': 5, 'V': 3, 'W': 3, 'X': 3}"
INV-ZZ-5468464,SCH-ZZ-1589980,ZZ,ZZ20240510BOMDEL2019.0,2019.0,Airbus A320 Neo,05/10/2024,2024-05-10 16:42:00,2024-05-11 04:40:00,BOM,DEL,180.0,208,109,-71,99,18,36,54,72,20,10,8,10,41,21,15,20,63,33,21,30,85,45,27,40,"{'F': 11, 'P': 7}","{'C': 14, 'J': 11, 'Z': 11}","{'Q': 16, 'R': 11, 'S': 5, 'T': 5, 'H': 11, 'M': 5}","{'Y': 5, 'A': 5, 'B': 3, 'D': 3, 'E': 3, 'G': 5, 'I': 3, 'K': 5, 'L': 3, 'N': 3, 'O': 3, 'U': 5, 'V': 3, 'W': 3, 'X': 3}"
INV-ZZ-9681635,SCH-ZZ-1589980,ZZ,ZZ20240511BOMDEL2019.0,2019.0,Airbus A320 Neo,05/11/2024,2024-05-11 16:42:00,2024-05-12 04:40:00,BOM,DEL,180.0,214,108,-72,106,18,36,54,72,21,11,7,10,42,21,15,21,60,30,24,30,85,43,29,42,"{'F': 11, 'P': 7}","{'C': 14, 'J': 11, 'Z': 11}","{'Q': 16, 'R': 11, 'S': 5, 'T': 5, 'H': 11, 'M': 5}","{'Y': 5, 'A': 5, 'B': 3, 'D': 3, 'E': 3, 'G': 5, 'I': 3, 'K': 5, 'L': 3, 'N': 3, 'O': 3, 'U': 5, 'V': 3, 'W': 3, 'X': 3}"
INV-ZZ-8438601,SCH-ZZ-1589980,ZZ,ZZ20240512BOMDEL2019.0,2019.0,Airbus A320 Neo,05/12/2024,2024-05-12 16:42:00,2024-05-13 04:40:00,BOM,DEL,180.0,215,115,-65,100,18,36,54,72,20,11,7,9,41,22,14,19,64,34,20,30,80,43,29,37,"{'F': 11, 'P': 7}","{'C': 14, 'J': 11, 'Z': 11}","{'Q': 16, 'R': 11, 'S': 5, 'T': 5, 'H': 11, 'M': 5}","{'Y': 5, 'A': 5, 'B': 3, 'D': 3, 'E': 3, 'G': 5, 'I': 3, 'K': 5, 'L': 3, 'N': 3, 'O': 3, 'U': 5, 'V': 3, 'W': 3, 'X': 3}"
INV-ZZ-6222020,SCH-ZZ-1589980,ZZ,ZZ20240513BOMDEL2019.0,2019.0,Airbus A320 Neo,05/13/2024,2024-05-13 16:42:00,2024-05-14 04:40:00,BOM,DEL,180.0,206,103,-77,103,18,36,54,72,20,10,8,10,42,21,15,21,62,31,23,31,81,40,32,41,"{'F': 11, 'P': 7}","{'C': 14, 'J': 11, 'Z': 11}","{'Q': 16, 'R': 11, 'S': 5, 'T': 5, 'H': 11, 'M': 5}","{'Y': 5, 'A': 5, 'B': 3, 'D': 3, 'E': 3, 'G': 5, 'I': 3, 'K': 5, 'L': 3, 'N': 3, 'O': 3, 'U': 5, 'V': 3, 'W': 3, 'X': 3}"
INV-ZZ-2386817,SCH-ZZ-1589980,ZZ,ZZ20240515BOMDEL2019.0,2019.0,Airbus A320 Neo,05/15/2024,2024-05-15 16:42:00,2024-05-16 04:40:00,BOM,DEL,180.0,209,114,-66,95,18,36,54,72,21,11,7,10,40,22,14,18,62,34,20,28,83,45,27,38,"{'F': 11, 'P': 7}","{'C': 14, 'J': 11, 'Z': 11}","{'Q': 16, 'R': 11, 'S': 5, 'T': 5, 'H': 11, 'M': 5}","{'Y': 5, 'A': 5, 'B': 3, 'D': 3, 'E': 3, 'G': 5, 'I': 3, 'K': 5, 'L': 3, 'N': 3, 'O': 3, 'U': 5, 'V': 3, 'W': 3, 'X': 3}"
INV-ZZ-1931604,SCH-ZZ-1589980,ZZ,ZZ20240516BOMDEL2019.0,2019.0,Airbus A320 Neo,05/16/2024,2024-05-16 16:42:00,2024-05-17 04:40:00,BOM,DEL,180.0,214,103,-77,111,18,36,54,72,21,10,8,11,41,20,16,21,60,29,25,31,85,41,31,44,"{'F': 11, 'P': 7}","{'C': 14, 'J': 11, 'Z': 11}","{'Q': 16, 'R': 11, 'S': 5, 'T': 5, 'H': 11, 'M': 5}","{'Y': 5, 'A': 5, 'B': 3, 'D': 3, 'E': 3, 'G': 5, 'I': 3, 'K': 5, 'L': 3, 'N': 3, 'O': 3, 'U': 5, 'V': 3, 'W': 3, 'X': 3}"
INV-ZZ-3316277,SCH-ZZ-1589980,ZZ,ZZ20240517BOMDEL2019.0,2019.0,Airbus A320 Neo,05/17/2024,2024-05-17 16:42:00,2024-05-18 04:40:00,BOM,DEL,180.0,205,98,-82,107,18,36,54,72,21,10,8,11,43,20,16,23,64,30,24,34,83,40,32,43,"{'F': 11, 'P': 7}","{'C': 14, 'J': 11, 'Z': 11}","{'Q': 16, 'R': 11, 'S': 5, 'T': 5, 'H': 11, 'M': 5}","{'Y': 5, 'A': 5, 'B': 3, 'D': 3, 'E': 3, 'G': 5, 'I': 3, 'K': 5, 'L': 3, 'N': 3, 'O': 3, 'U': 5, 'V': 3, 'W': 3, 'X': 3}"
INV-ZZ-1672911,SCH-ZZ-1589980,ZZ,ZZ20240518BOMDEL2019.0,2019.0,Airbus A320 Neo,05/18/2024,2024-05-18 16:42:00,2024-05-19 04:40:00,BOM,DEL,180.0,207,102,-78,105,18,36,54,72,21,10,8,11,40,20,16,20,61,30,24,31,81,40,32,41,"{'F': 11, 'P': 7}","{'C': 14, 'J': 11, 'Z': 11}","{'Q': 16, 'R': 11, 'S': 5, 'T': 5, 'H': 11, 'M': 5}","{'Y': 5, 'A': 5, 'B': 3, 'D': 3, 'E': 3, 'G': 5, 'I': 3, 'K': 5, 'L': 3, 'N': 3, 'O': 3, 'U': 5, 'V': 3, 'W': 3, 'X': 3}"
INV-ZZ-1816914,SCH-ZZ-1589980,ZZ,ZZ20240519BOMDEL2019.0,2019.0,Airbus A320 Neo,05/19/2024,2024-05-19 16:42:00,2024-05-20 04:40:00,BOM,DEL,180.0,212,100,-80,112,18,36,54,72,21,10,8,11,43,20,16,23,61,29,25,32,82,39,33,43,"{'F': 11, 'P': 7}","{'C': 14, 'J': 11, 'Z': 11}","{'Q': 16, 'R': 11, 'S': 5, 'T': 5, 'H': 11, 'M': 5}","{'Y': 5, 'A': 5, 'B': 3, 'D': 3, 'E': 3, 'G': 5, 'I': 3, 'K': 5, 'L': 3, 'N': 3, 'O': 3, 'U': 5, 'V': 3, 'W': 3, 'X': 3}"
INV-ZZ-1533160,SCH-ZZ-1589980,ZZ,ZZ20240520BOMDEL2019.0,2019.0,Airbus A320 Neo,05/20/2024,2024-05-20 16:42:00,2024-05-21 04:40:00,BOM,DEL,180.0,199,99,-81,100,18,36,54,72,21,10,8,11,41,20,16,21,65,32,22,33,81,40,32,41,"{'F': 11, 'P': 7}","{'C': 14, 'J': 11, 'Z': 11}","{'Q': 16, 'R': 11, 'S': 5, 'T': 5, 'H': 11, 'M': 5}","{'Y': 5, 'A': 5, 'B': 3, 'D': 3, 'E': 3, 'G': 5, 'I': 3, 'K': 5, 'L': 3, 'N': 3, 'O': 3, 'U': 5, 'V': 3, 'W': 3, 'X': 3}"
INV-ZZ-6359165,SCH-ZZ-1589980,ZZ,ZZ20240522BOMDEL2019.0,2019.0,Airbus A320 Neo,05/22/2024,2024-05-22 16:42:00,2024-05-23 04:40:00,BOM,DEL,180.0,198,107,-73,91,18,36,54,72,21,11,7,10,41,22,14,19,64,35,19,29,81,44,28,37,"{'F': 11, 'P': 7}","{'C': 14, 'J': 11, 'Z': 11}","{'Q': 16, 'R': 11, 'S': 5, 'T': 5, 'H': 11, 'M': 5}","{'Y': 5, 'A': 5, 'B': 3, 'D': 3, 'E': 3, 'G': 5, 'I': 3, 'K': 5, 'L': 3, 'N': 3, 'O': 3, 'U': 5, 'V': 3, 'W': 3, 'X': 3}"
INV-ZZ-8223337,SCH-ZZ-1589980,ZZ,ZZ20240523BOMDEL2019.0,2019.0,Airbus A320 Neo,05/23/2024,2024-05-23 16:42:00,2024-05-24 04:40:00,BOM,DEL,180.0,200,105,-75,95,18,36,54,72,21,11,7,10,41,22,14,19,61,32,22,29,84,44,28,40,"{'F': 11, 'P': 7}","{'C': 14, 'J': 11, 'Z': 11}","{'Q': 16, 'R': 11, 'S': 5, 'T': 5, 'H': 11, 'M': 5}","{'Y': 5, 'A': 5, 'B': 3, 'D': 3, 'E': 3, 'G': 5, 'I': 3, 'K': 5, 'L': 3, 'N': 3, 'O': 3, 'U': 5, 'V': 3, 'W': 3, 'X': 3}"
INV-ZZ-3645468,SCH-ZZ-1589980,ZZ,ZZ20240524BOMDEL2019.0,2019.0,Airbus A320 Neo,05/24/2024,2024-05-24 16:42:00,2024-05-25 04:40:00,BOM,DEL,180.0,214,103,-77,111,18,36,54,72,21,10,8,11,41,20,16,21,64,31,23,33,81,39,33,42,"{'F': 11, 'P': 7}","{'C': 14, 'J': 11, 'Z': 11}","{'Q': 16, 'R': 11, 'S': 5, 'T': 5, 'H': 11, 'M': 5}","{'Y': 5, 'A': 5, 'B': 3, 'D': 3, 'E': 3, 'G': 5, 'I': 3, 'K': 5, 'L': 3, 'N': 3, 'O': 3, 'U': 5, 'V': 3, 'W': 3, 'X': 3}"
INV-ZZ-3898720,SCH-ZZ-1589980,ZZ,ZZ20240525BOMDEL2019.0,2019.0,Airbus A320 Neo,05/25/2024,2024-05-25 16:42:00,2024-05-26 04:40:00,BOM,DEL,180.0,208,96,-84,112,18,36,54,72,21,10,8,11,42,19,17,23,64,29,25,35,79,36,36,43,"{'F': 11, 'P': 7}","{'C': 14, 'J': 11, 'Z': 11}","{'Q': 16, 'R': 11, 'S': 5, 'T': 5, 'H': 11, 'M': 5}","{'Y': 5, 'A': 5, 'B': 3, 'D': 3, 'E': 3, 'G': 5, 'I': 3, 'K': 5, 'L': 3, 'N': 3, 'O': 3, 'U': 5, 'V': 3, 'W': 3, 'X': 3}"
INV-ZZ-7141721,SCH-ZZ-1589980,ZZ,ZZ20240526BOMDEL2019.0,2019.0,Airbus A320 Neo,05/26/2024,2024-05-26 16:42:00,2024-05-27 04:40:00,BOM,DEL,180.0,198,101,-79,97,18,36,54,72,21,11,7,10,42,21,15,21,62,32,22,30,83,42,30,41,"{'F': 11, 'P': 7}","{'C': 14, 'J': 11, 'Z': 11}","{'Q': 16, 'R': 11, 'S': 5, 'T': 5, 'H': 11, 'M': 5}","{'Y': 5, 'A': 5, 'B': 3, 'D': 3, 'E': 3, 'G': 5, 'I': 3, 'K': 5, 'L': 3, 'N': 3, 'O': 3, 'U': 5, 'V': 3, 'W': 3, 'X': 3}"
INV-ZZ-2885495,SCH-ZZ-1589980,ZZ,ZZ20240527BOMDEL2019.0,2019.0,Airbus A320 Neo,05/27/2024,2024-05-27 16:42:00,2024-05-28 04:40:00,BOM,DEL,180.0,204,97,-83,107,18,36,54,72,20,10,8,10,43,21,15,22,64,31,23,33,82,39,33,43,"{'F': 11, 'P': 7}","{'C': 14, 'J': 11, 'Z': 11}","{'Q': 16, 'R': 11, 'S': 5, 'T': 5, 'H': 11, 'M': 5}","{'Y': 5, 'A': 5, 'B': 3, 'D': 3, 'E': 3, 'G': 5, 'I': 3, 'K': 5, 'L': 3, 'N': 3, 'O': 3, 'U': 5, 'V': 3, 'W': 3, 'X': 3}"
INV-ZZ-2737988,SCH-ZZ-1589980,ZZ,ZZ20240529BOMDEL2019.0,2019.0,Airbus A320 Neo,05/29/2024,2024-05-29 16:42:00,2024-05-30 04:40:00,BOM,DEL,180.0,199,91,-89,108,18,36,54,72,21,10,8,11,40,18,18,22,63,29,25,34,83,38,34,45,"{'F': 11, 'P': 7}","{'C': 14, 'J': 11, 'Z': 11}","{'Q': 16, 'R': 11, 'S': 5, 'T': 5, 'H': 11, 'M': 5}","{'Y': 5, 'A': 5, 'B': 3, 'D': 3, 'E': 3, 'G': 5, 'I': 3, 'K': 5, 'L': 3, 'N': 3, 'O': 3, 'U': 5, 'V': 3, 'W': 3, 'X': 3}"
INV-ZZ-4794087,SCH-ZZ-1589980,ZZ,ZZ20240530BOMDEL2019.0,2019.0,Airbus A320 Neo,05/30/2024,2024-05-30 16:42:00,2024-05-31 04:40:00,BOM,DEL,180.0,198,98,-82,100,18,36,54,72,21,10,8,11,41,20,16,21,64,32,22,32,86,43,29,43,"{'F': 11, 'P': 7}","{'C': 14, 'J': 11, 'Z': 11}","{'Q': 16, 'R': 11, 'S': 5, 'T': 5, 'H': 11, 'M': 5}","{'Y': 5, 'A': 5, 'B': 3, 'D': 3, 'E': 3, 'G': 5, 'I': 3, 'K': 5, 'L': 3, 'N': 3, 'O': 3, 'U': 5, 'V': 3, 'W': 3, 'X': 3}"
INV-ZZ-5260527,SCH-ZZ-1589980,ZZ,ZZ20240531BOMDEL2019.0,2019.0,Airbus A320 Neo,05/31/2024,2024-05-31 16:42:00,2024-06-01 04:40:00,BOM,DEL,180.0,215,100,-80,115,18,36,54,72,21,10,8,11,43,20,16,23,64,30,24,34,80,37,35,43,"{'F': 11, 'P': 7}","{'C': 14, 'J': 11, 'Z': 11}","{'Q': 16, 'R': 11, 'S': 5, 'T': 5, 'H': 11, 'M': 5}","{'Y': 5, 'A': 5, 'B': 3, 'D': 3, 'E': 3, 'G': 5, 'I': 3, 'K': 5, 'L': 3, 'N': 3, 'O': 3, 'U': 5, 'V': 3, 'W': 3, 'X': 3}"
INV-ZZ-2785213,SCH-ZZ-1589980,ZZ,ZZ20240601BOMDEL2019.0,2019.0,Airbus A320 Neo,06/01/2024,2024-06-01 16:42:00,2024-06-02 04:40:00,BOM,DEL,180.0,213,101,-79,112,18,36,54,72,21,10,8,11,42,20,16,22,62,29,25,33,81,38,34,43,"{'F': 11, 'P': 7}","{'C': 14, 'J': 11, 'Z': 11}","{'Q': 16, 'R': 11, 'S': 5, 'T': 5, 'H': 11, 'M': 5}","{'Y': 5, 'A': 5, 'B': 3, 'D': 3, 'E': 3, 'G': 5, 'I': 3, 'K': 5, 'L': 3, 'N': 3, 'O': 3, 'U': 5, 'V': 3, 'W': 3, 'X': 3}"
INV-ZZ-1438693,SCH-ZZ-1589980,ZZ,ZZ20240602BOMDEL2019.0,2019.0,Airbus A320 Neo,06/02/2024,2024-06-02 16:42:00,2024-06-03 04:40:00,BOM,DEL,180.0,202,96,-84,106,18,36,54,72,20,9,9,11,41,19,17,22,61,29,25,32,83,39,33,44,"{'F': 11, 'P': 7}","{'C': 14, 'J': 11, 'Z': 11}","{'Q': 16, 'R': 11, 'S': 5, 'T': 5, 'H': 11, 'M': 5}","{'Y': 5, 'A': 5, 'B': 3, 'D': 3, 'E': 3, 'G': 5, 'I': 3, 'K': 5, 'L': 3, 'N': 3, 'O': 3, 'U': 5, 'V': 3, 'W': 3, 'X': 3}"
INV-ZZ-5390033,SCH-ZZ-1589980,ZZ,ZZ20240603BOMDEL2019.0,2019.0,Airbus A320 Neo,06/03/2024,2024-06-03 16:42:00,2024-06-04 04:40:00,BOM,DEL,180.0,198,95,-85,103,18,36,54,72,21,10,8,11,41,20,16,21,61,29,25,32,84,40,32,44,"{'F': 11, 'P': 7}","{'C': 14, 'J': 11, 'Z': 11}","{'Q': 16, 'R': 11, 'S': 5, 'T': 5, 'H': 11, 'M': 5}","{'Y': 5, 'A': 5, 'B': 3, 'D': 3, 'E': 3, 'G': 5, 'I': 3, 'K': 5, 'L': 3, 'N': 3, 'O': 3, 'U': 5, 'V': 3, 'W': 3, 'X': 3}"
INV-ZZ-7775573,SCH-ZZ-1589980,ZZ,ZZ20240605BOMDEL2019.0,2019.0,Airbus A320 Neo,06/05/2024,2024-06-05 16:42:00,2024-06-06 04:40:00,BOM,DEL,180.0,211,98,-82,113,18,36,54,72,21,10,8,11,41,19,17,22,64,30,24,34,81,38,34,43,"{'F': 11, 'P': 7}","{'C': 14, 'J': 11, 'Z': 11}","{'Q': 16, 'R': 11, 'S': 5, 'T': 5, 'H': 11, 'M': 5}","{'Y': 5, 'A': 5, 'B': 3, 'D': 3, 'E': 3, 'G': 5, 'I': 3, 'K': 5, 'L': 3, 'N': 3, 'O': 3, 'U': 5, 'V': 3, 'W': 3, 'X': 3}"
INV-ZZ-4133626,SCH-ZZ-8590177,ZZ,ZZ20240513AMDBOM2678.0,2678.0,Boeing 787,05/13/2024,2024-05-13 16:00:00,2024-05-14 01:45:00,AMD,BOM,270.0,316,155,-115,161,27,54,81,108,31,15,12,16,60,29,25,31,95,47,34,48,119,58,50,61,"{'F': 16, 'P': 11}","{'C': 22, 'J': 16, 'Z': 16}","{'Q': 24, 'R': 16, 'S': 8, 'T': 8, 'H': 16, 'M': 8}","{'Y': 8, 'A': 8, 'B': 4, 'D': 4, 'E': 4, 'G': 8, 'I': 4, 'K': 8, 'L': 4, 'N': 4, 'O': 4, 'U': 8, 'V': 4, 'W': 4, 'X': 4}"
INV-ZZ-5379620,SCH-ZZ-8590177,ZZ,ZZ20240516AMDBOM2678.0,2678.0,Boeing 787,05/16/2024,2024-05-16 16:00:00,2024-05-17 01:45:00,AMD,BOM,270.0,319,167,-103,152,27,54,81,108,30,16,11,14,64,33,21,31,94,49,32,45,129,67,41,62,"{'F': 16, 'P': 11}","{'C': 22, 'J': 16, 'Z': 16}","{'Q': 24, 'R': 16, 'S': 8, 'T': 8, 'H': 16, 'M': 8}","{'Y': 8, 'A': 8, 'B': 4, 'D': 4, 'E': 4, 'G': 8, 'I': 4, 'K': 8, 'L': 4, 'N': 4, 'O': 4, 'U': 8, 'V': 4, 'W': 4, 'X': 4}"
INV-ZZ-8351952,SCH-ZZ-8590177,ZZ,ZZ20240520AMDBOM2678.0,2678.0,Boeing 787,05/20/2024,2024-05-20 16:00:00,2024-05-21 01:45:00,AMD,BOM,270.0,301,156,-114,145,27,54,81,108,32,17,10,15,59,31,23,28,94,49,32,45,120,62,46,58,"{'F': 16, 'P': 11}","{'C': 22, 'J': 16, 'Z': 16}","{'Q': 24, 'R': 16, 'S': 8, 'T': 8, 'H': 16, 'M': 8}","{'Y': 8, 'A': 8, 'B': 4, 'D': 4, 'E': 4, 'G': 8, 'I': 4, 'K': 8, 'L': 4, 'N': 4, 'O': 4, 'U': 8, 'V': 4, 'W': 4, 'X': 4}"
INV-ZZ-2397658,SCH-ZZ-8590177,ZZ,ZZ20240523AMDBOM2678.0,2678.0,Boeing 787,05/23/2024,2024-05-23 16:00:00,2024-05-24 01:45:00,AMD,BOM,270.0,301,146,-124,155,27,54,81,108,32,16,11,16,63,31,23,32,97,47,34,50,124,60,48,64,"{'F': 16, 'P': 11}","{'C': 22, 'J': 16, 'Z': 16}","{'Q': 24, 'R': 16, 'S': 8, 'T': 8, 'H': 16, 'M': 8}","{'Y': 8, 'A': 8, 'B': 4, 'D': 4, 'E': 4, 'G': 8, 'I': 4, 'K': 8, 'L': 4, 'N': 4, 'O': 4, 'U': 8, 'V': 4, 'W': 4, 'X': 4}"
INV-ZZ-2326993,SCH-ZZ-8590177,ZZ,ZZ20240527AMDBOM2678.0,2678.0,Boeing 787,05/27/2024,2024-05-27 16:00:00,2024-05-28 01:45:00,AMD,BOM,270.0,323,166,-104,157,27,54,81,108,32,16,11,16,63,32,22,31,93,48,33,45,122,63,45,59,"{'F': 16, 'P': 11}","{'C': 22, 'J': 16, 'Z': 16}","{'Q': 24, 'R': 16, 'S': 8, 'T': 8, 'H': 16, 'M': 8}","{'Y': 8, 'A': 8, 'B': 4, 'D': 4, 'E': 4, 'G': 8, 'I': 4, 'K': 8, 'L': 4, 'N': 4, 'O': 4, 'U': 8, 'V': 4, 'W': 4, 'X': 4}"
INV-ZZ-7949321,SCH-ZZ-8590177,ZZ,ZZ20240530AMDBOM2678.0,2678.0,Boeing 787,05/30/2024,2024-05-30 16:00:00,2024-05-31 01:45:00,AMD,BOM,270.0,301,149,-121,152,27,54,81,108,32,16,11,16,60,30,24,30,89,44,37,45,122,60,48,62,"{'F': 16, 'P': 11}","{'C': 22, 'J': 16, 'Z': 16}","{'Q': 24, 'R': 16, 'S': 8, 'T': 8, 'H': 16, 'M': 8}","{'Y': 8, 'A': 8, 'B': 4, 'D': 4, 'E': 4, 'G': 8, 'I': 4, 'K': 8, 'L': 4, 'N': 4, 'O': 4, 'U': 8, 'V': 4, 'W': 4, 'X': 4}"
INV-ZZ-1032785,SCH-ZZ-8590177,ZZ,ZZ20240603AMDBOM2678.0,2678.0,Boeing 787,06/03/2024,2024-06-03 16:00:00,2024-06-04 01:45:00,AMD,BOM,270.0,307,140,-130,167,27,54,81,108,31,14,13,17,61,28,26,33,90,41,40,49,123,56,52,67,"{'F': 16, 'P': 11}","{'C': 22, 'J': 16, 'Z': 16}","{'Q': 24, 'R': 16, 'S': 8, 'T': 8, 'H': 16, 'M': 8}","{'Y': 8, 'A': 8, 'B': 4, 'D': 4, 'E': 4, 'G': 8, 'I': 4, 'K': 8, 'L': 4, 'N': 4, 'O': 4, 'U': 8, 'V': 4, 'W': 4, 'X': 4}"
INV-ZZ-3818582,SCH-ZZ-8590177,ZZ,ZZ20240606AMDBOM2678.0,2678.0,Boeing 787,06/06/2024,2024-06-06 16:00:00,2024-06-07 01:45:00,AMD,BOM,270.0,318,158,-112,160,27,54,81,108,31,15,12,16,63,31,23,32,91,45,36,46,125,62,46,63,"{'F': 16, 'P': 11}","{'C': 22, 'J': 16, 'Z': 16}","{'Q': 24, 'R': 16, 'S': 8, 'T': 8, 'H': 16, 'M': 8}","{'Y': 8, 'A': 8, 'B': 4, 'D': 4, 'E': 4, 'G': 8, 'I': 4, 'K': 8, 'L': 4, 'N': 4, 'O': 4, 'U': 8, 'V': 4, 'W': 4, 'X': 4}"
INV-ZZ-9673535,SCH-ZZ-8590177,ZZ,ZZ20240610AMDBOM2678.0,2678.0,Boeing 787,06/10/2024,2024-06-10 16:00:00,2024-06-11 01:45:00,AMD,BOM,270.0,312,136,-134,176,27,54,81,108,32,14,13,18,61,27,27,34,91,40,41,51,120,52,56,68,"{'F': 16, 'P': 11}","{'C': 22, 'J': 16, 'Z': 16}","{'Q': 24, 'R': 16, 'S': 8, 'T': 8, 'H': 16, 'M': 8}","{'Y': 8, 'A': 8, 'B': 4, 'D': 4, 'E': 4, 'G': 8, 'I': 4, 'K': 8, 'L': 4, 'N': 4, 'O': 4, 'U': 8, 'V': 4, 'W': 4, 'X': 4}"
INV-ZZ-2769993,SCH-ZZ-8590177,ZZ,ZZ20240613AMDBOM2678.0,2678.0,Boeing 787,06/13/2024,2024-06-13 16:00:00,2024-06-14 01:45:00,AMD,BOM,270.0,320,151,-119,169,27,54,81,108,31,15,12,16,62,29,25,33,95,45,36,50,130,61,47,69,"{'F': 16, 'P': 11}","{'C': 22, 'J': 16, 'Z': 16}","{'Q': 24, 'R': 16, 'S': 8, 'T': 8, 'H': 16, 'M': 8}","{'Y': 8, 'A': 8, 'B': 4, 'D': 4, 'E': 4, 'G': 8, 'I': 4, 'K': 8, 'L': 4, 'N': 4, 'O': 4, 'U': 8, 'V': 4, 'W': 4, 'X': 4}"
INV-ZZ-7212744,SCH-ZZ-8590177,ZZ,ZZ20240617AMDBOM2678.0,2678.0,Boeing 787,06/17/2024,2024-06-17 16:00:00,2024-06-18 01:45:00,AMD,BOM,270.0,320,138,-132,182,27,54,81,108,31,13,14,18,62,27,27,35,91,39,42,52,120,52,56,68,"{'F': 16, 'P': 11}","{'C': 22, 'J': 16, 'Z': 16}","{'Q': 24, 'R': 16, 'S': 8, 'T': 8, 'H': 16, 'M': 8}","{'Y': 8, 'A': 8, 'B': 4, 'D': 4, 'E': 4, 'G': 8, 'I': 4, 'K': 8, 'L': 4, 'N': 4, 'O': 4, 'U': 8, 'V': 4, 'W': 4, 'X': 4}"
INV-ZZ-2154075,SCH-ZZ-8590177,ZZ,ZZ20240620AMDBOM2678.0,2678.0,Boeing 787,06/20/2024,2024-06-20 16:00:00,2024-06-21 01:45:00,AMD,BOM,270.0,317,127,-143,190,27,54,81,108,32,13,14,19,63,25,29,38,96,38,43,58,121,48,60,73,"{'F': 16, 'P': 11}","{'C': 22, 'J': 16, 'Z': 16}","{'Q': 24, 'R': 16, 'S': 8, 'T': 8, 'H': 16, 'M': 8}","{'Y': 8, 'A': 8, 'B': 4, 'D': 4, 'E': 4, 'G': 8, 'I': 4, 'K': 8, 'L': 4, 'N': 4, 'O': 4, 'U': 8, 'V': 4, 'W': 4, 'X': 4}"
INV-ZZ-5207392,SCH-ZZ-8590177,ZZ,ZZ20240624AMDBOM2678.0,2678.0,Boeing 787,06/24/2024,2024-06-24 16:00:00,2024-06-25 01:45:00,AMD,BOM,270.0,300,121,-149,179,27,54,81,108,32,13,14,19,60,24,30,36,94,38,43,56,121,49,59,72,"{'F': 16, 'P': 11}","{'C': 22, 'J': 16, 'Z': 16}","{'Q': 24, 'R': 16, 'S': 8, 'T': 8, 'H': 16, 'M': 8}","{'Y': 8, 'A': 8, 'B': 4, 'D': 4, 'E': 4, 'G': 8, 'I': 4, 'K': 8, 'L': 4, 'N': 4, 'O': 4, 'U': 8, 'V': 4, 'W': 4, 'X': 4}"
INV-ZZ-4642517,SCH-ZZ-5189392,ZZ,ZZ20240516BOMHYD3946.0,3946.0,Boeing 777-300,05/16/2024,2024-05-16 22:47:00,2024-05-17 11:37:00,BOM,HYD,360.0,424,229,-131,195,36,72,108,144,41,22,14,19,83,45,27,38,129,70,38,59,165,89,55,76,"{'F': 22, 'P': 14}","{'C': 29, 'J': 22, 'Z': 22}","{'Q': 32, 'R': 22, 'S': 11, 'T': 11, 'H': 22, 'M': 11}","{'Y': 11, 'A': 11, 'B': 5, 'D': 5, 'E': 5, 'G': 11, 'I': 5, 'K': 11, 'L': 5, 'N': 5, 'O': 5, 'U': 11, 'V': 5, 'W': 5, 'X': 5}"
INV-ZZ-5467077,SCH-ZZ-5189392,ZZ,ZZ20240522BOMHYD3946.0,3946.0,Boeing 777-300,05/22/2024,2024-05-22 22:47:00,2024-05-23 11:37:00,BOM,HYD,360.0,418,205,-155,213,36,72,108,144,43,21,15,22,84,41,31,43,127,62,46,65,165,81,63,84,"{'F': 22, 'P': 14}","{'C': 29, 'J': 22, 'Z': 22}","{'Q': 32, 'R': 22, 'S': 11, 'T': 11, 'H': 22, 'M': 11}","{'Y': 11, 'A': 11, 'B': 5, 'D': 5, 'E': 5, 'G': 11, 'I': 5, 'K': 11, 'L': 5, 'N': 5, 'O': 5, 'U': 11, 'V': 5, 'W': 5, 'X': 5}"
INV-ZZ-6250134,SCH-ZZ-5189392,ZZ,ZZ20240523BOMHYD3946.0,3946.0,Boeing 777-300,05/23/2024,2024-05-23 22:47:00,2024-05-24 11:37:00,BOM,HYD,360.0,415,223,-137,192,36,72,108,144,40,21,15,19,82,44,28,38,123,66,42,57,169,91,53,78,"{'F': 22, 'P': 14}","{'C': 29, 'J': 22, 'Z': 22}","{'Q': 32, 'R': 22, 'S': 11, 'T': 11, 'H': 22, 'M': 11}","{'Y': 11, 'A': 11, 'B': 5, 'D': 5, 'E': 5, 'G': 11, 'I': 5, 'K': 11, 'L': 5, 'N': 5, 'O': 5, 'U': 11, 'V': 5, 'W': 5, 'X': 5}"
INV-ZZ-5530274,SCH-ZZ-5189392,ZZ,ZZ20240529BOMHYD3946.0,3946.0,Boeing 777-300,05/29/2024,2024-05-29 22:47:00,2024-05-30 11:37:00,BOM,HYD,360.0,409,206,-154,203,36,72,108,144,41,21,15,20,82,41,31,41,130,66,42,64,172,87,57,85,"{'F': 22, 'P': 14}","{'C': 29, 'J': 22, 'Z': 22}","{'Q': 32, 'R': 22, 'S': 11, 'T': 11, 'H': 22, 'M': 11}","{'Y': 11, 'A': 11, 'B': 5, 'D': 5, 'E': 5, 'G': 11, 'I': 5, 'K': 11, 'L': 5, 'N': 5, 'O': 5, 'U': 11, 'V': 5, 'W': 5, 'X': 5}"
INV-ZZ-7694697,SCH-ZZ-5189392,ZZ,ZZ20240530BOMHYD3946.0,3946.0,Boeing 777-300,05/30/2024,2024-05-30 22:47:00,2024-05-31 11:37:00,BOM,HYD,360.0,402,191,-169,211,36,72,108,144,43,20,16,23,84,40,32,44,127,60,48,67,172,82,62,90,"{'F': 22, 'P': 14}","{'C': 29, 'J': 22, 'Z': 22}","{'Q': 32, 'R': 22, 'S': 11, 'T': 11, 'H': 22, 'M': 11}","{'Y': 11, 'A': 11, 'B': 5, 'D': 5, 'E': 5, 'G': 11, 'I': 5, 'K': 11, 'L': 5, 'N': 5, 'O': 5, 'U': 11, 'V': 5, 'W': 5, 'X': 5}"
INV-ZZ-6991256,SCH-ZZ-5189392,ZZ,ZZ20240605BOMHYD3946.0,3946.0,Boeing 777-300,06/05/2024,2024-06-05 22:47:00,2024-06-06 11:37:00,BOM,HYD,360.0,419,207,-153,212,36,72,108,144,42,21,15,21,81,40,32,41,119,59,49,60,165,81,63,84,"{'F': 22, 'P': 14}","{'C': 29, 'J': 22, 'Z': 22}","{'Q': 32, 'R': 22, 'S': 11, 'T': 11, 'H': 22, 'M': 11}","{'Y': 11, 'A': 11, 'B': 5, 'D': 5, 'E': 5, 'G': 11, 'I': 5, 'K': 11, 'L': 5, 'N': 5, 'O': 5, 'U': 11, 'V': 5, 'W': 5, 'X': 5}"
INV-ZZ-3916268,SCH-ZZ-5189392,ZZ,ZZ20240606BOMHYD3946.0,3946.0,Boeing 777-300,06/06/2024,2024-06-06 22:47:00,2024-06-07 11:37:00,BOM,HYD,360.0,419,185,-175,234,36,72,108,144,40,18,18,22,86,38,34,48,124,55,53,69,159,70,74,89,"{'F': 22, 'P': 14}","{'C': 29, 'J': 22, 'Z': 22}","{'Q': 32, 'R': 22, 'S': 11, 'T': 11, 'H': 22, 'M': 11}","{'Y': 11, 'A': 11, 'B': 5, 'D': 5, 'E': 5, 'G': 11, 'I': 5, 'K': 11, 'L': 5, 'N': 5, 'O': 5, 'U': 11, 'V': 5, 'W': 5, 'X': 5}"
INV-ZZ-6264445,SCH-ZZ-5189392,ZZ,ZZ20240612BOMHYD3946.0,3946.0,Boeing 777-300,06/12/2024,2024-06-12 22:47:00,2024-06-13 11:37:00,BOM,HYD,360.0,420,197,-163,223,36,72,108,144,41,19,17,22,80,37,35,43,128,60,48,68,167,78,66,89,"{'F': 22, 'P': 14}","{'C': 29, 'J': 22, 'Z': 22}","{'Q': 32, 'R': 22, 'S': 11, 'T': 11, 'H': 22, 'M': 11}","{'Y': 11, 'A': 11, 'B': 5, 'D': 5, 'E': 5, 'G': 11, 'I': 5, 'K': 11, 'L': 5, 'N': 5, 'O': 5, 'U': 11, 'V': 5, 'W': 5, 'X': 5}"
INV-ZZ-3398712,SCH-ZZ-5189392,ZZ,ZZ20240613BOMHYD3946.0,3946.0,Boeing 777-300,06/13/2024,2024-06-13 22:47:00,2024-06-14 11:37:00,BOM,HYD,360.0,424,199,-161,225,36,72,108,144,41,19,17,22,83,39,33,44,125,59,49,66,159,75,69,84,"{'F': 22, 'P': 14}","{'C': 29, 'J': 22, 'Z': 22}","{'Q': 32, 'R': 22, 'S': 11, 'T': 11, 'H': 22, 'M': 11}","{'Y': 11, 'A': 11, 'B': 5, 'D': 5, 'E': 5, 'G': 11, 'I': 5, 'K': 11, 'L': 5, 'N': 5, 'O': 5, 'U': 11, 'V': 5, 'W': 5, 'X': 5}"
INV-ZZ-6131541,SCH-ZZ-5189392,ZZ,ZZ20240619BOMHYD3946.0,3946.0,Boeing 777-300,06/19/2024,2024-06-19 22:47:00,2024-06-20 11:37:00,BOM,HYD,360.0,418,184,-176,234,36,72,108,144,43,19,17,24,80,35,37,45,127,56,52,71,164,72,72,92,"{'F': 22, 'P': 14}","{'C': 29, 'J': 22, 'Z': 22}","{'Q': 32, 'R': 22, 'S': 11, 'T': 11, 'H': 22, 'M': 11}","{'Y': 11, 'A': 11, 'B': 5, 'D': 5, 'E': 5, 'G': 11, 'I': 5, 'K': 11, 'L': 5, 'N': 5, 'O': 5, 'U': 11, 'V': 5, 'W': 5, 'X': 5}"
INV-ZZ-3193130,SCH-ZZ-5189392,ZZ,ZZ20240620BOMHYD3946.0,3946.0,Boeing 777-300,06/20/2024,2024-06-20 22:47:00,2024-06-21 11:37:00,BOM,HYD,360.0,428,176,-184,252,36,72,108,144,41,17,19,24,86,35,37,51,128,53,55,75,164,67,77,97,"{'F': 22, 'P': 14}","{'C': 29, 'J': 22, 'Z': 22}","{'Q': 32, 'R': 22, 'S': 11, 'T': 11, 'H': 22, 'M': 11}","{'Y': 11, 'A': 11, 'B': 5, 'D': 5, 'E': 5, 'G': 11, 'I': 5, 'K': 11, 'L': 5, 'N': 5, 'O': 5, 'U': 11, 'V': 5, 'W': 5, 'X': 5}"
INV-ZZ-5973145,SCH-ZZ-5189392,ZZ,ZZ20240626BOMHYD3946.0,3946.0,Boeing 777-300,06/26/2024,2024-06-26 22:47:00,2024-06-27 11:37:00,BOM,HYD,360.0,405,168,-192,237,36,72,108,144,41,17,19,24,84,35,37,49,127,53,55,74,166,69,75,97,"{'F': 22, 'P': 14}","{'C': 29, 'J': 22, 'Z': 22}","{'Q': 32, 'R': 22, 'S': 11, 'T': 11, 'H': 22, 'M': 11}","{'Y': 11, 'A': 11, 'B': 5, 'D': 5, 'E': 5, 'G': 11, 'I': 5, 'K': 11, 'L': 5, 'N': 5, 'O': 5, 'U': 11, 'V': 5, 'W': 5, 'X': 5}"
INV-ZZ-6362280,SCH-ZZ-5189392,ZZ,ZZ20240627BOMHYD3946.0,3946.0,Boeing 777-300,06/27/2024,2024-06-27 22:47:00,2024-06-28 11:37:00,BOM,HYD,360.0,407,169,-191,238,36,72,108,144,40,17,19,23,80,33,39,47,119,49,59,70,162,67,77,95,"{'F': 22, 'P': 14}","{'C': 29, 'J': 22, 'Z': 22}","{'Q': 32, 'R': 22, 'S': 11, 'T': 11, 'H': 22, 'M': 11}","{'Y': 11, 'A': 11, 'B': 5, 'D': 5, 'E': 5, 'G': 11, 'I': 5, 'K': 11, 'L': 5, 'N': 5, 'O': 5, 'U': 11, 'V': 5, 'W': 5, 'X': 5}"
INV-ZZ-2381745,SCH-ZZ-8346803,ZZ,ZZ20240508BLRDEL2257.0,2257.0,Boeing 757,05/08/2024,2024-05-08 04:37:00,2024-05-08 18:55:00,BLR,DEL,209.0,232,124,-85,108,20,41,62,83,22,12,8,10,46,25,16,21,73,39,23,34,92,49,34,43,"{'F': 12, 'P': 8}","{'C': 16, 'J': 12, 'Z': 12}","{'Q': 19, 'R': 12, 'S': 6, 'T': 6, 'H': 12, 'M': 6}","{'Y': 6, 'A': 6, 'B': 3, 'D': 3, 'E': 3, 'G': 6, 'I': 3, 'K': 6, 'L': 3, 'N': 3, 'O': 3, 'U': 6, 'V': 3, 'W': 3, 'X': 3}"
INV-ZZ-8048337,SCH-ZZ-8346803,ZZ,ZZ20240510BLRDEL2257.0,2257.0,Boeing 757,05/10/2024,2024-05-10 04:37:00,2024-05-10 18:55:00,BLR,DEL,209.0,243,134,-75,109,20,41,62,83,22,12,8,10,48,27,14,21,71,39,23,32,95,52,31,43,"{'F': 12, 'P': 8}","{'C': 16, 'J': 12, 'Z': 12}","{'Q': 19, 'R': 12, 'S': 6, 'T': 6, 'H': 12, 'M': 6}","{'Y': 6, 'A': 6, 'B': 3, 'D': 3, 'E': 3, 'G': 6, 'I': 3, 'K': 6, 'L': 3, 'N': 3, 'O': 3, 'U': 6, 'V': 3, 'W': 3, 'X': 3}"
INV-ZZ-4705380,SCH-ZZ-8346803,ZZ,ZZ20240511BLRDEL2257.0,2257.0,Boeing 757,05/11/2024,2024-05-11 04:37:00,2024-05-11 18:55:00,BLR,DEL,209.0,232,131,-78,101,20,41,62,83,23,13,7,10,47,26,15,21,71,40,22,31,94,53,30,41,"{'F': 12, 'P': 8}","{'C': 16, 'J': 12, 'Z': 12}","{'Q': 19, 'R': 12, 'S': 6, 'T': 6, 'H': 12, 'M': 6}","{'Y': 6, 'A': 6, 'B': 3, 'D': 3, 'E': 3, 'G': 6, 'I': 3, 'K': 6, 'L': 3, 'N': 3, 'O': 3, 'U': 6, 'V': 3, 'W': 3, 'X': 3}"
INV-ZZ-9075744,SCH-ZZ-8346803,ZZ,ZZ20240512BLRDEL2257.0,2257.0,Boeing 757,05/12/2024,2024-05-12 04:37:00,2024-05-12 18:55:00,BLR,DEL,209.0,250,137,-72,113,20,41,62,83,22,12,8,10,49,27,14,22,70,38,24,32,97,53,30,44,"{'F': 12, 'P': 8}","{'C': 16, 'J': 12, 'Z': 12}","{'Q': 19, 'R': 12, 'S': 6, 'T': 6, 'H': 12, 'M': 6}","{'Y': 6, 'A': 6, 'B': 3, 'D': 3, 'E': 3, 'G': 6, 'I': 3, 'K': 6, 'L': 3, 'N': 3, 'O': 3, 'U': 6, 'V': 3, 'W': 3, 'X': 3}"
INV-ZZ-6795203,SCH-ZZ-8346803,ZZ,ZZ20240513BLRDEL2257.0,2257.0,Boeing 757,05/13/2024,2024-05-13 04:37:00,2024-05-13 18:55:00,BLR,DEL,209.0,244,129,-80,115,20,41,62,83,24,13,7,11,46,24,17,22,73,38,24,35,93,49,34,44,"{'F': 12, 'P': 8}","{'C': 16, 'J': 12, 'Z': 12}","{'Q': 19, 'R': 12, 'S': 6, 'T': 6, 'H': 12, 'M': 6}","{'Y': 6, 'A': 6, 'B': 3, 'D': 3, 'E': 3, 'G': 6, 'I': 3, 'K': 6, 'L': 3, 'N': 3, 'O': 3, 'U': 6, 'V': 3, 'W': 3, 'X': 3}"
INV-ZZ-7565470,SCH-ZZ-8346803,ZZ,ZZ20240514BLRDEL2257.0,2257.0,Boeing 757,05/14/2024,2024-05-14 04:37:00,2024-05-14 18:55:00,BLR,DEL,209.0,243,120,-89,123,20,41,62,83,22,11,9,11,46,23,18,23,71,35,27,36,97,48,35,49,"{'F': 12, 'P': 8}","{'C': 16, 'J': 12, 'Z': 12}","{'Q': 19, 'R': 12, 'S': 6, 'T': 6, 'H': 12, 'M': 6}","{'Y': 6, 'A': 6, 'B': 3, 'D': 3, 'E': 3, 'G': 6, 'I': 3, 'K': 6, 'L': 3, 'N': 3, 'O': 3, 'U': 6, 'V': 3, 'W': 3, 'X': 3}"
INV-ZZ-8591127,SCH-ZZ-8346803,ZZ,ZZ20240515BLRDEL2257.0,2257.0,Boeing 757,05/15/2024,2024-05-15 04:37:00,2024-05-15 18:55:00,BLR,DEL,209.0,245,136,-73,109,20,41,62,83,23,13,7,10,48,27,14,21,70,39,23,31,96,53,30,43,"{'F': 12, 'P': 8}","{'C': 16, 'J': 12, 'Z': 12}","{'Q': 19, 'R': 12, 'S': 6, 'T': 6, 'H': 12, 'M': 6}","{'Y': 6, 'A': 6, 'B': 3, 'D': 3, 'E': 3, 'G': 6, 'I': 3, 'K': 6, 'L': 3, 'N': 3, 'O': 3, 'U': 6, 'V': 3, 'W': 3, 'X': 3}"
INV-ZZ-5445927,SCH-ZZ-8346803,ZZ,ZZ20240517BLRDEL2257.0,2257.0,Boeing 757,05/17/2024,2024-05-17 04:37:00,2024-05-17 18:55:00,BLR,DEL,209.0,249,130,-79,119,20,41,62,83,23,12,8,11,47,25,16,22,72,38,24,34,98,51,32,47,"{'F': 12, 'P': 8}","{'C': 16, 'J': 12, 'Z': 12}","{'Q': 19, 'R': 12, 'S': 6, 'T': 6, 'H': 12, 'M': 6}","{'Y': 6, 'A': 6, 'B': 3, 'D': 3, 'E': 3, 'G': 6, 'I': 3, 'K': 6, 'L': 3, 'N': 3, 'O': 3, 'U': 6, 'V': 3, 'W': 3, 'X': 3}"
INV-ZZ-6767900,SCH-ZZ-8346803,ZZ,ZZ20240518BLRDEL2257.0,2257.0,Boeing 757,05/18/2024,2024-05-18 04:37:00,2024-05-18 18:55:00,BLR,DEL,209.0,240,116,-93,124,20,41,62,83,22,11,9,11,48,23,18,25,70,34,28,36,94,45,38,49,"{'F': 12, 'P': 8}","{'C': 16, 'J': 12, 'Z': 12}","{'Q': 19, 'R': 12, 'S': 6, 'T': 6, 'H': 12, 'M': 6}","{'Y': 6, 'A': 6, 'B': 3, 'D': 3, 'E': 3, 'G': 6, 'I': 3, 'K': 6, 'L': 3, 'N': 3, 'O': 3, 'U': 6, 'V': 3, 'W': 3, 'X': 3}"
INV-ZZ-8586480,SCH-ZZ-8346803,ZZ,ZZ20240519BLRDEL2257.0,2257.0,Boeing 757,05/19/2024,2024-05-19 04:37:00,2024-05-19 18:55:00,BLR,DEL,209.0,245,124,-85,121,20,41,62,83,22,11,9,11,48,24,17,24,73,37,25,36,98,50,33,48,"{'F': 12, 'P': 8}","{'C': 16, 'J': 12, 'Z': 12}","{'Q': 19, 'R': 12, 'S': 6, 'T': 6, 'H': 12, 'M': 6}","{'Y': 6, 'A': 6, 'B': 3, 'D': 3, 'E': 3, 'G': 6, 'I': 3, 'K': 6, 'L': 3, 'N': 3, 'O': 3, 'U': 6, 'V': 3, 'W': 3, 'X': 3}"
INV-ZZ-7983494,SCH-ZZ-8346803,ZZ,ZZ20240520BLRDEL2257.0,2257.0,Boeing 757,05/20/2024,2024-05-20 04:37:00,2024-05-20 18:55:00,BLR,DEL,209.0,246,124,-85,122,20,41,62,83,23,12,8,11,46,23,18,23,72,36,26,36,92,46,37,46,"{'F': 12, 'P': 8}","{'C': 16, 'J': 12, 'Z': 12}","{'Q': 19, 'R': 12, 'S': 6, 'T': 6, 'H': 12, 'M': 6}","{'Y': 6, 'A': 6, 'B': 3, 'D': 3, 'E': 3, 'G': 6, 'I': 3, 'K': 6, 'L': 3, 'N': 3, 'O': 3, 'U': 6, 'V': 3, 'W': 3, 'X': 3}"
INV-ZZ-6836960,SCH-ZZ-8346803,ZZ,ZZ20240521BLRDEL2257.0,2257.0,Boeing 757,05/21/2024,2024-05-21 04:37:00,2024-05-21 18:55:00,BLR,DEL,209.0,235,124,-85,111,20,41,62,83,24,13,7,11,48,25,16,23,70,37,25,33,96,51,32,45,"{'F': 12, 'P': 8}","{'C': 16, 'J': 12, 'Z': 12}","{'Q': 19, 'R': 12, 'S': 6, 'T': 6, 'H': 12, 'M': 6}","{'Y': 6, 'A': 6, 'B': 3, 'D': 3, 'E': 3, 'G': 6, 'I': 3, 'K': 6, 'L': 3, 'N': 3, 'O': 3, 'U': 6, 'V': 3, 'W': 3, 'X': 3}"
INV-ZZ-8650478,SCH-ZZ-8346803,ZZ,ZZ20240522BLRDEL2257.0,2257.0,Boeing 757,05/22/2024,2024-05-22 04:37:00,2024-05-22 18:55:00,BLR,DEL,209.0,232,118,-91,114,20,41,62,83,23,12,8,11,46,23,18,23,69,35,27,34,96,49,34,47,"{'F': 12, 'P': 8}","{'C': 16, 'J': 12, 'Z': 12}","{'Q': 19, 'R': 12, 'S': 6, 'T': 6, 'H': 12, 'M': 6}","{'Y': 6, 'A': 6, 'B': 3, 'D': 3, 'E': 3, 'G': 6, 'I': 3, 'K': 6, 'L': 3, 'N': 3, 'O': 3, 'U': 6, 'V': 3, 'W': 3, 'X': 3}"
INV-ZZ-5889974,SCH-ZZ-8346803,ZZ,ZZ20240524BLRDEL2257.0,2257.0,Boeing 757,05/24/2024,2024-05-24 04:37:00,2024-05-24 18:55:00,BLR,DEL,209.0,250,134,-75,116,20,41,62,83,22,12,8,10,45,24,17,21,70,37,25,33,96,51,32,45,"{'F': 12, 'P': 8}","{'C': 16, 'J': 12, 'Z': 12}","{'Q': 19, 'R': 12, 'S': 6, 'T': 6, 'H': 12, 'M': 6}","{'Y': 6, 'A': 6, 'B': 3, 'D': 3, 'E': 3, 'G': 6, 'I': 3, 'K': 6, 'L': 3, 'N': 3, 'O': 3, 'U': 6, 'V': 3, 'W': 3, 'X': 3}"
INV-ZZ-6635812,SCH-ZZ-8346803,ZZ,ZZ20240525BLRDEL2257.0,2257.0,Boeing 757,05/25/2024,2024-05-25 04:37:00,2024-05-25 18:55:00,BLR,DEL,209.0,238,116,-93,122,20,41,62,83,24,12,8,12,46,22,19,24,70,34,28,36,96,47,36,49,"{'F': 12, 'P': 8}","{'C': 16, 'J': 12, 'Z': 12}","{'Q': 19, 'R': 12, 'S': 6, 'T': 6, 'H': 12, 'M': 6}","{'Y': 6, 'A': 6, 'B': 3, 'D': 3, 'E': 3, 'G': 6, 'I': 3, 'K': 6, 'L': 3, 'N': 3, 'O': 3, 'U': 6, 'V': 3, 'W': 3, 'X': 3}"
INV-ZZ-6171185,SCH-ZZ-8346803,ZZ,ZZ20240526BLRDEL2257.0,2257.0,Boeing 757,05/26/2024,2024-05-26 04:37:00,2024-05-26 18:55:00,BLR,DEL,209.0,238,118,-91,120,20,41,62,83,22,11,9,11,49,24,17,25,72,36,26,36,97,48,35,49,"{'F': 12, 'P': 8}","{'C': 16, 'J': 12, 'Z': 12}","{'Q': 19, 'R': 12, 'S': 6, 'T': 6, 'H': 12, 'M': 6}","{'Y': 6, 'A': 6, 'B': 3, 'D': 3, 'E': 3, 'G': 6, 'I': 3, 'K': 6, 'L': 3, 'N': 3, 'O': 3, 'U': 6, 'V': 3, 'W': 3, 'X': 3}"
INV-ZZ-4527916,SCH-ZZ-8346803,ZZ,ZZ20240527BLRDEL2257.0,2257.0,Boeing 757,05/27/2024,2024-05-27 04:37:00,2024-05-27 18:55:00,BLR,DEL,209.0,241,117,-92,124,20,41,62,83,22,11,9,11,47,23,18,24,71,34,28,37,97,47,36,50,"{'F': 12, 'P': 8}","{'C': 16, 'J': 12, 'Z': 12}","{'Q': 19, 'R': 12, 'S': 6, 'T': 6, 'H': 12, 'M': 6}","{'Y': 6, 'A': 6, 'B': 3, 'D': 3, 'E': 3, 'G': 6, 'I': 3, 'K': 6, 'L': 3, 'N': 3, 'O': 3, 'U': 6, 'V': 3, 'W': 3, 'X': 3}"
INV-ZZ-3847336,SCH-ZZ-8346803,ZZ,ZZ20240528BLRDEL2257.0,2257.0,Boeing 757,05/28/2024,2024-05-28 04:37:00,2024-05-28 18:55:00,BLR,DEL,209.0,250,118,-91,132,20,41,62,83,23,11,9,12,45,21,20,24,74,35,27,39,98,46,37,52,"{'F': 12, 'P': 8}","{'C': 16, 'J': 12, 'Z': 12}","{'Q': 19, 'R': 12, 'S': 6, 'T': 6, 'H': 12, 'M': 6}","{'Y': 6, 'A': 6, 'B': 3, 'D': 3, 'E': 3, 'G': 6, 'I': 3, 'K': 6, 'L': 3, 'N': 3, 'O': 3, 'U': 6, 'V': 3, 'W': 3, 'X': 3}"
INV-ZZ-2501950,SCH-ZZ-8346803,ZZ,ZZ20240529BLRDEL2257.0,2257.0,Boeing 757,05/29/2024,2024-05-29 04:37:00,2024-05-29 18:55:00,BLR,DEL,209.0,240,126,-83,114,20,41,62,83,23,12,8,11,46,24,17,22,71,37,25,34,95,50,33,45,"{'F': 12, 'P': 8}","{'C': 16, 'J': 12, 'Z': 12}","{'Q': 19, 'R': 12, 'S': 6, 'T': 6, 'H': 12, 'M': 6}","{'Y': 6, 'A': 6, 'B': 3, 'D': 3, 'E': 3, 'G': 6, 'I': 3, 'K': 6, 'L': 3, 'N': 3, 'O': 3, 'U': 6, 'V': 3, 'W': 3, 'X': 3}"
INV-ZZ-1381176,SCH-ZZ-8346803,ZZ,ZZ20240531BLRDEL2257.0,2257.0,Boeing 757,05/31/2024,2024-05-31 04:37:00,2024-05-31 18:55:00,BLR,DEL,209.0,232,118,-91,114,20,41,62,83,23,12,8,11,46,23,18,23,74,38,24,36,95,48,35,47,"{'F': 12, 'P': 8}","{'C': 16, 'J': 12, 'Z': 12}","{'Q': 19, 'R': 12, 'S': 6, 'T': 6, 'H': 12, 'M': 6}","{'Y': 6, 'A': 6, 'B': 3, 'D': 3, 'E': 3, 'G': 6, 'I': 3, 'K': 6, 'L': 3, 'N': 3, 'O': 3, 'U': 6, 'V': 3, 'W': 3, 'X': 3}"
INV-ZZ-2455005,SCH-ZZ-8346803,ZZ,ZZ20240601BLRDEL2257.0,2257.0,Boeing 757,06/01/2024,2024-06-01 04:37:00,2024-06-01 18:55:00,BLR,DEL,209.0,246,123,-86,123,20,41,62,83,23,11,9,12,49,24,17,25,69,34,28,35,97,48,35,49,"{'F': 12, 'P': 8}","{'C': 16, 'J': 12, 'Z': 12}","{'Q': 19, 'R': 12, 'S': 6, 'T': 6, 'H': 12, 'M': 6}","{'Y': 6, 'A': 6, 'B': 3, 'D': 3, 'E': 3, 'G': 6, 'I': 3, 'K': 6, 'L': 3, 'N': 3, 'O': 3, 'U': 6, 'V': 3, 'W': 3, 'X': 3}"
INV-ZZ-4019127,SCH-ZZ-8346803,ZZ,ZZ20240602BLRDEL2257.0,2257.0,Boeing 757,06/02/2024,2024-06-02 04:37:00,2024-06-02 18:55:00,BLR,DEL,209.0,244,111,-98,133,20,41,62,83,23,10,10,13,46,21,20,25,70,32,30,38,92,42,41,50,"{'F': 12, 'P': 8}","{'C': 16, 'J': 12, 'Z': 12}","{'Q': 19, 'R': 12, 'S': 6, 'T': 6, 'H': 12, 'M': 6}","{'Y': 6, 'A': 6, 'B': 3, 'D': 3, 'E': 3, 'G': 6, 'I': 3, 'K': 6, 'L': 3, 'N': 3, 'O': 3, 'U': 6, 'V': 3, 'W': 3, 'X': 3}"
INV-ZZ-5595784,SCH-ZZ-8346803,ZZ,ZZ20240603BLRDEL2257.0,2257.0,Boeing 757,06/03/2024,2024-06-03 04:37:00,2024-06-03 18:55:00,BLR,DEL,209.0,244,121,-88,123,20,41,62,83,23,11,9,12,47,23,18,24,68,34,28,34,95,47,36,48,"{'F': 12, 'P': 8}","{'C': 16, 'J': 12, 'Z': 12}","{'Q': 19, 'R': 12, 'S': 6, 'T': 6, 'H': 12, 'M': 6}","{'Y': 6, 'A': 6, 'B': 3, 'D': 3, 'E': 3, 'G': 6, 'I': 3, 'K': 6, 'L': 3, 'N': 3, 'O': 3, 'U': 6, 'V': 3, 'W': 3, 'X': 3}"
INV-ZZ-7544642,SCH-ZZ-8346803,ZZ,ZZ20240604BLRDEL2257.0,2257.0,Boeing 757,06/04/2024,2024-06-04 04:37:00,2024-06-04 18:55:00,BLR,DEL,209.0,246,122,-87,124,20,41,62,83,23,11,9,12,48,24,17,24,72,36,26,36,96,48,35,48,"{'F': 12, 'P': 8}","{'C': 16, 'J': 12, 'Z': 12}","{'Q': 19, 'R': 12, 'S': 6, 'T': 6, 'H': 12, 'M': 6}","{'Y': 6, 'A': 6, 'B': 3, 'D': 3, 'E': 3, 'G': 6, 'I': 3, 'K': 6, 'L': 3, 'N': 3, 'O': 3, 'U': 6, 'V': 3, 'W': 3, 'X': 3}"
INV-ZZ-4713880,SCH-ZZ-8346803,ZZ,ZZ20240605BLRDEL2257.0,2257.0,Boeing 757,06/05/2024,2024-06-05 04:37:00,2024-06-05 18:55:00,BLR,DEL,209.0,239,119,-90,120,20,41,62,83,23,11,9,12,49,24,17,25,72,36,26,36,98,49,34,49,"{'F': 12, 'P': 8}","{'C': 16, 'J': 12, 'Z': 12}","{'Q': 19, 'R': 12, 'S': 6, 'T': 6, 'H': 12, 'M': 6}","{'Y': 6, 'A': 6, 'B': 3, 'D': 3, 'E': 3, 'G': 6, 'I': 3, 'K': 6, 'L': 3, 'N': 3, 'O': 3, 'U': 6, 'V': 3, 'W': 3, 'X': 3}"
INV-ZZ-7997438,SCH-ZZ-8346803,ZZ,ZZ20240607BLRDEL2257.0,2257.0,Boeing 757,06/07/2024,2024-06-07 04:37:00,2024-06-07 18:55:00,BLR,DEL,209.0,236,102,-107,134,20,41,62,83,22,10,10,12,48,21,20,27,73,32,30,41,96,42,41,54,"{'F': 12, 'P': 8}","{'C': 16, 'J': 12, 'Z': 12}","{'Q': 19, 'R': 12, 'S': 6, 'T': 6, 'H': 12, 'M': 6}","{'Y': 6, 'A': 6, 'B': 3, 'D': 3, 'E': 3, 'G': 6, 'I': 3, 'K': 6, 'L': 3, 'N': 3, 'O': 3, 'U': 6, 'V': 3, 'W': 3, 'X': 3}"
INV-ZZ-5517088,SCH-ZZ-8346803,ZZ,ZZ20240608BLRDEL2257.0,2257.0,Boeing 757,06/08/2024,2024-06-08 04:37:00,2024-06-08 18:55:00,BLR,DEL,209.0,239,103,-106,136,20,41,62,83,22,9,11,13,47,20,21,27,74,32,30,42,93,40,43,53,"{'F': 12, 'P': 8}","{'C': 16, 'J': 12, 'Z': 12}","{'Q': 19, 'R': 12, 'S': 6, 'T': 6, 'H': 12, 'M': 6}","{'Y': 6, 'A': 6, 'B': 3, 'D': 3, 'E': 3, 'G': 6, 'I': 3, 'K': 6, 'L': 3, 'N': 3, 'O': 3, 'U': 6, 'V': 3, 'W': 3, 'X': 3}"
INV-ZZ-7899947,SCH-ZZ-8346803,ZZ,ZZ20240609BLRDEL2257.0,2257.0,Boeing 757,06/09/2024,2024-06-09 04:37:00,2024-06-09 18:55:00,BLR,DEL,209.0,248,106,-103,142,20,41,62,83,23,10,10,13,46,20,21,26,71,30,32,41,94,40,43,54,"{'F': 12, 'P': 8}","{'C': 16, 'J': 12, 'Z': 12}","{'Q': 19, 'R': 12, 'S': 6, 'T': 6, 'H': 12, 'M': 6}","{'Y': 6, 'A': 6, 'B': 3, 'D': 3, 'E': 3, 'G': 6, 'I': 3, 'K': 6, 'L': 3, 'N': 3, 'O': 3, 'U': 6, 'V': 3, 'W': 3, 'X': 3}"
INV-ZZ-5422298,SCH-ZZ-8346803,ZZ,ZZ20240610BLRDEL2257.0,2257.0,Boeing 757,06/10/2024,2024-06-10 04:37:00,2024-06-10 18:55:00,BLR,DEL,209.0,246,117,-92,129,20,41,62,83,23,11,9,12,46,22,19,24,73,35,27,38,97,46,37,51,"{'F': 12, 'P': 8}","{'C': 16, 'J': 12, 'Z': 12}","{'Q': 19, 'R': 12, 'S': 6, 'T': 6, 'H': 12, 'M': 6}","{'Y': 6, 'A': 6, 'B': 3, 'D': 3, 'E': 3, 'G': 6, 'I': 3, 'K': 6, 'L': 3, 'N': 3, 'O': 3, 'U': 6, 'V': 3, 'W': 3, 'X': 3}"
INV-ZZ-2442616,SCH-ZZ-8346803,ZZ,ZZ20240611BLRDEL2257.0,2257.0,Boeing 757,06/11/2024,2024-06-11 04:37:00,2024-06-11 18:55:00,BLR,DEL,209.0,231,102,-107,129,20,41,62,83,24,11,9,13,49,22,19,27,71,31,31,40,96,43,40,53,"{'F': 12, 'P': 8}","{'C': 16, 'J': 12, 'Z': 12}","{'Q': 19, 'R': 12, 'S': 6, 'T': 6, 'H': 12, 'M': 6}","{'Y': 6, 'A': 6, 'B': 3, 'D': 3, 'E': 3, 'G': 6, 'I': 3, 'K': 6, 'L': 3, 'N': 3, 'O': 3, 'U': 6, 'V': 3, 'W': 3, 'X': 3}"
INV-ZZ-2010649,SCH-ZZ-8346803,ZZ,ZZ20240612BLRDEL2257.0,2257.0,Boeing 757,06/12/2024,2024-06-12 04:37:00,2024-06-12 18:55:00,BLR,DEL,209.0,245,118,-91,127,20,41,62,83,22,11,9,11,46,22,19,24,70,34,28,36,98,47,36,51,"{'F': 12, 'P': 8}","{'C': 16, 'J': 12, 'Z': 12}","{'Q': 19, 'R': 12, 'S': 6, 'T': 6, 'H': 12, 'M': 6}","{'Y': 6, 'A': 6, 'B': 3, 'D': 3, 'E': 3, 'G': 6, 'I': 3, 'K': 6, 'L': 3, 'N': 3, 'O': 3, 'U': 6, 'V': 3, 'W': 3, 'X': 3}"
INV-ZZ-8346431,SCH-ZZ-8346803,ZZ,ZZ20240614BLRDEL2257.0,2257.0,Boeing 757,06/14/2024,2024-06-14 04:37:00,2024-06-14 18:55:00,BLR,DEL,209.0,235,112,-97,123,20,41,62,83,22,11,9,11,48,23,18,25,74,35,27,39,95,45,38,50,"{'F': 12, 'P': 8}","{'C': 16, 'J': 12, 'Z': 12}","{'Q': 19, 'R': 12, 'S': 6, 'T': 6, 'H': 12, 'M': 6}","{'Y': 6, 'A': 6, 'B': 3, 'D': 3, 'E': 3, 'G': 6, 'I': 3, 'K': 6, 'L': 3, 'N': 3, 'O': 3, 'U': 6, 'V': 3, 'W': 3, 'X': 3}"
INV-ZZ-7882059,SCH-ZZ-8346803,ZZ,ZZ20240615BLRDEL2257.0,2257.0,Boeing 757,06/15/2024,2024-06-15 04:37:00,2024-06-15 18:55:00,BLR,DEL,209.0,237,113,-96,124,20,41,62,83,22,10,10,12,45,21,20,24,74,35,27,39,96,46,37,50,"{'F': 12, 'P': 8}","{'C': 16, 'J': 12, 'Z': 12}","{'Q': 19, 'R': 12, 'S': 6, 'T': 6, 'H': 12, 'M': 6}","{'Y': 6, 'A': 6, 'B': 3, 'D': 3, 'E': 3, 'G': 6, 'I': 3, 'K': 6, 'L': 3, 'N': 3, 'O': 3, 'U': 6, 'V': 3, 'W': 3, 'X': 3}"
INV-ZZ-3292541,SCH-ZZ-8346803,ZZ,ZZ20240616BLRDEL2257.0,2257.0,Boeing 757,06/16/2024,2024-06-16 04:37:00,2024-06-16 18:55:00,BLR,DEL,209.0,245,102,-107,143,20,41,62,83,23,10,10,13,47,20,21,27,73,31,31,42,92,38,45,54,"{'F': 12, 'P': 8}","{'C': 16, 'J': 12, 'Z': 12}","{'Q': 19, 'R': 12, 'S': 6, 'T': 6, 'H': 12, 'M': 6}","{'Y': 6, 'A': 6, 'B': 3, 'D': 3, 'E': 3, 'G': 6, 'I': 3, 'K': 6, 'L': 3, 'N': 3, 'O': 3, 'U': 6, 'V': 3, 'W': 3, 'X': 3}"
INV-ZZ-9832649,SCH-ZZ-8346803,ZZ,ZZ20240617BLRDEL2257.0,2257.0,Boeing 757,06/17/2024,2024-06-17 04:37:00,2024-06-17 18:55:00,BLR,DEL,209.0,240,102,-107,138,20,41,62,83,23,10,10,13,48,20,21,28,71,30,32,41,94,40,43,54,"{'F': 12, 'P': 8}","{'C': 16, 'J': 12, 'Z': 12}","{'Q': 19, 'R': 12, 'S': 6, 'T': 6, 'H': 12, 'M': 6}","{'Y': 6, 'A': 6, 'B': 3, 'D': 3, 'E': 3, 'G': 6, 'I': 3, 'K': 6, 'L': 3, 'N': 3, 'O': 3, 'U': 6, 'V': 3, 'W': 3, 'X': 3}"
INV-ZZ-7784326,SCH-ZZ-8346803,ZZ,ZZ20240618BLRDEL2257.0,2257.0,Boeing 757,06/18/2024,2024-06-18 04:37:00,2024-06-18 18:55:00,BLR,DEL,209.0,230,105,-104,125,20,41,62,83,23,10,10,13,46,21,20,25,73,33,29,40,98,45,38,53,"{'F': 12, 'P': 8}","{'C': 16, 'J': 12, 'Z': 12}","{'Q': 19, 'R': 12, 'S': 6, 'T': 6, 'H': 12, 'M': 6}","{'Y': 6, 'A': 6, 'B': 3, 'D': 3, 'E': 3, 'G': 6, 'I': 3, 'K': 6, 'L': 3, 'N': 3, 'O': 3, 'U': 6, 'V': 3, 'W': 3, 'X': 3}"
INV-ZZ-5341962,SCH-ZZ-8346803,ZZ,ZZ20240619BLRDEL2257.0,2257.0,Boeing 757,06/19/2024,2024-06-19 04:37:00,2024-06-19 18:55:00,BLR,DEL,209.0,248,116,-93,132,20,41,62,83,23,11,9,12,46,21,20,25,68,32,30,36,97,45,38,52,"{'F': 12, 'P': 8}","{'C': 16, 'J': 12, 'Z': 12}","{'Q': 19, 'R': 12, 'S': 6, 'T': 6, 'H': 12, 'M': 6}","{'Y': 6, 'A': 6, 'B': 3, 'D': 3, 'E': 3, 'G': 6, 'I': 3, 'K': 6, 'L': 3, 'N': 3, 'O': 3, 'U': 6, 'V': 3, 'W': 3, 'X': 3}"
INV-ZZ-4008555,SCH-ZZ-8346803,ZZ,ZZ20240621BLRDEL2257.0,2257.0,Boeing 757,06/21/2024,2024-06-21 04:37:00,2024-06-21 18:55:00,BLR,DEL,209.0,233,101,-108,132,20,41,62,83,23,10,10,13,47,20,21,27,70,30,32,40,93,40,43,53,"{'F': 12, 'P': 8}","{'C': 16, 'J': 12, 'Z': 12}","{'Q': 19, 'R': 12, 'S': 6, 'T': 6, 'H': 12, 'M': 6}","{'Y': 6, 'A': 6, 'B': 3, 'D': 3, 'E': 3, 'G': 6, 'I': 3, 'K': 6, 'L': 3, 'N': 3, 'O': 3, 'U': 6, 'V': 3, 'W': 3, 'X': 3}"
INV-ZZ-8203045,SCH-ZZ-8346803,ZZ,ZZ20240622BLRDEL2257.0,2257.0,Boeing 757,06/22/2024,2024-06-22 04:37:00,2024-06-22 18:55:00,BLR,DEL,209.0,244,108,-101,136,20,41,62,83,23,10,10,13,48,21,20,27,73,32,30,41,97,43,40,54,"{'F': 12, 'P': 8}","{'C': 16, 'J': 12, 'Z': 12}","{'Q': 19, 'R': 12, 'S': 6, 'T': 6, 'H': 12, 'M': 6}","{'Y': 6, 'A': 6, 'B': 3, 'D': 3, 'E': 3, 'G': 6, 'I': 3, 'K': 6, 'L': 3, 'N': 3, 'O': 3, 'U': 6, 'V': 3, 'W': 3, 'X': 3}"
INV-ZZ-7703162,SCH-ZZ-5156445,ZZ,ZZ20240514AMDBLR3782.0,3782.0,Boeing 787,05/14/2024,2024-05-14 15:57:00,2024-05-15 07:24:00,AMD,BLR,270.0,313,168,-102,145,27,54,81,108,30,16,11,14,64,34,20,30,92,49,32,43,120,65,43,55,"{'F': 16, 'P': 11}","{'C': 22, 'J': 16, 'Z': 16}","{'Q': 24, 'R': 16, 'S': 8, 'T': 8, 'H': 16, 'M': 8}","{'Y': 8, 'A': 8, 'B': 4, 'D': 4, 'E': 4, 'G': 8, 'I': 4, 'K': 8, 'L': 4, 'N': 4, 'O': 4, 'U': 8, 'V': 4, 'W': 4, 'X': 4}"
INV-ZZ-7431689,SCH-ZZ-5156445,ZZ,ZZ20240515AMDBLR3782.0,3782.0,Boeing 787,05/15/2024,2024-05-15 15:57:00,2024-05-16 07:24:00,AMD,BLR,270.0,315,167,-103,148,27,54,81,108,30,16,11,14,60,32,22,28,90,48,33,42,125,66,42,59,"{'F': 16, 'P': 11}","{'C': 22, 'J': 16, 'Z': 16}","{'Q': 24, 'R': 16, 'S': 8, 'T': 8, 'H': 16, 'M': 8}","{'Y': 8, 'A': 8, 'B': 4, 'D': 4, 'E': 4, 'G': 8, 'I': 4, 'K': 8, 'L': 4, 'N': 4, 'O': 4, 'U': 8, 'V': 4, 'W': 4, 'X': 4}"
INV-ZZ-1603837,SCH-ZZ-5156445,ZZ,ZZ20240517AMDBLR3782.0,3782.0,Boeing 787,05/17/2024,2024-05-17 15:57:00,2024-05-18 07:24:00,AMD,BLR,270.0,321,153,-117,168,27,54,81,108,30,14,13,16,65,31,23,34,96,46,35,50,119,57,51,62,"{'F': 16, 'P': 11}","{'C': 22, 'J': 16, 'Z': 16}","{'Q': 24, 'R': 16, 'S': 8, 'T': 8, 'H': 16, 'M': 8}","{'Y': 8, 'A': 8, 'B': 4, 'D': 4, 'E': 4, 'G': 8, 'I': 4, 'K': 8, 'L': 4, 'N': 4, 'O': 4, 'U': 8, 'V': 4, 'W': 4, 'X': 4}"
INV-ZZ-6060194,SCH-ZZ-5156445,ZZ,ZZ20240518AMDBLR3782.0,3782.0,Boeing 787,05/18/2024,2024-05-18 15:57:00,2024-05-19 07:24:00,AMD,BLR,270.0,303,145,-125,158,27,54,81,108,32,15,12,17,61,29,25,32,95,46,35,49,121,58,50,63,"{'F': 16, 'P': 11}","{'C': 22, 'J': 16, 'Z': 16}","{'Q': 24, 'R': 16, 'S': 8, 'T': 8, 'H': 16, 'M': 8}","{'Y': 8, 'A': 8, 'B': 4, 'D': 4, 'E': 4, 'G': 8, 'I': 4, 'K': 8, 'L': 4, 'N': 4, 'O': 4, 'U': 8, 'V': 4, 'W': 4, 'X': 4}"
INV-ZZ-3258972,SCH-ZZ-5156445,ZZ,ZZ20240521AMDBLR3782.0,3782.0,Boeing 787,05/21/2024,2024-05-21 15:57:00,2024-05-22 07:24:00,AMD,BLR,270.0,321,162,-108,159,27,54,81,108,31,16,11,15,62,31,23,31,91,46,35,45,123,62,46,61,"{'F': 16, 'P': 11}","{'C': 22, 'J': 16, 'Z': 16}","{'Q': 24, 'R': 16, 'S': 8, 'T': 8, 'H': 16, 'M': 8}","{'Y': 8, 'A': 8, 'B': 4, 'D': 4, 'E': 4, 'G': 8, 'I': 4, 'K': 8, 'L': 4, 'N': 4, 'O': 4, 'U': 8, 'V': 4, 'W': 4, 'X': 4}"
INV-ZZ-5744475,SCH-ZZ-5156445,ZZ,ZZ20240522AMDBLR3782.0,3782.0,Boeing 787,05/22/2024,2024-05-22 15:57:00,2024-05-23 07:24:00,AMD,BLR,270.0,306,164,-106,142,27,54,81,108,31,17,10,14,63,34,20,29,93,50,31,43,120,64,44,56,"{'F': 16, 'P': 11}","{'C': 22, 'J': 16, 'Z': 16}","{'Q': 24, 'R': 16, 'S': 8, 'T': 8, 'H': 16, 'M': 8}","{'Y': 8, 'A': 8, 'B': 4, 'D': 4, 'E': 4, 'G': 8, 'I': 4, 'K': 8, 'L': 4, 'N': 4, 'O': 4, 'U': 8, 'V': 4, 'W': 4, 'X': 4}"
INV-ZZ-4515786,SCH-ZZ-5156445,ZZ,ZZ20240524AMDBLR3782.0,3782.0,Boeing 787,05/24/2024,2024-05-24 15:57:00,2024-05-25 07:24:00,AMD,BLR,270.0,320,171,-99,149,27,54,81,108,30,16,11,14,65,35,19,30,97,52,29,45,124,66,42,58,"{'F': 16, 'P': 11}","{'C': 22, 'J': 16, 'Z': 16}","{'Q': 24, 'R': 16, 'S': 8, 'T': 8, 'H': 16, 'M': 8}","{'Y': 8, 'A': 8, 'B': 4, 'D': 4, 'E': 4, 'G': 8, 'I': 4, 'K': 8, 'L': 4, 'N': 4, 'O': 4, 'U': 8, 'V': 4, 'W': 4, 'X': 4}"
INV-ZZ-9800834,SCH-ZZ-5156445,ZZ,ZZ20240525AMDBLR3782.0,3782.0,Boeing 787,05/25/2024,2024-05-25 15:57:00,2024-05-26 07:24:00,AMD,BLR,270.0,304,141,-129,163,27,54,81,108,32,15,12,17,61,28,26,33,91,42,39,49,128,60,48,68,"{'F': 16, 'P': 11}","{'C': 22, 'J': 16, 'Z': 16}","{'Q': 24, 'R': 16, 'S': 8, 'T': 8, 'H': 16, 'M': 8}","{'Y': 8, 'A': 8, 'B': 4, 'D': 4, 'E': 4, 'G': 8, 'I': 4, 'K': 8, 'L': 4, 'N': 4, 'O': 4, 'U': 8, 'V': 4, 'W': 4, 'X': 4}"
INV-ZZ-9610909,SCH-ZZ-5156445,ZZ,ZZ20240528AMDBLR3782.0,3782.0,Boeing 787,05/28/2024,2024-05-28 15:57:00,2024-05-29 07:24:00,AMD,BLR,270.0,299,141,-129,158,27,54,81,108,32,15,12,17,60,28,26,32,93,44,37,49,121,57,51,64,"{'F': 16, 'P': 11}","{'C': 22, 'J': 16, 'Z': 16}","{'Q': 24, 'R': 16, 'S': 8, 'T': 8, 'H': 16, 'M': 8}","{'Y': 8, 'A': 8, 'B': 4, 'D': 4, 'E': 4, 'G': 8, 'I': 4, 'K': 8, 'L': 4, 'N': 4, 'O': 4, 'U': 8, 'V': 4, 'W': 4, 'X': 4}"
INV-ZZ-6717278,SCH-ZZ-5156445,ZZ,ZZ20240529AMDBLR3782.0,3782.0,Boeing 787,05/29/2024,2024-05-29 15:57:00,2024-05-30 07:24:00,AMD,BLR,270.0,319,148,-122,171,27,54,81,108,30,14,13,16,61,28,26,33,91,42,39,49,119,55,53,64,"{'F': 16, 'P': 11}","{'C': 22, 'J': 16, 'Z': 16}","{'Q': 24, 'R': 16, 'S': 8, 'T': 8, 'H': 16, 'M': 8}","{'Y': 8, 'A': 8, 'B': 4, 'D': 4, 'E': 4, 'G': 8, 'I': 4, 'K': 8, 'L': 4, 'N': 4, 'O': 4, 'U': 8, 'V': 4, 'W': 4, 'X': 4}"
INV-ZZ-2676115,SCH-ZZ-5156445,ZZ,ZZ20240531AMDBLR3782.0,3782.0,Boeing 787,05/31/2024,2024-05-31 15:57:00,2024-06-01 07:24:00,AMD,BLR,270.0,315,145,-125,170,27,54,81,108,31,14,13,17,62,28,26,34,96,44,37,52,125,57,51,68,"{'F': 16, 'P': 11}","{'C': 22, 'J': 16, 'Z': 16}","{'Q': 24, 'R': 16, 'S': 8, 'T': 8, 'H': 16, 'M': 8}","{'Y': 8, 'A': 8, 'B': 4, 'D': 4, 'E': 4, 'G': 8, 'I': 4, 'K': 8, 'L': 4, 'N': 4, 'O': 4, 'U': 8, 'V': 4, 'W': 4, 'X': 4}"
INV-ZZ-1374753,SCH-ZZ-5156445,ZZ,ZZ20240601AMDBLR3782.0,3782.0,Boeing 787,06/01/2024,2024-06-01 15:57:00,2024-06-02 07:24:00,AMD,BLR,270.0,316,154,-116,162,27,54,81,108,32,16,11,16,60,29,25,31,91,44,37,47,124,61,47,63,"{'F': 16, 'P': 11}","{'C': 22, 'J': 16, 'Z': 16}","{'Q': 24, 'R': 16, 'S': 8, 'T': 8, 'H': 16, 'M': 8}","{'Y': 8, 'A': 8, 'B': 4, 'D': 4, 'E': 4, 'G': 8, 'I': 4, 'K': 8, 'L': 4, 'N': 4, 'O': 4, 'U': 8, 'V': 4, 'W': 4, 'X': 4}"
INV-ZZ-2703663,SCH-ZZ-5156445,ZZ,ZZ20240604AMDBLR3782.0,3782.0,Boeing 787,06/04/2024,2024-06-04 15:57:00,2024-06-05 07:24:00,AMD,BLR,270.0,301,153,-117,148,27,54,81,108,31,16,11,15,64,32,22,32,92,47,34,45,128,65,43,63,"{'F': 16, 'P': 11}","{'C': 22, 'J': 16, 'Z': 16}","{'Q': 24, 'R': 16, 'S': 8, 'T': 8, 'H': 16, 'M': 8}","{'Y': 8, 'A': 8, 'B': 4, 'D': 4, 'E': 4, 'G': 8, 'I': 4, 'K': 8, 'L': 4, 'N': 4, 'O': 4, 'U': 8, 'V': 4, 'W': 4, 'X': 4}"
INV-ZZ-4502566,SCH-ZZ-5156445,ZZ,ZZ20240605AMDBLR3782.0,3782.0,Boeing 787,06/05/2024,2024-06-05 15:57:00,2024-06-06 07:24:00,AMD,BLR,270.0,323,154,-116,169,27,54,81,108,30,14,13,16,62,30,24,32,94,45,36,49,129,62,46,67,"{'F': 16, 'P': 11}","{'C': 22, 'J': 16, 'Z': 16}","{'Q': 24, 'R': 16, 'S': 8, 'T': 8, 'H': 16, 'M': 8}","{'Y': 8, 'A': 8, 'B': 4, 'D': 4, 'E': 4, 'G': 8, 'I': 4, 'K': 8, 'L': 4, 'N': 4, 'O': 4, 'U': 8, 'V': 4, 'W': 4, 'X': 4}"
INV-ZZ-7871820,SCH-ZZ-5156445,ZZ,ZZ20240607AMDBLR3782.0,3782.0,Boeing 787,06/07/2024,2024-06-07 15:57:00,2024-06-08 07:24:00,AMD,BLR,270.0,315,134,-136,181,27,54,81,108,30,13,14,17,64,27,27,37,91,39,42,52,128,55,53,73,"{'F': 16, 'P': 11}","{'C': 22, 'J': 16, 'Z': 16}","{'Q': 24, 'R': 16, 'S': 8, 'T': 8, 'H': 16, 'M': 8}","{'Y': 8, 'A': 8, 'B': 4, 'D': 4, 'E': 4, 'G': 8, 'I': 4, 'K': 8, 'L': 4, 'N': 4, 'O': 4, 'U': 8, 'V': 4, 'W': 4, 'X': 4}"
INV-ZZ-8708544,SCH-ZZ-5156445,ZZ,ZZ20240608AMDBLR3782.0,3782.0,Boeing 787,06/08/2024,2024-06-08 15:57:00,2024-06-09 07:24:00,AMD,BLR,270.0,297,136,-134,161,27,54,81,108,30,14,13,16,64,29,25,35,94,43,38,51,124,57,51,67,"{'F': 16, 'P': 11}","{'C': 22, 'J': 16, 'Z': 16}","{'Q': 24, 'R': 16, 'S': 8, 'T': 8, 'H': 16, 'M': 8}","{'Y': 8, 'A': 8, 'B': 4, 'D': 4, 'E': 4, 'G': 8, 'I': 4, 'K': 8, 'L': 4, 'N': 4, 'O': 4, 'U': 8, 'V': 4, 'W': 4, 'X': 4}"
INV-ZZ-7825115,SCH-ZZ-5156445,ZZ,ZZ20240611AMDBLR3782.0,3782.0,Boeing 787,06/11/2024,2024-06-11 15:57:00,2024-06-12 07:24:00,AMD,BLR,270.0,298,135,-135,163,27,54,81,108,31,14,13,17,64,29,25,35,91,41,40,50,121,55,53,66,"{'F': 16, 'P': 11}","{'C': 22, 'J': 16, 'Z': 16}","{'Q': 24, 'R': 16, 'S': 8, 'T': 8, 'H': 16, 'M': 8}","{'Y': 8, 'A': 8, 'B': 4, 'D': 4, 'E': 4, 'G': 8, 'I': 4, 'K': 8, 'L': 4, 'N': 4, 'O': 4, 'U': 8, 'V': 4, 'W': 4, 'X': 4}"
INV-ZZ-4106516,SCH-ZZ-5156445,ZZ,ZZ20240612AMDBLR3782.0,3782.0,Boeing 787,06/12/2024,2024-06-12 15:57:00,2024-06-13 07:24:00,AMD,BLR,270.0,301,134,-136,167,27,54,81,108,32,14,13,18,65,29,25,36,92,41,40,51,121,54,54,67,"{'F': 16, 'P': 11}","{'C': 22, 'J': 16, 'Z': 16}","{'Q': 24, 'R': 16, 'S': 8, 'T': 8, 'H': 16, 'M': 8}","{'Y': 8, 'A': 8, 'B': 4, 'D': 4, 'E': 4, 'G': 8, 'I': 4, 'K': 8, 'L': 4, 'N': 4, 'O': 4, 'U': 8, 'V': 4, 'W': 4, 'X': 4}"
INV-ZZ-3234914,SCH-ZZ-5156445,ZZ,ZZ20240614AMDBLR3782.0,3782.0,Boeing 787,06/14/2024,2024-06-14 15:57:00,2024-06-15 07:24:00,AMD,BLR,270.0,305,141,-129,164,27,54,81,108,32,15,12,17,64,30,24,34,94,43,38,51,126,58,50,68,"{'F': 16, 'P': 11}","{'C': 22, 'J': 16, 'Z': 16}","{'Q': 24, 'R': 16, 'S': 8, 'T': 8, 'H': 16, 'M': 8}","{'Y': 8, 'A': 8, 'B': 4, 'D': 4, 'E': 4, 'G': 8, 'I': 4, 'K': 8, 'L': 4, 'N': 4, 'O': 4, 'U': 8, 'V': 4, 'W': 4, 'X': 4}"
INV-ZZ-1091878,SCH-ZZ-5156445,ZZ,ZZ20240615AMDBLR3782.0,3782.0,Boeing 787,06/15/2024,2024-06-15 15:57:00,2024-06-16 07:24:00,AMD,BLR,270.0,309,130,-140,179,27,54,81,108,32,13,14,19,61,26,28,35,93,39,42,54,123,52,56,71,"{'F': 16, 'P': 11}","{'C': 22, 'J': 16, 'Z': 16}","{'Q': 24, 'R': 16, 'S': 8, 'T': 8, 'H': 16, 'M': 8}","{'Y': 8, 'A': 8, 'B': 4, 'D': 4, 'E': 4, 'G': 8, 'I': 4, 'K': 8, 'L': 4, 'N': 4, 'O': 4, 'U': 8, 'V': 4, 'W': 4, 'X': 4}"
INV-ZZ-6098176,SCH-ZZ-5156445,ZZ,ZZ20240618AMDBLR3782.0,3782.0,Boeing 787,06/18/2024,2024-06-18 15:57:00,2024-06-19 07:24:00,AMD,BLR,270.0,315,130,-140,185,27,54,81,108,31,13,14,18,61,25,29,36,90,37,44,53,123,51,57,72,"{'F': 16, 'P': 11}","{'C': 22, 'J': 16, 'Z': 16}","{'Q': 24, 'R': 16, 'S': 8, 'T': 8, 'H': 16, 'M': 8}","{'Y': 8, 'A': 8, 'B': 4, 'D': 4, 'E': 4, 'G': 8, 'I': 4, 'K': 8, 'L': 4, 'N': 4, 'O': 4, 'U': 8, 'V': 4, 'W': 4, 'X': 4}"
INV-ZZ-1874920,SCH-ZZ-5156445,ZZ,ZZ20240619AMDBLR3782.0,3782.0,Boeing 787,06/19/2024,2024-06-19 15:57:00,2024-06-20 07:24:00,AMD,BLR,270.0,302,127,-143,175,27,54,81,108,32,14,13,18,64,27,27,37,97,41,40,56,122,51,57,71,"{'F': 16, 'P': 11}","{'C': 22, 'J': 16, 'Z': 16}","{'Q': 24, 'R': 16, 'S': 8, 'T': 8, 'H': 16, 'M': 8}","{'Y': 8, 'A': 8, 'B': 4, 'D': 4, 'E': 4, 'G': 8, 'I': 4, 'K': 8, 'L': 4, 'N': 4, 'O': 4, 'U': 8, 'V': 4, 'W': 4, 'X': 4}"
INV-ZZ-4976890,SCH-ZZ-5156445,ZZ,ZZ20240621AMDBLR3782.0,3782.0,Boeing 787,06/21/2024,2024-06-21 15:57:00,2024-06-22 07:24:00,AMD,BLR,270.0,309,134,-136,175,27,54,81,108,32,14,13,18,59,26,28,33,96,42,39,54,123,53,55,70,"{'F': 16, 'P': 11}","{'C': 22, 'J': 16, 'Z': 16}","{'Q': 24, 'R': 16, 'S': 8, 'T': 8, 'H': 16, 'M': 8}","{'Y': 8, 'A': 8, 'B': 4, 'D': 4, 'E': 4, 'G': 8, 'I': 4, 'K': 8, 'L': 4, 'N': 4, 'O': 4, 'U': 8, 'V': 4, 'W': 4, 'X': 4}"
INV-ZZ-5754495,SCH-ZZ-5156445,ZZ,ZZ20240622AMDBLR3782.0,3782.0,Boeing 787,06/22/2024,2024-06-22 15:57:00,2024-06-23 07:24:00,AMD,BLR,270.0,303,131,-139,172,27,54,81,108,31,13,14,18,61,26,28,35,94,40,41,54,128,55,53,73,"{'F': 16, 'P': 11}","{'C': 22, 'J': 16, 'Z': 16}","{'Q': 24, 'R': 16, 'S': 8, 'T': 8, 'H': 16, 'M': 8}","{'Y': 8, 'A': 8, 'B': 4, 'D': 4, 'E': 4, 'G': 8, 'I': 4, 'K': 8, 'L': 4, 'N': 4, 'O': 4, 'U': 8, 'V': 4, 'W': 4, 'X': 4}"
INV-ZZ-1118477,SCH-ZZ-5156445,ZZ,ZZ20240625AMDBLR3782.0,3782.0,Boeing 787,06/25/2024,2024-06-25 15:57:00,2024-06-26 07:24:00,AMD,BLR,270.0,314,137,-133,177,27,54,81,108,32,14,13,18,60,26,28,34,95,41,40,54,125,55,53,70,"{'F': 16, 'P': 11}","{'C': 22, 'J': 16, 'Z': 16}","{'Q': 24, 'R': 16, 'S': 8, 'T': 8, 'H': 16, 'M': 8}","{'Y': 8, 'A': 8, 'B': 4, 'D': 4, 'E': 4, 'G': 8, 'I': 4, 'K': 8, 'L': 4, 'N': 4, 'O': 4, 'U': 8, 'V': 4, 'W': 4, 'X': 4}"
INV-ZZ-3981792,SCH-ZZ-5156445,ZZ,ZZ20240626AMDBLR3782.0,3782.0,Boeing 787,06/26/2024,2024-06-26 15:57:00,2024-06-27 07:24:00,AMD,BLR,270.0,305,127,-143,178,27,54,81,108,31,13,14,18,60,25,29,35,95,40,41,55,126,52,56,74,"{'F': 16, 'P': 11}","{'C': 22, 'J': 16, 'Z': 16}","{'Q': 24, 'R': 16, 'S': 8, 'T': 8, 'H': 16, 'M': 8}","{'Y': 8, 'A': 8, 'B': 4, 'D': 4, 'E': 4, 'G': 8, 'I': 4, 'K': 8, 'L': 4, 'N': 4, 'O': 4, 'U': 8, 'V': 4, 'W': 4, 'X': 4}"
INV-ZZ-6218276,SCH-ZZ-3838342,ZZ,ZZ20240414HYDCCU3772.0,3772.0,Boeing 767,04/14/2024,2024-04-14 05:58:00,2024-04-15 03:23:00,HYD,CCU,278.0,320,197,-81,123,27,55,83,111,30,18,9,12,61,37,18,24,93,57,26,36,125,77,34,48,"{'F': 16, 'P': 11}","{'C': 22, 'J': 16, 'Z': 16}","{'Q': 25, 'R': 17, 'S': 8, 'T': 8, 'H': 17, 'M': 8}","{'Y': 8, 'A': 8, 'B': 4, 'D': 4, 'E': 4, 'G': 8, 'I': 4, 'K': 8, 'L': 4, 'N': 4, 'O': 4, 'U': 8, 'V': 4, 'W': 4, 'X': 4}"
INV-ZZ-4899984,SCH-ZZ-3838342,ZZ,ZZ20240416HYDCCU3772.0,3772.0,Boeing 767,04/16/2024,2024-04-16 05:58:00,2024-04-17 03:23:00,HYD,CCU,278.0,316,197,-81,119,27,55,83,111,32,20,7,12,61,38,17,23,99,62,21,37,129,80,31,49,"{'F': 16, 'P': 11}","{'C': 22, 'J': 16, 'Z': 16}","{'Q': 25, 'R': 17, 'S': 8, 'T': 8, 'H': 17, 'M': 8}","{'Y': 8, 'A': 8, 'B': 4, 'D': 4, 'E': 4, 'G': 8, 'I': 4, 'K': 8, 'L': 4, 'N': 4, 'O': 4, 'U': 8, 'V': 4, 'W': 4, 'X': 4}"
INV-ZZ-8764000,SCH-ZZ-3838342,ZZ,ZZ20240419HYDCCU3772.0,3772.0,Boeing 767,04/19/2024,2024-04-19 05:58:00,2024-04-20 03:23:00,HYD,CCU,278.0,311,182,-96,129,27,55,83,111,31,18,9,13,65,38,17,27,99,58,25,41,128,75,36,53,"{'F': 16, 'P': 11}","{'C': 22, 'J': 16, 'Z': 16}","{'Q': 25, 'R': 17, 'S': 8, 'T': 8, 'H': 17, 'M': 8}","{'Y': 8, 'A': 8, 'B': 4, 'D': 4, 'E': 4, 'G': 8, 'I': 4, 'K': 8, 'L': 4, 'N': 4, 'O': 4, 'U': 8, 'V': 4, 'W': 4, 'X': 4}"
INV-ZZ-9643127,SCH-ZZ-3838342,ZZ,ZZ20240420HYDCCU3772.0,3772.0,Boeing 767,04/20/2024,2024-04-20 05:58:00,2024-04-21 03:23:00,HYD,CCU,278.0,330,192,-86,138,27,55,83,111,32,19,8,13,63,37,18,26,93,54,29,39,132,77,34,55,"{'F': 16, 'P': 11}","{'C': 22, 'J': 16, 'Z': 16}","{'Q': 25, 'R': 17, 'S': 8, 'T': 8, 'H': 17, 'M': 8}","{'Y': 8, 'A': 8, 'B': 4, 'D': 4, 'E': 4, 'G': 8, 'I': 4, 'K': 8, 'L': 4, 'N': 4, 'O': 4, 'U': 8, 'V': 4, 'W': 4, 'X': 4}"
INV-ZZ-2545790,SCH-ZZ-3838342,ZZ,ZZ20240421HYDCCU3772.0,3772.0,Boeing 767,04/21/2024,2024-04-21 05:58:00,2024-04-22 03:23:00,HYD,CCU,278.0,323,193,-85,130,27,55,83,111,32,19,8,13,65,39,16,26,96,57,26,39,127,76,35,51,"{'F': 16, 'P': 11}","{'C': 22, 'J': 16, 'Z': 16}","{'Q': 25, 'R': 17, 'S': 8, 'T': 8, 'H': 17, 'M': 8}","{'Y': 8, 'A': 8, 'B': 4, 'D': 4, 'E': 4, 'G': 8, 'I': 4, 'K': 8, 'L': 4, 'N': 4, 'O': 4, 'U': 8, 'V': 4, 'W': 4, 'X': 4}"
INV-ZZ-8720109,SCH-ZZ-3838342,ZZ,ZZ20240423HYDCCU3772.0,3772.0,Boeing 767,04/23/2024,2024-04-23 05:58:00,2024-04-24 03:23:00,HYD,CCU,278.0,316,191,-87,125,27,55,83,111,31,19,8,12,64,39,16,25,92,56,27,36,125,76,35,49,"{'F': 16, 'P': 11}","{'C': 22, 'J': 16, 'Z': 16}","{'Q': 25, 'R': 17, 'S': 8, 'T': 8, 'H': 17, 'M': 8}","{'Y': 8, 'A': 8, 'B': 4, 'D': 4, 'E': 4, 'G': 8, 'I': 4, 'K': 8, 'L': 4, 'N': 4, 'O': 4, 'U': 8, 'V': 4, 'W': 4, 'X': 4}"
INV-ZZ-4863717,SCH-ZZ-3838342,ZZ,ZZ20240426HYDCCU3772.0,3772.0,Boeing 767,04/26/2024,2024-04-26 05:58:00,2024-04-27 03:23:00,HYD,CCU,278.0,312,177,-101,135,27,55,83,111,32,18,9,14,61,35,20,26,93,53,30,40,128,73,38,55,"{'F': 16, 'P': 11}","{'C': 22, 'J': 16, 'Z': 16}","{'Q': 25, 'R': 17, 'S': 8, 'T': 8, 'H': 17, 'M': 8}","{'Y': 8, 'A': 8, 'B': 4, 'D': 4, 'E': 4, 'G': 8, 'I': 4, 'K': 8, 'L': 4, 'N': 4, 'O': 4, 'U': 8, 'V': 4, 'W': 4, 'X': 4}"
INV-ZZ-9261996,SCH-ZZ-3838342,ZZ,ZZ20240427HYDCCU3772.0,3772.0,Boeing 767,04/27/2024,2024-04-27 05:58:00,2024-04-28 03:23:00,HYD,CCU,278.0,321,194,-84,127,27,55,83,111,30,18,9,12,61,37,18,24,95,57,26,38,124,75,36,49,"{'F': 16, 'P': 11}","{'C': 22, 'J': 16, 'Z': 16}","{'Q': 25, 'R': 17, 'S': 8, 'T': 8, 'H': 17, 'M': 8}","{'Y': 8, 'A': 8, 'B': 4, 'D': 4, 'E': 4, 'G': 8, 'I': 4, 'K': 8, 'L': 4, 'N': 4, 'O': 4, 'U': 8, 'V': 4, 'W': 4, 'X': 4}"
INV-ZZ-6079233,SCH-ZZ-3838342,ZZ,ZZ20240428HYDCCU3772.0,3772.0,Boeing 767,04/28/2024,2024-04-28 05:58:00,2024-04-29 03:23:00,HYD,CCU,278.0,316,192,-86,124,27,55,83,111,31,19,8,12,62,38,17,24,93,57,26,36,124,75,36,49,"{'F': 16, 'P': 11}","{'C': 22, 'J': 16, 'Z': 16}","{'Q': 25, 'R': 17, 'S': 8, 'T': 8, 'H': 17, 'M': 8}","{'Y': 8, 'A': 8, 'B': 4, 'D': 4, 'E': 4, 'G': 8, 'I': 4, 'K': 8, 'L': 4, 'N': 4, 'O': 4, 'U': 8, 'V': 4, 'W': 4, 'X': 4}"
INV-ZZ-6286160,SCH-ZZ-3838342,ZZ,ZZ20240430HYDCCU3772.0,3772.0,Boeing 767,04/30/2024,2024-04-30 05:58:00,2024-05-01 03:23:00,HYD,CCU,278.0,318,185,-93,133,27,55,83,111,30,17,10,13,64,37,18,27,92,54,29,38,125,73,38,52,"{'F': 16, 'P': 11}","{'C': 22, 'J': 16, 'Z': 16}","{'Q': 25, 'R': 17, 'S': 8, 'T': 8, 'H': 17, 'M': 8}","{'Y': 8, 'A': 8, 'B': 4, 'D': 4, 'E': 4, 'G': 8, 'I': 4, 'K': 8, 'L': 4, 'N': 4, 'O': 4, 'U': 8, 'V': 4, 'W': 4, 'X': 4}"
INV-ZZ-6755786,SCH-ZZ-3838342,ZZ,ZZ20240503HYDCCU3772.0,3772.0,Boeing 767,05/03/2024,2024-05-03 05:58:00,2024-05-04 03:23:00,HYD,CCU,278.0,320,174,-104,146,27,55,83,111,31,17,10,14,65,35,20,30,99,54,29,45,127,69,42,58,"{'F': 16, 'P': 11}","{'C': 22, 'J': 16, 'Z': 16}","{'Q': 25, 'R': 17, 'S': 8, 'T': 8, 'H': 17, 'M': 8}","{'Y': 8, 'A': 8, 'B': 4, 'D': 4, 'E': 4, 'G': 8, 'I': 4, 'K': 8, 'L': 4, 'N': 4, 'O': 4, 'U': 8, 'V': 4, 'W': 4, 'X': 4}"
INV-ZZ-7831318,SCH-ZZ-3838342,ZZ,ZZ20240504HYDCCU3772.0,3772.0,Boeing 767,05/04/2024,2024-05-04 05:58:00,2024-05-05 03:23:00,HYD,CCU,278.0,306,177,-101,129,27,55,83,111,32,18,9,14,62,36,19,26,95,55,28,40,126,73,38,53,"{'F': 16, 'P': 11}","{'C': 22, 'J': 16, 'Z': 16}","{'Q': 25, 'R': 17, 'S': 8, 'T': 8, 'H': 17, 'M': 8}","{'Y': 8, 'A': 8, 'B': 4, 'D': 4, 'E': 4, 'G': 8, 'I': 4, 'K': 8, 'L': 4, 'N': 4, 'O': 4, 'U': 8, 'V': 4, 'W': 4, 'X': 4}"
INV-ZZ-1066808,SCH-ZZ-3838342,ZZ,ZZ20240505HYDCCU3772.0,3772.0,Boeing 767,05/05/2024,2024-05-05 05:58:00,2024-05-06 03:23:00,HYD,CCU,278.0,316,185,-93,131,27,55,83,111,32,19,8,13,65,38,17,27,98,57,26,41,129,76,35,53,"{'F': 16, 'P': 11}","{'C': 22, 'J': 16, 'Z': 16}","{'Q': 25, 'R': 17, 'S': 8, 'T': 8, 'H': 17, 'M': 8}","{'Y': 8, 'A': 8, 'B': 4, 'D': 4, 'E': 4, 'G': 8, 'I': 4, 'K': 8, 'L': 4, 'N': 4, 'O': 4, 'U': 8, 'V': 4, 'W': 4, 'X': 4}"
INV-ZZ-6939573,SCH-ZZ-3838342,ZZ,ZZ20240507HYDCCU3772.0,3772.0,Boeing 767,05/07/2024,2024-05-07 05:58:00,2024-05-08 03:23:00,HYD,CCU,278.0,310,161,-117,149,27,55,83,111,31,16,11,15,62,32,23,30,96,50,33,46,128,66,45,62,"{'F': 16, 'P': 11}","{'C': 22, 'J': 16, 'Z': 16}","{'Q': 25, 'R': 17, 'S': 8, 'T': 8, 'H': 17, 'M': 8}","{'Y': 8, 'A': 8, 'B': 4, 'D': 4, 'E': 4, 'G': 8, 'I': 4, 'K': 8, 'L': 4, 'N': 4, 'O': 4, 'U': 8, 'V': 4, 'W': 4, 'X': 4}"
INV-ZZ-5317709,SCH-ZZ-3838342,ZZ,ZZ20240510HYDCCU3772.0,3772.0,Boeing 767,05/10/2024,2024-05-10 05:58:00,2024-05-11 03:23:00,HYD,CCU,278.0,322,173,-105,149,27,55,83,111,32,17,10,15,66,35,20,31,96,51,32,45,125,67,44,58,"{'F': 16, 'P': 11}","{'C': 22, 'J': 16, 'Z': 16}","{'Q': 25, 'R': 17, 'S': 8, 'T': 8, 'H': 17, 'M': 8}","{'Y': 8, 'A': 8, 'B': 4, 'D': 4, 'E': 4, 'G': 8, 'I': 4, 'K': 8, 'L': 4, 'N': 4, 'O': 4, 'U': 8, 'V': 4, 'W': 4, 'X': 4}"
INV-ZZ-2180066,SCH-ZZ-3838342,ZZ,ZZ20240511HYDCCU3772.0,3772.0,Boeing 767,05/11/2024,2024-05-11 05:58:00,2024-05-12 03:23:00,HYD,CCU,278.0,309,164,-114,145,27,55,83,111,30,16,11,14,63,34,21,29,99,53,30,46,124,66,45,58,"{'F': 16, 'P': 11}","{'C': 22, 'J': 16, 'Z': 16}","{'Q': 25, 'R': 17, 'S': 8, 'T': 8, 'H': 17, 'M': 8}","{'Y': 8, 'A': 8, 'B': 4, 'D': 4, 'E': 4, 'G': 8, 'I': 4, 'K': 8, 'L': 4, 'N': 4, 'O': 4, 'U': 8, 'V': 4, 'W': 4, 'X': 4}"
INV-ZZ-7884463,SCH-ZZ-3838342,ZZ,ZZ20240512HYDCCU3772.0,3772.0,Boeing 767,05/12/2024,2024-05-12 05:58:00,2024-05-13 03:23:00,HYD,CCU,278.0,307,164,-114,143,27,55,83,111,30,16,11,14,62,33,22,29,92,49,34,43,128,68,43,60,"{'F': 16, 'P': 11}","{'C': 22, 'J': 16, 'Z': 16}","{'Q': 25, 'R': 17, 'S': 8, 'T': 8, 'H': 17, 'M': 8}","{'Y': 8, 'A': 8, 'B': 4, 'D': 4, 'E': 4, 'G': 8, 'I': 4, 'K': 8, 'L': 4, 'N': 4, 'O': 4, 'U': 8, 'V': 4, 'W': 4, 'X': 4}"
INV-ZZ-1811088,SCH-ZZ-3838342,ZZ,ZZ20240514HYDCCU3772.0,3772.0,Boeing 767,05/14/2024,2024-05-14 05:58:00,2024-05-15 03:23:00,HYD,CCU,278.0,319,180,-98,139,27,55,83,111,31,17,10,14,62,35,20,27,99,56,27,43,131,74,37,57,"{'F': 16, 'P': 11}","{'C': 22, 'J': 16, 'Z': 16}","{'Q': 25, 'R': 17, 'S': 8, 'T': 8, 'H': 17, 'M': 8}","{'Y': 8, 'A': 8, 'B': 4, 'D': 4, 'E': 4, 'G': 8, 'I': 4, 'K': 8, 'L': 4, 'N': 4, 'O': 4, 'U': 8, 'V': 4, 'W': 4, 'X': 4}"
INV-ZZ-5199975,SCH-ZZ-3838342,ZZ,ZZ20240517HYDCCU3772.0,3772.0,Boeing 767,05/17/2024,2024-05-17 05:58:00,2024-05-18 03:23:00,HYD,CCU,278.0,317,154,-124,163,27,55,83,111,32,16,11,16,63,31,24,32,92,45,38,47,125,61,50,64,"{'F': 16, 'P': 11}","{'C': 22, 'J': 16, 'Z': 16}","{'Q': 25, 'R': 17, 'S': 8, 'T': 8, 'H': 17, 'M': 8}","{'Y': 8, 'A': 8, 'B': 4, 'D': 4, 'E': 4, 'G': 8, 'I': 4, 'K': 8, 'L': 4, 'N': 4, 'O': 4, 'U': 8, 'V': 4, 'W': 4, 'X': 4}"
INV-ZZ-7462612,SCH-ZZ-3838342,ZZ,ZZ20240518HYDCCU3772.0,3772.0,Boeing 767,05/18/2024,2024-05-18 05:58:00,2024-05-19 03:23:00,HYD,CCU,278.0,326,161,-117,165,27,55,83,111,32,16,11,16,64,32,23,32,94,46,37,48,127,63,48,64,"{'F': 16, 'P': 11}","{'C': 22, 'J': 16, 'Z': 16}","{'Q': 25, 'R': 17, 'S': 8, 'T': 8, 'H': 17, 'M': 8}","{'Y': 8, 'A': 8, 'B': 4, 'D': 4, 'E': 4, 'G': 8, 'I': 4, 'K': 8, 'L': 4, 'N': 4, 'O': 4, 'U': 8, 'V': 4, 'W': 4, 'X': 4}"
INV-ZZ-3041625,SCH-ZZ-3838342,ZZ,ZZ20240519HYDCCU3772.0,3772.0,Boeing 767,05/19/2024,2024-05-19 05:58:00,2024-05-20 03:23:00,HYD,CCU,278.0,318,161,-117,157,27,55,83,111,30,15,12,15,61,31,24,30,93,47,36,46,126,64,47,62,"{'F': 16, 'P': 11}","{'C': 22, 'J': 16, 'Z': 16}","{'Q': 25, 'R': 17, 'S': 8, 'T': 8, 'H': 17, 'M': 8}","{'Y': 8, 'A': 8, 'B': 4, 'D': 4, 'E': 4, 'G': 8, 'I': 4, 'K': 8, 'L': 4, 'N': 4, 'O': 4, 'U': 8, 'V': 4, 'W': 4, 'X': 4}"
INV-ZZ-3577191,SCH-ZZ-3838342,ZZ,ZZ20240521HYDCCU3772.0,3772.0,Boeing 767,05/21/2024,2024-05-21 05:58:00,2024-05-22 03:23:00,HYD,CCU,278.0,307,144,-134,163,27,55,83,111,31,15,12,16,64,30,25,34,93,44,39,49,126,59,52,67,"{'F': 16, 'P': 11}","{'C': 22, 'J': 16, 'Z': 16}","{'Q': 25, 'R': 17, 'S': 8, 'T': 8, 'H': 17, 'M': 8}","{'Y': 8, 'A': 8, 'B': 4, 'D': 4, 'E': 4, 'G': 8, 'I': 4, 'K': 8, 'L': 4, 'N': 4, 'O': 4, 'U': 8, 'V': 4, 'W': 4, 'X': 4}"
INV-ZZ-4014107,SCH-ZZ-3838342,ZZ,ZZ20240524HYDCCU3772.0,3772.0,Boeing 767,05/24/2024,2024-05-24 05:58:00,2024-05-25 03:23:00,HYD,CCU,278.0,328,172,-106,156,27,55,83,111,32,17,10,15,66,35,20,31,99,52,31,47,127,67,44,60,"{'F': 16, 'P': 11}","{'C': 22, 'J': 16, 'Z': 16}","{'Q': 25, 'R': 17, 'S': 8, 'T': 8, 'H': 17, 'M': 8}","{'Y': 8, 'A': 8, 'B': 4, 'D': 4, 'E': 4, 'G': 8, 'I': 4, 'K': 8, 'L': 4, 'N': 4, 'O': 4, 'U': 8, 'V': 4, 'W': 4, 'X': 4}"
INV-ZZ-8424367,SCH-ZZ-3838342,ZZ,ZZ20240525HYDCCU3772.0,3772.0,Boeing 767,05/25/2024,2024-05-25 05:58:00,2024-05-26 03:23:00,HYD,CCU,278.0,306,148,-130,158,27,55,83,111,30,15,12,15,64,31,24,33,97,47,36,50,130,63,48,67,"{'F': 16, 'P': 11}","{'C': 22, 'J': 16, 'Z': 16}","{'Q': 25, 'R': 17, 'S': 8, 'T': 8, 'H': 17, 'M': 8}","{'Y': 8, 'A': 8, 'B': 4, 'D': 4, 'E': 4, 'G': 8, 'I': 4, 'K': 8, 'L': 4, 'N': 4, 'O': 4, 'U': 8, 'V': 4, 'W': 4, 'X': 4}"
INV-ZZ-7025490,SCH-ZZ-3838342,ZZ,ZZ20240526HYDCCU3772.0,3772.0,Boeing 767,05/26/2024,2024-05-26 05:58:00,2024-05-27 03:23:00,HYD,CCU,278.0,314,145,-133,169,27,55,83,111,31,14,13,17,64,30,25,34,95,44,39,51,133,62,49,71,"{'F': 16, 'P': 11}","{'C': 22, 'J': 16, 'Z': 16}","{'Q': 25, 'R': 17, 'S': 8, 'T': 8, 'H': 17, 'M': 8}","{'Y': 8, 'A': 8, 'B': 4, 'D': 4, 'E': 4, 'G': 8, 'I': 4, 'K': 8, 'L': 4, 'N': 4, 'O': 4, 'U': 8, 'V': 4, 'W': 4, 'X': 4}"
INV-ZZ-1206499,SCH-ZZ-3838342,ZZ,ZZ20240528HYDCCU3772.0,3772.0,Boeing 767,05/28/2024,2024-05-28 05:58:00,2024-05-29 03:23:00,HYD,CCU,278.0,329,159,-119,170,27,55,83,111,32,15,12,17,63,30,25,33,99,48,35,51,125,60,51,65,"{'F': 16, 'P': 11}","{'C': 22, 'J': 16, 'Z': 16}","{'Q': 25, 'R': 17, 'S': 8, 'T': 8, 'H': 17, 'M': 8}","{'Y': 8, 'A': 8, 'B': 4, 'D': 4, 'E': 4, 'G': 8, 'I': 4, 'K': 8, 'L': 4, 'N': 4, 'O': 4, 'U': 8, 'V': 4, 'W': 4, 'X': 4}"
INV-ZZ-9541266,SCH-ZZ-7588562,ZZ,ZZ20240417AMDDEL3688.0,3688.0,Airbus A321-200,04/17/2024,2024-04-17 10:53:00,2024-04-17 19:22:00,AMD,DEL,200.0,233,127,-73,106,20,40,60,80,23,13,7,10,46,25,15,21,69,38,22,31,95,52,28,43,"{'F': 12, 'P': 8}","{'C': 16, 'J': 12, 'Z': 12}","{'Q': 18, 'R': 12, 'S': 6, 'T': 6, 'H': 12, 'M': 6}","{'Y': 6, 'A': 6, 'B': 3, 'D': 3, 'E': 3, 'G': 6, 'I': 3, 'K': 6, 'L': 3, 'N': 3, 'O': 3, 'U': 6, 'V': 3, 'W': 3, 'X': 3}"
INV-ZZ-6031249,SCH-ZZ-7588562,ZZ,ZZ20240421AMDDEL3688.0,3688.0,Airbus A321-200,04/21/2024,2024-04-21 10:53:00,2024-04-21 19:22:00,AMD,DEL,200.0,225,134,-66,91,20,40,60,80,23,14,6,9,47,28,12,19,69,41,19,28,93,55,25,38,"{'F': 12, 'P': 8}","{'C': 16, 'J': 12, 'Z': 12}","{'Q': 18, 'R': 12, 'S': 6, 'T': 6, 'H': 12, 'M': 6}","{'Y': 6, 'A': 6, 'B': 3, 'D': 3, 'E': 3, 'G': 6, 'I': 3, 'K': 6, 'L': 3, 'N': 3, 'O': 3, 'U': 6, 'V': 3, 'W': 3, 'X': 3}"
INV-ZZ-5093981,SCH-ZZ-7588562,ZZ,ZZ20240424AMDDEL3688.0,3688.0,Airbus A321-200,04/24/2024,2024-04-24 10:53:00,2024-04-24 19:22:00,AMD,DEL,200.0,236,140,-60,96,20,40,60,80,23,14,6,9,47,28,12,19,69,41,19,28,89,53,27,36,"{'F': 12, 'P': 8}","{'C': 16, 'J': 12, 'Z': 12}","{'Q': 18, 'R': 12, 'S': 6, 'T': 6, 'H': 12, 'M': 6}","{'Y': 6, 'A': 6, 'B': 3, 'D': 3, 'E': 3, 'G': 6, 'I': 3, 'K': 6, 'L': 3, 'N': 3, 'O': 3, 'U': 6, 'V': 3, 'W': 3, 'X': 3}"
INV-ZZ-5692705,SCH-ZZ-7588562,ZZ,ZZ20240428AMDDEL3688.0,3688.0,Airbus A321-200,04/28/2024,2024-04-28 10:53:00,2024-04-28 19:22:00,AMD,DEL,200.0,236,137,-63,99,20,40,60,80,23,13,7,10,47,27,13,20,69,40,20,29,93,54,26,39,"{'F': 12, 'P': 8}","{'C': 16, 'J': 12, 'Z': 12}","{'Q': 18, 'R': 12, 'S': 6, 'T': 6, 'H': 12, 'M': 6}","{'Y': 6, 'A': 6, 'B': 3, 'D': 3, 'E': 3, 'G': 6, 'I': 3, 'K': 6, 'L': 3, 'N': 3, 'O': 3, 'U': 6, 'V': 3, 'W': 3, 'X': 3}"
INV-ZZ-7872647,SCH-ZZ-7588562,ZZ,ZZ20240501AMDDEL3688.0,3688.0,Airbus A321-200,05/01/2024,2024-05-01 10:53:00,2024-05-01 19:22:00,AMD,DEL,200.0,232,120,-80,112,20,40,60,80,24,12,8,12,46,24,16,22,72,37,23,35,92,48,32,44,"{'F': 12, 'P': 8}","{'C': 16, 'J': 12, 'Z': 12}","{'Q': 18, 'R': 12, 'S': 6, 'T': 6, 'H': 12, 'M': 6}","{'Y': 6, 'A': 6, 'B': 3, 'D': 3, 'E': 3, 'G': 6, 'I': 3, 'K': 6, 'L': 3, 'N': 3, 'O': 3, 'U': 6, 'V': 3, 'W': 3, 'X': 3}"
INV-ZZ-4724030,SCH-ZZ-7588562,ZZ,ZZ20240505AMDDEL3688.0,3688.0,Airbus A321-200,05/05/2024,2024-05-05 10:53:00,2024-05-05 19:22:00,AMD,DEL,200.0,220,117,-83,103,20,40,60,80,23,12,8,11,47,25,15,22,68,36,24,32,91,48,32,43,"{'F': 12, 'P': 8}","{'C': 16, 'J': 12, 'Z': 12}","{'Q': 18, 'R': 12, 'S': 6, 'T': 6, 'H': 12, 'M': 6}","{'Y': 6, 'A': 6, 'B': 3, 'D': 3, 'E': 3, 'G': 6, 'I': 3, 'K': 6, 'L': 3, 'N': 3, 'O': 3, 'U': 6, 'V': 3, 'W': 3, 'X': 3}"
INV-ZZ-8181245,SCH-ZZ-7588562,ZZ,ZZ20240508AMDDEL3688.0,3688.0,Airbus A321-200,05/08/2024,2024-05-08 10:53:00,2024-05-08 19:22:00,AMD,DEL,200.0,226,120,-80,106,20,40,60,80,23,12,8,11,46,24,16,22,71,38,22,33,90,48,32,42,"{'F': 12, 'P': 8}","{'C': 16, 'J': 12, 'Z': 12}","{'Q': 18, 'R': 12, 'S': 6, 'T': 6, 'H': 12, 'M': 6}","{'Y': 6, 'A': 6, 'B': 3, 'D': 3, 'E': 3, 'G': 6, 'I': 3, 'K': 6, 'L': 3, 'N': 3, 'O': 3, 'U': 6, 'V': 3, 'W': 3, 'X': 3}"
INV-ZZ-9319708,SCH-ZZ-7588562,ZZ,ZZ20240512AMDDEL3688.0,3688.0,Airbus A321-200,05/12/2024,2024-05-12 10:53:00,2024-05-12 19:22:00,AMD,DEL,200.0,225,113,-87,112,20,40,60,80,23,12,8,11,45,23,17,22,69,35,25,34,94,47,33,47,"{'F': 12, 'P': 8}","{'C': 16, 'J': 12, 'Z': 12}","{'Q': 18, 'R': 12, 'S': 6, 'T': 6, 'H': 12, 'M': 6}","{'Y': 6, 'A': 6, 'B': 3, 'D': 3, 'E': 3, 'G': 6, 'I': 3, 'K': 6, 'L': 3, 'N': 3, 'O': 3, 'U': 6, 'V': 3, 'W': 3, 'X': 3}"
INV-ZZ-7485494,SCH-ZZ-7588562,ZZ,ZZ20240515AMDDEL3688.0,3688.0,Airbus A321-200,05/15/2024,2024-05-15 10:53:00,2024-05-15 19:22:00,AMD,DEL,200.0,238,120,-80,118,20,40,60,80,23,12,8,11,45,23,17,22,72,36,24,36,95,48,32,47,"{'F': 12, 'P': 8}","{'C': 16, 'J': 12, 'Z': 12}","{'Q': 18, 'R': 12, 'S': 6, 'T': 6, 'H': 12, 'M': 6}","{'Y': 6, 'A': 6, 'B': 3, 'D': 3, 'E': 3, 'G': 6, 'I': 3, 'K': 6, 'L': 3, 'N': 3, 'O': 3, 'U': 6, 'V': 3, 'W': 3, 'X': 3}"
INV-ZZ-9335465,SCH-ZZ-7588562,ZZ,ZZ20240519AMDDEL3688.0,3688.0,Airbus A321-200,05/19/2024,2024-05-19 10:53:00,2024-05-19 19:22:00,AMD,DEL,200.0,238,131,-69,107,20,40,60,80,24,13,7,11,47,26,14,21,67,37,23,30,90,50,30,40,"{'F': 12, 'P': 8}","{'C': 16, 'J': 12, 'Z': 12}","{'Q': 18, 'R': 12, 'S': 6, 'T': 6, 'H': 12, 'M': 6}","{'Y': 6, 'A': 6, 'B': 3, 'D': 3, 'E': 3, 'G': 6, 'I': 3, 'K': 6, 'L': 3, 'N': 3, 'O': 3, 'U': 6, 'V': 3, 'W': 3, 'X': 3}"
INV-ZZ-5795696,SCH-ZZ-7588562,ZZ,ZZ20240522AMDDEL3688.0,3688.0,Airbus A321-200,05/22/2024,2024-05-22 10:53:00,2024-05-22 19:22:00,AMD,DEL,200.0,236,119,-81,117,20,40,60,80,22,11,9,11,46,23,17,23,67,34,26,33,90,45,35,45,"{'F': 12, 'P': 8}","{'C': 16, 'J': 12, 'Z': 12}","{'Q': 18, 'R': 12, 'S': 6, 'T': 6, 'H': 12, 'M': 6}","{'Y': 6, 'A': 6, 'B': 3, 'D': 3, 'E': 3, 'G': 6, 'I': 3, 'K': 6, 'L': 3, 'N': 3, 'O': 3, 'U': 6, 'V': 3, 'W': 3, 'X': 3}"
INV-ZZ-1537657,SCH-ZZ-7588562,ZZ,ZZ20240526AMDDEL3688.0,3688.0,Airbus A321-200,05/26/2024,2024-05-26 10:53:00,2024-05-26 19:22:00,AMD,DEL,200.0,234,108,-92,126,20,40,60,80,23,11,9,12,47,22,18,25,71,33,27,38,95,44,36,51,"{'F': 12, 'P': 8}","{'C': 16, 'J': 12, 'Z': 12}","{'Q': 18, 'R': 12, 'S': 6, 'T': 6, 'H': 12, 'M': 6}","{'Y': 6, 'A': 6, 'B': 3, 'D': 3, 'E': 3, 'G': 6, 'I': 3, 'K': 6, 'L': 3, 'N': 3, 'O': 3, 'U': 6, 'V': 3, 'W': 3, 'X': 3}"
INV-ZZ-4220446,SCH-ZZ-7588562,ZZ,ZZ20240529AMDDEL3688.0,3688.0,Airbus A321-200,05/29/2024,2024-05-29 10:53:00,2024-05-29 19:22:00,AMD,DEL,200.0,228,114,-86,114,20,40,60,80,22,11,9,11,48,24,16,24,71,35,25,36,94,47,33,47,"{'F': 12, 'P': 8}","{'C': 16, 'J': 12, 'Z': 12}","{'Q': 18, 'R': 12, 'S': 6, 'T': 6, 'H': 12, 'M': 6}","{'Y': 6, 'A': 6, 'B': 3, 'D': 3, 'E': 3, 'G': 6, 'I': 3, 'K': 6, 'L': 3, 'N': 3, 'O': 3, 'U': 6, 'V': 3, 'W': 3, 'X': 3}"
INV-ZZ-2343016,SCH-ZZ-4321829,ZZ,ZZ20240518HYDDEL2297.0,2297.0,Boeing 767,05/18/2024,2024-05-18 03:40:00,2024-05-18 06:55:00,HYD,DEL,278.0,308,147,-131,161,27,55,83,111,31,15,12,16,64,31,24,33,92,44,39,48,127,61,50,66,"{'F': 16, 'P': 11}","{'C': 22, 'J': 16, 'Z': 16}","{'Q': 25, 'R': 17, 'S': 8, 'T': 8, 'H': 17, 'M': 8}","{'Y': 8, 'A': 8, 'B': 4, 'D': 4, 'E': 4, 'G': 8, 'I': 4, 'K': 8, 'L': 4, 'N': 4, 'O': 4, 'U': 8, 'V': 4, 'W': 4, 'X': 4}"
INV-ZZ-2127582,SCH-ZZ-4321829,ZZ,ZZ20240519HYDDEL2297.0,2297.0,Boeing 767,05/19/2024,2024-05-19 03:40:00,2024-05-19 06:55:00,HYD,DEL,278.0,314,172,-106,142,27,55,83,111,31,17,10,14,64,35,20,29,98,54,29,44,126,69,42,57,"{'F': 16, 'P': 11}","{'C': 22, 'J': 16, 'Z': 16}","{'Q': 25, 'R': 17, 'S': 8, 'T': 8, 'H': 17, 'M': 8}","{'Y': 8, 'A': 8, 'B': 4, 'D': 4, 'E': 4, 'G': 8, 'I': 4, 'K': 8, 'L': 4, 'N': 4, 'O': 4, 'U': 8, 'V': 4, 'W': 4, 'X': 4}"
INV-ZZ-1226738,SCH-ZZ-4321829,ZZ,ZZ20240521HYDDEL2297.0,2297.0,Boeing 767,05/21/2024,2024-05-21 03:40:00,2024-05-21 06:55:00,HYD,DEL,278.0,309,145,-133,164,27,55,83,111,30,14,13,16,61,29,26,32,93,44,39,49,123,58,53,65,"{'F': 16, 'P': 11}","{'C': 22, 'J': 16, 'Z': 16}","{'Q': 25, 'R': 17, 'S': 8, 'T': 8, 'H': 17, 'M': 8}","{'Y': 8, 'A': 8, 'B': 4, 'D': 4, 'E': 4, 'G': 8, 'I': 4, 'K': 8, 'L': 4, 'N': 4, 'O': 4, 'U': 8, 'V': 4, 'W': 4, 'X': 4}"
INV-ZZ-1668512,SCH-ZZ-4321829,ZZ,ZZ20240522HYDDEL2297.0,2297.0,Boeing 767,05/22/2024,2024-05-22 03:40:00,2024-05-22 06:55:00,HYD,DEL,278.0,325,169,-109,156,27,55,83,111,30,16,11,14,62,32,23,30,94,49,34,45,129,67,44,62,"{'F': 16, 'P': 11}","{'C': 22, 'J': 16, 'Z': 16}","{'Q': 25, 'R': 17, 'S': 8, 'T': 8, 'H': 17, 'M': 8}","{'Y': 8, 'A': 8, 'B': 4, 'D': 4, 'E': 4, 'G': 8, 'I': 4, 'K': 8, 'L': 4, 'N': 4, 'O': 4, 'U': 8, 'V': 4, 'W': 4, 'X': 4}"
INV-ZZ-9591848,SCH-ZZ-4321829,ZZ,ZZ20240525HYDDEL2297.0,2297.0,Boeing 767,05/25/2024,2024-05-25 03:40:00,2024-05-25 06:55:00,HYD,DEL,278.0,333,159,-119,174,27,55,83,111,31,15,12,16,64,31,24,33,94,45,38,49,124,59,52,65,"{'F': 16, 'P': 11}","{'C': 22, 'J': 16, 'Z': 16}","{'Q': 25, 'R': 17, 'S': 8, 'T': 8, 'H': 17, 'M': 8}","{'Y': 8, 'A': 8, 'B': 4, 'D': 4, 'E': 4, 'G': 8, 'I': 4, 'K': 8, 'L': 4, 'N': 4, 'O': 4, 'U': 8, 'V': 4, 'W': 4, 'X': 4}"
INV-ZZ-7974979,SCH-ZZ-4321829,ZZ,ZZ20240526HYDDEL2297.0,2297.0,Boeing 767,05/26/2024,2024-05-26 03:40:00,2024-05-26 06:55:00,HYD,DEL,278.0,330,173,-105,157,27,55,83,111,30,16,11,14,65,34,21,31,97,51,32,46,131,69,42,62,"{'F': 16, 'P': 11}","{'C': 22, 'J': 16, 'Z': 16}","{'Q': 25, 'R': 17, 'S': 8, 'T': 8, 'H': 17, 'M': 8}","{'Y': 8, 'A': 8, 'B': 4, 'D': 4, 'E': 4, 'G': 8, 'I': 4, 'K': 8, 'L': 4, 'N': 4, 'O': 4, 'U': 8, 'V': 4, 'W': 4, 'X': 4}"
INV-ZZ-5843537,SCH-ZZ-4321829,ZZ,ZZ20240528HYDDEL2297.0,2297.0,Boeing 767,05/28/2024,2024-05-28 03:40:00,2024-05-28 06:55:00,HYD,DEL,278.0,323,146,-132,177,27,55,83,111,30,14,13,16,63,29,26,34,97,44,39,53,126,57,54,69,"{'F': 16, 'P': 11}","{'C': 22, 'J': 16, 'Z': 16}","{'Q': 25, 'R': 17, 'S': 8, 'T': 8, 'H': 17, 'M': 8}","{'Y': 8, 'A': 8, 'B': 4, 'D': 4, 'E': 4, 'G': 8, 'I': 4, 'K': 8, 'L': 4, 'N': 4, 'O': 4, 'U': 8, 'V': 4, 'W': 4, 'X': 4}"
INV-ZZ-9164641,SCH-ZZ-4321829,ZZ,ZZ20240529HYDDEL2297.0,2297.0,Boeing 767,05/29/2024,2024-05-29 03:40:00,2024-05-29 06:55:00,HYD,DEL,278.0,307,152,-126,155,27,55,83,111,31,15,12,16,62,31,24,31,96,48,35,48,128,63,48,65,"{'F': 16, 'P': 11}","{'C': 22, 'J': 16, 'Z': 16}","{'Q': 25, 'R': 17, 'S': 8, 'T': 8, 'H': 17, 'M': 8}","{'Y': 8, 'A': 8, 'B': 4, 'D': 4, 'E': 4, 'G': 8, 'I': 4, 'K': 8, 'L': 4, 'N': 4, 'O': 4, 'U': 8, 'V': 4, 'W': 4, 'X': 4}"
INV-ZZ-3591392,SCH-ZZ-4321829,ZZ,ZZ20240601HYDDEL2297.0,2297.0,Boeing 767,06/01/2024,2024-06-01 03:40:00,2024-06-01 06:55:00,HYD,DEL,278.0,318,149,-129,169,27,55,83,111,31,15,12,16,64,30,25,34,97,46,37,51,132,62,49,70,"{'F': 16, 'P': 11}","{'C': 22, 'J': 16, 'Z': 16}","{'Q': 25, 'R': 17, 'S': 8, 'T': 8, 'H': 17, 'M': 8}","{'Y': 8, 'A': 8, 'B': 4, 'D': 4, 'E': 4, 'G': 8, 'I': 4, 'K': 8, 'L': 4, 'N': 4, 'O': 4, 'U': 8, 'V': 4, 'W': 4, 'X': 4}"
INV-ZZ-4167842,SCH-ZZ-4321829,ZZ,ZZ20240602HYDDEL2297.0,2297.0,Boeing 767,06/02/2024,2024-06-02 03:40:00,2024-06-02 06:55:00,HYD,DEL,278.0,322,166,-112,156,27,55,83,111,31,16,11,15,64,33,22,31,91,47,36,44,122,63,48,59,"{'F': 16, 'P': 11}","{'C': 22, 'J': 16, 'Z': 16}","{'Q': 25, 'R': 17, 'S': 8, 'T': 8, 'H': 17, 'M': 8}","{'Y': 8, 'A': 8, 'B': 4, 'D': 4, 'E': 4, 'G': 8, 'I': 4, 'K': 8, 'L': 4, 'N': 4, 'O': 4, 'U': 8, 'V': 4, 'W': 4, 'X': 4}"
INV-ZZ-2076026,SCH-ZZ-4321829,ZZ,ZZ20240604HYDDEL2297.0,2297.0,Boeing 767,06/04/2024,2024-06-04 03:40:00,2024-06-04 06:55:00,HYD,DEL,278.0,332,154,-124,178,27,55,83,111,32,15,12,17,61,28,27,33,96,45,38,51,127,59,52,68,"{'F': 16, 'P': 11}","{'C': 22, 'J': 16, 'Z': 16}","{'Q': 25, 'R': 17, 'S': 8, 'T': 8, 'H': 17, 'M': 8}","{'Y': 8, 'A': 8, 'B': 4, 'D': 4, 'E': 4, 'G': 8, 'I': 4, 'K': 8, 'L': 4, 'N': 4, 'O': 4, 'U': 8, 'V': 4, 'W': 4, 'X': 4}"
INV-ZZ-1432528,SCH-ZZ-4321829,ZZ,ZZ20240605HYDDEL2297.0,2297.0,Boeing 767,06/05/2024,2024-06-05 03:40:00,2024-06-05 06:55:00,HYD,DEL,278.0,321,161,-117,160,27,55,83,111,31,16,11,15,63,32,23,31,98,49,34,49,130,65,46,65,"{'F': 16, 'P': 11}","{'C': 22, 'J': 16, 'Z': 16}","{'Q': 25, 'R': 17, 'S': 8, 'T': 8, 'H': 17, 'M': 8}","{'Y': 8, 'A': 8, 'B': 4, 'D': 4, 'E': 4, 'G': 8, 'I': 4, 'K': 8, 'L': 4, 'N': 4, 'O': 4, 'U': 8, 'V': 4, 'W': 4, 'X': 4}"
INV-ZZ-5645598,SCH-ZZ-4321829,ZZ,ZZ20240608HYDDEL2297.0,2297.0,Boeing 767,06/08/2024,2024-06-08 03:40:00,2024-06-08 06:55:00,HYD,DEL,278.0,326,142,-136,184,27,55,83,111,32,14,13,18,62,27,28,35,94,41,42,53,124,54,57,70,"{'F': 16, 'P': 11}","{'C': 22, 'J': 16, 'Z': 16}","{'Q': 25, 'R': 17, 'S': 8, 'T': 8, 'H': 17, 'M': 8}","{'Y': 8, 'A': 8, 'B': 4, 'D': 4, 'E': 4, 'G': 8, 'I': 4, 'K': 8, 'L': 4, 'N': 4, 'O': 4, 'U': 8, 'V': 4, 'W': 4, 'X': 4}"
INV-ZZ-7471951,SCH-ZZ-4321829,ZZ,ZZ20240609HYDDEL2297.0,2297.0,Boeing 767,06/09/2024,2024-06-09 03:40:00,2024-06-09 06:55:00,HYD,DEL,278.0,321,137,-141,184,27,55,83,111,30,13,14,17,64,27,28,37,96,41,42,55,128,54,57,74,"{'F': 16, 'P': 11}","{'C': 22, 'J': 16, 'Z': 16}","{'Q': 25, 'R': 17, 'S': 8, 'T': 8, 'H': 17, 'M': 8}","{'Y': 8, 'A': 8, 'B': 4, 'D': 4, 'E': 4, 'G': 8, 'I': 4, 'K': 8, 'L': 4, 'N': 4, 'O': 4, 'U': 8, 'V': 4, 'W': 4, 'X': 4}"
INV-ZZ-6248212,SCH-ZZ-4321829,ZZ,ZZ20240611HYDDEL2297.0,2297.0,Boeing 767,06/11/2024,2024-06-11 03:40:00,2024-06-11 06:55:00,HYD,DEL,278.0,320,148,-130,172,27,55,83,111,32,15,12,17,64,30,25,34,95,44,39,51,130,60,51,70,"{'F': 16, 'P': 11}","{'C': 22, 'J': 16, 'Z': 16}","{'Q': 25, 'R': 17, 'S': 8, 'T': 8, 'H': 17, 'M': 8}","{'Y': 8, 'A': 8, 'B': 4, 'D': 4, 'E': 4, 'G': 8, 'I': 4, 'K': 8, 'L': 4, 'N': 4, 'O': 4, 'U': 8, 'V': 4, 'W': 4, 'X': 4}"
INV-ZZ-2108679,SCH-ZZ-4321829,ZZ,ZZ20240612HYDDEL2297.0,2297.0,Boeing 767,06/12/2024,2024-06-12 03:40:00,2024-06-12 06:55:00,HYD,DEL,278.0,329,148,-130,181,27,55,83,111,31,14,13,17,64,29,26,35,97,44,39,53,125,56,55,69,"{'F': 16, 'P': 11}","{'C': 22, 'J': 16, 'Z': 16}","{'Q': 25, 'R': 17, 'S': 8, 'T': 8, 'H': 17, 'M': 8}","{'Y': 8, 'A': 8, 'B': 4, 'D': 4, 'E': 4, 'G': 8, 'I': 4, 'K': 8, 'L': 4, 'N': 4, 'O': 4, 'U': 8, 'V': 4, 'W': 4, 'X': 4}"
INV-ZZ-6278483,SCH-ZZ-4321829,ZZ,ZZ20240615HYDDEL2297.0,2297.0,Boeing 767,06/15/2024,2024-06-15 03:40:00,2024-06-15 06:55:00,HYD,DEL,278.0,328,149,-129,179,27,55,83,111,30,14,13,16,66,30,25,36,96,44,39,52,123,56,55,67,"{'F': 16, 'P': 11}","{'C': 22, 'J': 16, 'Z': 16}","{'Q': 25, 'R': 17, 'S': 8, 'T': 8, 'H': 17, 'M': 8}","{'Y': 8, 'A': 8, 'B': 4, 'D': 4, 'E': 4, 'G': 8, 'I': 4, 'K': 8, 'L': 4, 'N': 4, 'O': 4, 'U': 8, 'V': 4, 'W': 4, 'X': 4}"
INV-ZZ-2287706,SCH-ZZ-4321829,ZZ,ZZ20240616HYDDEL2297.0,2297.0,Boeing 767,06/16/2024,2024-06-16 03:40:00,2024-06-16 06:55:00,HYD,DEL,278.0,316,130,-148,186,27,55,83,111,30,12,15,18,64,26,29,38,96,39,44,57,131,54,57,77,"{'F': 16, 'P': 11}","{'C': 22, 'J': 16, 'Z': 16}","{'Q': 25, 'R': 17, 'S': 8, 'T': 8, 'H': 17, 'M': 8}","{'Y': 8, 'A': 8, 'B': 4, 'D': 4, 'E': 4, 'G': 8, 'I': 4, 'K': 8, 'L': 4, 'N': 4, 'O': 4, 'U': 8, 'V': 4, 'W': 4, 'X': 4}"
INV-ZZ-6084848,SCH-ZZ-4321829,ZZ,ZZ20240618HYDDEL2297.0,2297.0,Boeing 767,06/18/2024,2024-06-18 03:40:00,2024-06-18 06:55:00,HYD,DEL,278.0,320,130,-148,190,27,55,83,111,32,13,14,19,66,27,28,39,97,40,43,57,133,54,57,79,"{'F': 16, 'P': 11}","{'C': 22, 'J': 16, 'Z': 16}","{'Q': 25, 'R': 17, 'S': 8, 'T': 8, 'H': 17, 'M': 8}","{'Y': 8, 'A': 8, 'B': 4, 'D': 4, 'E': 4, 'G': 8, 'I': 4, 'K': 8, 'L': 4, 'N': 4, 'O': 4, 'U': 8, 'V': 4, 'W': 4, 'X': 4}"
INV-ZZ-3184849,SCH-ZZ-4321829,ZZ,ZZ20240619HYDDEL2297.0,2297.0,Boeing 767,06/19/2024,2024-06-19 03:40:00,2024-06-19 06:55:00,HYD,DEL,278.0,320,144,-134,176,27,55,83,111,31,14,13,17,64,29,26,35,94,42,41,52,131,59,52,72,"{'F': 16, 'P': 11}","{'C': 22, 'J': 16, 'Z': 16}","{'Q': 25, 'R': 17, 'S': 8, 'T': 8, 'H': 17, 'M': 8}","{'Y': 8, 'A': 8, 'B': 4, 'D': 4, 'E': 4, 'G': 8, 'I': 4, 'K': 8, 'L': 4, 'N': 4, 'O': 4, 'U': 8, 'V': 4, 'W': 4, 'X': 4}"
INV-ZZ-4331300,SCH-ZZ-4321829,ZZ,ZZ20240622HYDDEL2297.0,2297.0,Boeing 767,06/22/2024,2024-06-22 03:40:00,2024-06-22 06:55:00,HYD,DEL,278.0,309,124,-154,185,27,55,83,111,32,13,14,19,65,26,29,39,97,39,44,58,124,50,61,74,"{'F': 16, 'P': 11}","{'C': 22, 'J': 16, 'Z': 16}","{'Q': 25, 'R': 17, 'S': 8, 'T': 8, 'H': 17, 'M': 8}","{'Y': 8, 'A': 8, 'B': 4, 'D': 4, 'E': 4, 'G': 8, 'I': 4, 'K': 8, 'L': 4, 'N': 4, 'O': 4, 'U': 8, 'V': 4, 'W': 4, 'X': 4}"
INV-ZZ-2837320,SCH-ZZ-4321829,ZZ,ZZ20240623HYDDEL2297.0,2297.0,Boeing 767,06/23/2024,2024-06-23 03:40:00,2024-06-23 06:55:00,HYD,DEL,278.0,324,144,-134,180,27,55,83,111,30,13,14,17,64,29,26,35,98,44,39,54,130,58,53,72,"{'F': 16, 'P': 11}","{'C': 22, 'J': 16, 'Z': 16}","{'Q': 25, 'R': 17, 'S': 8, 'T': 8, 'H': 17, 'M': 8}","{'Y': 8, 'A': 8, 'B': 4, 'D': 4, 'E': 4, 'G': 8, 'I': 4, 'K': 8, 'L': 4, 'N': 4, 'O': 4, 'U': 8, 'V': 4, 'W': 4, 'X': 4}"
INV-ZZ-6239286,SCH-ZZ-4321829,ZZ,ZZ20240625HYDDEL2297.0,2297.0,Boeing 767,06/25/2024,2024-06-25 03:40:00,2024-06-25 06:55:00,HYD,DEL,278.0,333,149,-129,184,27,55,83,111,31,14,13,17,62,28,27,34,98,44,39,54,127,57,54,70,"{'F': 16, 'P': 11}","{'C': 22, 'J': 16, 'Z': 16}","{'Q': 25, 'R': 17, 'S': 8, 'T': 8, 'H': 17, 'M': 8}","{'Y': 8, 'A': 8, 'B': 4, 'D': 4, 'E': 4, 'G': 8, 'I': 4, 'K': 8, 'L': 4, 'N': 4, 'O': 4, 'U': 8, 'V': 4, 'W': 4, 'X': 4}"
INV-ZZ-4366463,SCH-ZZ-4321829,ZZ,ZZ20240626HYDDEL2297.0,2297.0,Boeing 767,06/26/2024,2024-06-26 03:40:00,2024-06-26 06:55:00,HYD,DEL,278.0,319,136,-142,183,27,55,83,111,30,13,14,17,65,28,27,37,94,40,43,54,127,54,57,73,"{'F': 16, 'P': 11}","{'C': 22, 'J': 16, 'Z': 16}","{'Q': 25, 'R': 17, 'S': 8, 'T': 8, 'H': 17, 'M': 8}","{'Y': 8, 'A': 8, 'B': 4, 'D': 4, 'E': 4, 'G': 8, 'I': 4, 'K': 8, 'L': 4, 'N': 4, 'O': 4, 'U': 8, 'V': 4, 'W': 4, 'X': 4}"
INV-ZZ-9260995,SCH-ZZ-4321829,ZZ,ZZ20240629HYDDEL2297.0,2297.0,Boeing 767,06/29/2024,2024-06-29 03:40:00,2024-06-29 06:55:00,HYD,DEL,278.0,312,126,-152,186,27,55,83,111,31,12,15,19,64,26,29,38,94,38,45,56,132,53,58,79,"{'F': 16, 'P': 11}","{'C': 22, 'J': 16, 'Z': 16}","{'Q': 25, 'R': 17, 'S': 8, 'T': 8, 'H': 17, 'M': 8}","{'Y': 8, 'A': 8, 'B': 4, 'D': 4, 'E': 4, 'G': 8, 'I': 4, 'K': 8, 'L': 4, 'N': 4, 'O': 4, 'U': 8, 'V': 4, 'W': 4, 'X': 4}"
INV-ZZ-6453751,SCH-ZZ-4321829,ZZ,ZZ20240630HYDDEL2297.0,2297.0,Boeing 767,06/30/2024,2024-06-30 03:40:00,2024-06-30 06:55:00,HYD,DEL,278.0,314,133,-145,181,27,55,83,111,31,13,14,18,64,27,28,37,95,40,43,55,130,55,56,75,"{'F': 16, 'P': 11}","{'C': 22, 'J': 16, 'Z': 16}","{'Q': 25, 'R': 17, 'S': 8, 'T': 8, 'H': 17, 'M': 8}","{'Y': 8, 'A': 8, 'B': 4, 'D': 4, 'E': 4, 'G': 8, 'I': 4, 'K': 8, 'L': 4, 'N': 4, 'O': 4, 'U': 8, 'V': 4, 'W': 4, 'X': 4}"
INV-ZZ-2109129,SCH-ZZ-8817322,ZZ,ZZ20240502BLRCCU3484.0,3484.0,Boeing 777,05/02/2024,2024-05-02 17:52:00,2024-05-03 07:39:00,BLR,CCU,425.0,489,261,-164,228,42,85,127,170,46,25,17,21,94,50,35,44,149,80,47,69,203,108,62,95,"{'F': 25, 'P': 17}","{'C': 34, 'J': 26, 'Z': 26}","{'Q': 38, 'R': 25, 'S': 13, 'T': 13, 'H': 25, 'M': 13}","{'Y': 13, 'A': 13, 'B': 6, 'D': 6, 'E': 6, 'G': 13, 'I': 6, 'K': 13, 'L': 6, 'N': 6, 'O': 6, 'U': 13, 'V': 6, 'W': 6, 'X': 6}"
INV-ZZ-1885327,SCH-ZZ-8817322,ZZ,ZZ20240508BLRCCU3484.0,3484.0,Boeing 777,05/08/2024,2024-05-08 17:52:00,2024-05-09 07:39:00,BLR,CCU,425.0,503,258,-167,245,42,85,127,170,49,25,17,24,100,51,34,49,149,76,51,73,193,99,71,94,"{'F': 25, 'P': 17}","{'C': 34, 'J': 26, 'Z': 26}","{'Q': 38, 'R': 25, 'S': 13, 'T': 13, 'H': 25, 'M': 13}","{'Y': 13, 'A': 13, 'B': 6, 'D': 6, 'E': 6, 'G': 13, 'I': 6, 'K': 13, 'L': 6, 'N': 6, 'O': 6, 'U': 13, 'V': 6, 'W': 6, 'X': 6}"
INV-ZZ-7512935,SCH-ZZ-8817322,ZZ,ZZ20240509BLRCCU3484.0,3484.0,Boeing 777,05/09/2024,2024-05-09 17:52:00,2024-05-10 07:39:00,BLR,CCU,425.0,487,245,-180,242,42,85,127,170,50,25,17,25,96,48,37,48,141,71,56,70,191,96,74,95,"{'F': 25, 'P': 17}","{'C': 34, 'J': 26, 'Z': 26}","{'Q': 38, 'R': 25, 'S': 13, 'T': 13, 'H': 25, 'M': 13}","{'Y': 13, 'A': 13, 'B': 6, 'D': 6, 'E': 6, 'G': 13, 'I': 6, 'K': 13, 'L': 6, 'N': 6, 'O': 6, 'U': 13, 'V': 6, 'W': 6, 'X': 6}"
INV-ZZ-3257109,SCH-ZZ-8817322,ZZ,ZZ20240515BLRCCU3484.0,3484.0,Boeing 777,05/15/2024,2024-05-15 17:52:00,2024-05-16 07:39:00,BLR,CCU,425.0,506,249,-176,257,42,85,127,170,49,24,18,25,100,49,36,51,140,69,58,71,202,100,70,102,"{'F': 25, 'P': 17}","{'C': 34, 'J': 26, 'Z': 26}","{'Q': 38, 'R': 25, 'S': 13, 'T': 13, 'H': 25, 'M': 13}","{'Y': 13, 'A': 13, 'B': 6, 'D': 6, 'E': 6, 'G': 13, 'I': 6, 'K': 13, 'L': 6, 'N': 6, 'O': 6, 'U': 13, 'V': 6, 'W': 6, 'X': 6}"
INV-ZZ-1311438,SCH-ZZ-8817322,ZZ,ZZ20240516BLRCCU3484.0,3484.0,Boeing 777,05/16/2024,2024-05-16 17:52:00,2024-05-17 07:39:00,BLR,CCU,425.0,470,226,-199,244,42,85,127,170,49,24,18,25,102,49,36,53,146,70,57,76,201,97,73,104,"{'F': 25, 'P': 17}","{'C': 34, 'J': 26, 'Z': 26}","{'Q': 38, 'R': 25, 'S': 13, 'T': 13, 'H': 25, 'M': 13}","{'Y': 13, 'A': 13, 'B': 6, 'D': 6, 'E': 6, 'G': 13, 'I': 6, 'K': 13, 'L': 6, 'N': 6, 'O': 6, 'U': 13, 'V': 6, 'W': 6, 'X': 6}"
INV-ZZ-1413506,SCH-ZZ-8817322,ZZ,ZZ20240522BLRCCU3484.0,3484.0,Boeing 777,05/22/2024,2024-05-22 17:52:00,2024-05-23 07:39:00,BLR,CCU,425.0,475,241,-184,234,42,85,127,170,46,23,19,23,100,51,34,49,143,73,54,70,198,100,70,98,"{'F': 25, 'P': 17}","{'C': 34, 'J': 26, 'Z': 26}","{'Q': 38, 'R': 25, 'S': 13, 'T': 13, 'H': 25, 'M': 13}","{'Y': 13, 'A': 13, 'B': 6, 'D': 6, 'E': 6, 'G': 13, 'I': 6, 'K': 13, 'L': 6, 'N': 6, 'O': 6, 'U': 13, 'V': 6, 'W': 6, 'X': 6}"
INV-ZZ-4336441,SCH-ZZ-8817322,ZZ,ZZ20240523BLRCCU3484.0,3484.0,Boeing 777,05/23/2024,2024-05-23 17:52:00,2024-05-24 07:39:00,BLR,CCU,425.0,473,252,-173,221,42,85,127,170,47,25,17,22,94,50,35,44,141,75,52,66,187,100,70,87,"{'F': 25, 'P': 17}","{'C': 34, 'J': 26, 'Z': 26}","{'Q': 38, 'R': 25, 'S': 13, 'T': 13, 'H': 25, 'M': 13}","{'Y': 13, 'A': 13, 'B': 6, 'D': 6, 'E': 6, 'G': 13, 'I': 6, 'K': 13, 'L': 6, 'N': 6, 'O': 6, 'U': 13, 'V': 6, 'W': 6, 'X': 6}"
INV-ZZ-6534302,SCH-ZZ-8817322,ZZ,ZZ20240529BLRCCU3484.0,3484.0,Boeing 777,05/29/2024,2024-05-29 17:52:00,2024-05-30 07:39:00,BLR,CCU,425.0,476,242,-183,234,42,85,127,170,47,24,18,23,99,50,35,49,149,76,51,73,204,104,66,100,"{'F': 25, 'P': 17}","{'C': 34, 'J': 26, 'Z': 26}","{'Q': 38, 'R': 25, 'S': 13, 'T': 13, 'H': 25, 'M': 13}","{'Y': 13, 'A': 13, 'B': 6, 'D': 6, 'E': 6, 'G': 13, 'I': 6, 'K': 13, 'L': 6, 'N': 6, 'O': 6, 'U': 13, 'V': 6, 'W': 6, 'X': 6}"
INV-ZZ-9664478,SCH-ZZ-8817322,ZZ,ZZ20240530BLRCCU3484.0,3484.0,Boeing 777,05/30/2024,2024-05-30 17:52:00,2024-05-31 07:39:00,BLR,CCU,425.0,489,233,-192,256,42,85,127,170,49,23,19,26,95,45,40,50,150,72,55,78,189,90,80,99,"{'F': 25, 'P': 17}","{'C': 34, 'J': 26, 'Z': 26}","{'Q': 38, 'R': 25, 'S': 13, 'T': 13, 'H': 25, 'M': 13}","{'Y': 13, 'A': 13, 'B': 6, 'D': 6, 'E': 6, 'G': 13, 'I': 6, 'K': 13, 'L': 6, 'N': 6, 'O': 6, 'U': 13, 'V': 6, 'W': 6, 'X': 6}"
INV-ZZ-4859311,SCH-ZZ-8817322,ZZ,ZZ20240605BLRCCU3484.0,3484.0,Boeing 777,06/05/2024,2024-06-05 17:52:00,2024-06-06 07:39:00,BLR,CCU,425.0,491,241,-184,250,42,85,127,170,49,24,18,25,98,48,37,50,142,70,57,72,188,92,78,96,"{'F': 25, 'P': 17}","{'C': 34, 'J': 26, 'Z': 26}","{'Q': 38, 'R': 25, 'S': 13, 'T': 13, 'H': 25, 'M': 13}","{'Y': 13, 'A': 13, 'B': 6, 'D': 6, 'E': 6, 'G': 13, 'I': 6, 'K': 13, 'L': 6, 'N': 6, 'O': 6, 'U': 13, 'V': 6, 'W': 6, 'X': 6}"
INV-ZZ-4932279,SCH-ZZ-8817322,ZZ,ZZ20240606BLRCCU3484.0,3484.0,Boeing 777,06/06/2024,2024-06-06 17:52:00,2024-06-07 07:39:00,BLR,CCU,425.0,494,246,-179,248,42,85,127,170,47,23,19,24,96,48,37,48,143,71,56,72,197,98,72,99,"{'F': 25, 'P': 17}","{'C': 34, 'J': 26, 'Z': 26}","{'Q': 38, 'R': 25, 'S': 13, 'T': 13, 'H': 25, 'M': 13}","{'Y': 13, 'A': 13, 'B': 6, 'D': 6, 'E': 6, 'G': 13, 'I': 6, 'K': 13, 'L': 6, 'N': 6, 'O': 6, 'U': 13, 'V': 6, 'W': 6, 'X': 6}"
INV-ZZ-9407722,SCH-ZZ-8817322,ZZ,ZZ20240612BLRCCU3484.0,3484.0,Boeing 777,06/12/2024,2024-06-12 17:52:00,2024-06-13 07:39:00,BLR,CCU,425.0,497,219,-206,278,42,85,127,170,46,20,22,26,96,42,43,54,140,62,65,78,199,88,82,111,"{'F': 25, 'P': 17}","{'C': 34, 'J': 26, 'Z': 26}","{'Q': 38, 'R': 25, 'S': 13, 'T': 13, 'H': 25, 'M': 13}","{'Y': 13, 'A': 13, 'B': 6, 'D': 6, 'E': 6, 'G': 13, 'I': 6, 'K': 13, 'L': 6, 'N': 6, 'O': 6, 'U': 13, 'V': 6, 'W': 6, 'X': 6}"
INV-ZZ-9545788,SCH-ZZ-8817322,ZZ,ZZ20240613BLRCCU3484.0,3484.0,Boeing 777,06/13/2024,2024-06-13 17:52:00,2024-06-14 07:39:00,BLR,CCU,425.0,469,206,-219,263,42,85,127,170,49,22,20,27,99,43,42,56,148,65,62,83,200,88,82,112,"{'F': 25, 'P': 17}","{'C': 34, 'J': 26, 'Z': 26}","{'Q': 38, 'R': 25, 'S': 13, 'T': 13, 'H': 25, 'M': 13}","{'Y': 13, 'A': 13, 'B': 6, 'D': 6, 'E': 6, 'G': 13, 'I': 6, 'K': 13, 'L': 6, 'N': 6, 'O': 6, 'U': 13, 'V': 6, 'W': 6, 'X': 6}"
INV-ZZ-8908940,SCH-ZZ-1748092,ZZ,ZZ20240430AMDHYD4780.0,4780.0,BAe 146,04/30/2024,2024-04-30 14:44:00,2024-05-01 09:52:00,AMD,HYD,91.0,107,60,-31,47,9,18,27,36,11,6,3,5,20,11,7,9,31,17,10,14,43,24,12,19,"{'F': 5, 'P': 4}","{'C': 7, 'J': 5, 'Z': 5}","{'Q': 8, 'R': 5, 'S': 3, 'T': 3, 'H': 5, 'M': 3}","{'Y': 3, 'A': 3, 'B': 1, 'D': 1, 'E': 1, 'G': 3, 'I': 1, 'K': 3, 'L': 1, 'N': 1, 'O': 1, 'U': 3, 'V': 1, 'W': 1, 'X': 1}"
INV-ZZ-5430563,SCH-ZZ-1748092,ZZ,ZZ20240501AMDHYD4780.0,4780.0,BAe 146,05/01/2024,2024-05-01 14:44:00,2024-05-02 09:52:00,AMD,HYD,91.0,108,59,-32,49,9,18,27,36,11,6,3,5,21,12,6,9,30,16,11,14,43,24,12,19,"{'F': 5, 'P': 4}","{'C': 7, 'J': 5, 'Z': 5}","{'Q': 8, 'R': 5, 'S': 3, 'T': 3, 'H': 5, 'M': 3}","{'Y': 3, 'A': 3, 'B': 1, 'D': 1, 'E': 1, 'G': 3, 'I': 1, 'K': 3, 'L': 1, 'N': 1, 'O': 1, 'U': 3, 'V': 1, 'W': 1, 'X': 1}"
INV-ZZ-9772042,SCH-ZZ-1748092,ZZ,ZZ20240502AMDHYD4780.0,4780.0,BAe 146,05/02/2024,2024-05-02 14:44:00,2024-05-03 09:52:00,AMD,HYD,91.0,104,56,-35,48,9,18,27,36,11,6,3,5,21,11,7,10,32,17,10,15,43,23,13,20,"{'F': 5, 'P': 4}","{'C': 7, 'J': 5, 'Z': 5}","{'Q': 8, 'R': 5, 'S': 3, 'T': 3, 'H': 5, 'M': 3}","{'Y': 3, 'A': 3, 'B': 1, 'D': 1, 'E': 1, 'G': 3, 'I': 1, 'K': 3, 'L': 1, 'N': 1, 'O': 1, 'U': 3, 'V': 1, 'W': 1, 'X': 1}"
INV-ZZ-7272907,SCH-ZZ-1748092,ZZ,ZZ20240507AMDHYD4780.0,4780.0,BAe 146,05/07/2024,2024-05-07 14:44:00,2024-05-08 09:52:00,AMD,HYD,91.0,106,59,-32,47,9,18,27,36,11,6,3,5,20,11,7,9,30,17,10,13,41,23,13,18,"{'F': 5, 'P': 4}","{'C': 7, 'J': 5, 'Z': 5}","{'Q': 8, 'R': 5, 'S': 3, 'T': 3, 'H': 5, 'M': 3}","{'Y': 3, 'A': 3, 'B': 1, 'D': 1, 'E': 1, 'G': 3, 'I': 1, 'K': 3, 'L': 1, 'N': 1, 'O': 1, 'U': 3, 'V': 1, 'W': 1, 'X': 1}"
INV-ZZ-3276390,SCH-ZZ-1748092,ZZ,ZZ20240508AMDHYD4780.0,4780.0,BAe 146,05/08/2024,2024-05-08 14:44:00,2024-05-09 09:52:00,AMD,HYD,91.0,103,58,-33,45,9,18,27,36,10,6,3,4,20,11,7,9,32,18,9,14,40,22,14,18,"{'F': 5, 'P': 4}","{'C': 7, 'J': 5, 'Z': 5}","{'Q': 8, 'R': 5, 'S': 3, 'T': 3, 'H': 5, 'M': 3}","{'Y': 3, 'A': 3, 'B': 1, 'D': 1, 'E': 1, 'G': 3, 'I': 1, 'K': 3, 'L': 1, 'N': 1, 'O': 1, 'U': 3, 'V': 1, 'W': 1, 'X': 1}"
INV-ZZ-7878719,SCH-ZZ-1748092,ZZ,ZZ20240509AMDHYD4780.0,4780.0,BAe 146,05/09/2024,2024-05-09 14:44:00,2024-05-10 09:52:00,AMD,HYD,91.0,101,55,-36,46,9,18,27,36,11,6,3,5,21,11,7,10,32,17,10,15,43,23,13,20,"{'F': 5, 'P': 4}","{'C': 7, 'J': 5, 'Z': 5}","{'Q': 8, 'R': 5, 'S': 3, 'T': 3, 'H': 5, 'M': 3}","{'Y': 3, 'A': 3, 'B': 1, 'D': 1, 'E': 1, 'G': 3, 'I': 1, 'K': 3, 'L': 1, 'N': 1, 'O': 1, 'U': 3, 'V': 1, 'W': 1, 'X': 1}"
INV-ZZ-9575293,SCH-ZZ-1748092,ZZ,ZZ20240514AMDHYD4780.0,4780.0,BAe 146,05/14/2024,2024-05-14 14:44:00,2024-05-15 09:52:00,AMD,HYD,91.0,101,53,-38,48,9,18,27,36,10,5,4,5,20,10,8,10,30,16,11,14,40,21,15,19,"{'F': 5, 'P': 4}","{'C': 7, 'J': 5, 'Z': 5}","{'Q': 8, 'R': 5, 'S': 3, 'T': 3, 'H': 5, 'M': 3}","{'Y': 3, 'A': 3, 'B': 1, 'D': 1, 'E': 1, 'G': 3, 'I': 1, 'K': 3, 'L': 1, 'N': 1, 'O': 1, 'U': 3, 'V': 1, 'W': 1, 'X': 1}"
INV-ZZ-2507206,SCH-ZZ-1748092,ZZ,ZZ20240515AMDHYD4780.0,4780.0,BAe 146,05/15/2024,2024-05-15 14:44:00,2024-05-16 09:52:00,AMD,HYD,91.0,105,52,-39,53,9,18,27,36,11,5,4,6,20,10,8,10,32,16,11,16,42,21,15,21,"{'F': 5, 'P': 4}","{'C': 7, 'J': 5, 'Z': 5}","{'Q': 8, 'R': 5, 'S': 3, 'T': 3, 'H': 5, 'M': 3}","{'Y': 3, 'A': 3, 'B': 1, 'D': 1, 'E': 1, 'G': 3, 'I': 1, 'K': 3, 'L': 1, 'N': 1, 'O': 1, 'U': 3, 'V': 1, 'W': 1, 'X': 1}"
INV-ZZ-5136245,SCH-ZZ-1748092,ZZ,ZZ20240516AMDHYD4780.0,4780.0,BAe 146,05/16/2024,2024-05-16 14:44:00,2024-05-17 09:52:00,AMD,HYD,91.0,108,55,-36,53,9,18,27,36,10,5,4,5,21,11,7,10,31,16,11,15,42,21,15,21,"{'F': 5, 'P': 4}","{'C': 7, 'J': 5, 'Z': 5}","{'Q': 8, 'R': 5, 'S': 3, 'T': 3, 'H': 5, 'M': 3}","{'Y': 3, 'A': 3, 'B': 1, 'D': 1, 'E': 1, 'G': 3, 'I': 1, 'K': 3, 'L': 1, 'N': 1, 'O': 1, 'U': 3, 'V': 1, 'W': 1, 'X': 1}"
INV-ZZ-6580254,SCH-ZZ-1748092,ZZ,ZZ20240521AMDHYD4780.0,4780.0,BAe 146,05/21/2024,2024-05-21 14:44:00,2024-05-22 09:52:00,AMD,HYD,91.0,103,56,-35,47,9,18,27,36,10,5,4,5,21,11,7,10,30,16,11,14,42,23,13,19,"{'F': 5, 'P': 4}","{'C': 7, 'J': 5, 'Z': 5}","{'Q': 8, 'R': 5, 'S': 3, 'T': 3, 'H': 5, 'M': 3}","{'Y': 3, 'A': 3, 'B': 1, 'D': 1, 'E': 1, 'G': 3, 'I': 1, 'K': 3, 'L': 1, 'N': 1, 'O': 1, 'U': 3, 'V': 1, 'W': 1, 'X': 1}"
INV-ZZ-9250282,SCH-ZZ-1748092,ZZ,ZZ20240522AMDHYD4780.0,4780.0,BAe 146,05/22/2024,2024-05-22 14:44:00,2024-05-23 09:52:00,AMD,HYD,91.0,107,51,-40,56,9,18,27,36,10,5,4,5,20,10,8,10,32,15,12,17,40,19,17,21,"{'F': 5, 'P': 4}","{'C': 7, 'J': 5, 'Z': 5}","{'Q': 8, 'R': 5, 'S': 3, 'T': 3, 'H': 5, 'M': 3}","{'Y': 3, 'A': 3, 'B': 1, 'D': 1, 'E': 1, 'G': 3, 'I': 1, 'K': 3, 'L': 1, 'N': 1, 'O': 1, 'U': 3, 'V': 1, 'W': 1, 'X': 1}"
INV-ZZ-9092691,SCH-ZZ-1748092,ZZ,ZZ20240523AMDHYD4780.0,4780.0,BAe 146,05/23/2024,2024-05-23 14:44:00,2024-05-24 09:52:00,AMD,HYD,91.0,105,49,-42,56,9,18,27,36,10,5,4,5,21,10,8,11,30,14,13,16,42,20,16,22,"{'F': 5, 'P': 4}","{'C': 7, 'J': 5, 'Z': 5}","{'Q': 8, 'R': 5, 'S': 3, 'T': 3, 'H': 5, 'M': 3}","{'Y': 3, 'A': 3, 'B': 1, 'D': 1, 'E': 1, 'G': 3, 'I': 1, 'K': 3, 'L': 1, 'N': 1, 'O': 1, 'U': 3, 'V': 1, 'W': 1, 'X': 1}"
INV-ZZ-7363018,SCH-ZZ-1748092,ZZ,ZZ20240528AMDHYD4780.0,4780.0,BAe 146,05/28/2024,2024-05-28 14:44:00,2024-05-29 09:52:00,AMD,HYD,91.0,106,53,-38,53,9,18,27,36,11,5,4,6,21,10,8,11,30,15,12,15,42,21,15,21,"{'F': 5, 'P': 4}","{'C': 7, 'J': 5, 'Z': 5}","{'Q': 8, 'R': 5, 'S': 3, 'T': 3, 'H': 5, 'M': 3}","{'Y': 3, 'A': 3, 'B': 1, 'D': 1, 'E': 1, 'G': 3, 'I': 1, 'K': 3, 'L': 1, 'N': 1, 'O': 1, 'U': 3, 'V': 1, 'W': 1, 'X': 1}"
INV-ZZ-8700507,SCH-ZZ-1748092,ZZ,ZZ20240529AMDHYD4780.0,4780.0,BAe 146,05/29/2024,2024-05-29 14:44:00,2024-05-30 09:52:00,AMD,HYD,91.0,106,52,-39,54,9,18,27,36,10,5,4,5,21,10,8,11,31,15,12,16,42,20,16,22,"{'F': 5, 'P': 4}","{'C': 7, 'J': 5, 'Z': 5}","{'Q': 8, 'R': 5, 'S': 3, 'T': 3, 'H': 5, 'M': 3}","{'Y': 3, 'A': 3, 'B': 1, 'D': 1, 'E': 1, 'G': 3, 'I': 1, 'K': 3, 'L': 1, 'N': 1, 'O': 1, 'U': 3, 'V': 1, 'W': 1, 'X': 1}"
INV-ZZ-4552482,SCH-ZZ-1748092,ZZ,ZZ20240530AMDHYD4780.0,4780.0,BAe 146,05/30/2024,2024-05-30 14:44:00,2024-05-31 09:52:00,AMD,HYD,91.0,107,55,-36,52,9,18,27,36,10,5,4,5,20,10,8,10,31,16,11,15,40,21,15,19,"{'F': 5, 'P': 4}","{'C': 7, 'J': 5, 'Z': 5}","{'Q': 8, 'R': 5, 'S': 3, 'T': 3, 'H': 5, 'M': 3}","{'Y': 3, 'A': 3, 'B': 1, 'D': 1, 'E': 1, 'G': 3, 'I': 1, 'K': 3, 'L': 1, 'N': 1, 'O': 1, 'U': 3, 'V': 1, 'W': 1, 'X': 1}"
INV-ZZ-1748559,SCH-ZZ-1748092,ZZ,ZZ20240604AMDHYD4780.0,4780.0,BAe 146,06/04/2024,2024-06-04 14:44:00,2024-06-05 09:52:00,AMD,HYD,91.0,101,49,-42,52,9,18,27,36,10,5,4,5,20,10,8,10,31,15,12,16,40,20,16,20,"{'F': 5, 'P': 4}","{'C': 7, 'J': 5, 'Z': 5}","{'Q': 8, 'R': 5, 'S': 3, 'T': 3, 'H': 5, 'M': 3}","{'Y': 3, 'A': 3, 'B': 1, 'D': 1, 'E': 1, 'G': 3, 'I': 1, 'K': 3, 'L': 1, 'N': 1, 'O': 1, 'U': 3, 'V': 1, 'W': 1, 'X': 1}"
INV-ZZ-7712220,SCH-ZZ-1748092,ZZ,ZZ20240605AMDHYD4780.0,4780.0,BAe 146,06/05/2024,2024-06-05 14:44:00,2024-06-06 09:52:00,AMD,HYD,91.0,105,52,-39,53,9,18,27,36,10,5,4,5,21,10,8,11,32,16,11,16,41,20,16,21,"{'F': 5, 'P': 4}","{'C': 7, 'J': 5, 'Z': 5}","{'Q': 8, 'R': 5, 'S': 3, 'T': 3, 'H': 5, 'M': 3}","{'Y': 3, 'A': 3, 'B': 1, 'D': 1, 'E': 1, 'G': 3, 'I': 1, 'K': 3, 'L': 1, 'N': 1, 'O': 1, 'U': 3, 'V': 1, 'W': 1, 'X': 1}"
INV-ZZ-2500372,SCH-ZZ-1748092,ZZ,ZZ20240606AMDHYD4780.0,4780.0,BAe 146,06/06/2024,2024-06-06 14:44:00,2024-06-07 09:52:00,AMD,HYD,91.0,100,44,-47,56,9,18,27,36,10,4,5,6,21,9,9,12,31,14,13,17,43,19,17,24,"{'F': 5, 'P': 4}","{'C': 7, 'J': 5, 'Z': 5}","{'Q': 8, 'R': 5, 'S': 3, 'T': 3, 'H': 5, 'M': 3}","{'Y': 3, 'A': 3, 'B': 1, 'D': 1, 'E': 1, 'G': 3, 'I': 1, 'K': 3, 'L': 1, 'N': 1, 'O': 1, 'U': 3, 'V': 1, 'W': 1, 'X': 1}"
INV-ZZ-9820159,SCH-ZZ-1748092,ZZ,ZZ20240611AMDHYD4780.0,4780.0,BAe 146,06/11/2024,2024-06-11 14:44:00,2024-06-12 09:52:00,AMD,HYD,91.0,101,44,-47,57,9,18,27,36,11,5,4,6,22,10,8,12,30,13,14,17,43,19,17,24,"{'F': 5, 'P': 4}","{'C': 7, 'J': 5, 'Z': 5}","{'Q': 8, 'R': 5, 'S': 3, 'T': 3, 'H': 5, 'M': 3}","{'Y': 3, 'A': 3, 'B': 1, 'D': 1, 'E': 1, 'G': 3, 'I': 1, 'K': 3, 'L': 1, 'N': 1, 'O': 1, 'U': 3, 'V': 1, 'W': 1, 'X': 1}"
INV-ZZ-2197648,SCH-ZZ-1748092,ZZ,ZZ20240612AMDHYD4780.0,4780.0,BAe 146,06/12/2024,2024-06-12 14:44:00,2024-06-13 09:52:00,AMD,HYD,91.0,106,48,-43,58,9,18,27,36,11,5,4,6,21,9,9,12,32,14,13,18,42,19,17,23,"{'F': 5, 'P': 4}","{'C': 7, 'J': 5, 'Z': 5}","{'Q': 8, 'R': 5, 'S': 3, 'T': 3, 'H': 5, 'M': 3}","{'Y': 3, 'A': 3, 'B': 1, 'D': 1, 'E': 1, 'G': 3, 'I': 1, 'K': 3, 'L': 1, 'N': 1, 'O': 1, 'U': 3, 'V': 1, 'W': 1, 'X': 1}"
INV-ZZ-4505598,SCH-ZZ-1748092,ZZ,ZZ20240613AMDHYD4780.0,4780.0,BAe 146,06/13/2024,2024-06-13 14:44:00,2024-06-14 09:52:00,AMD,HYD,91.0,108,50,-41,58,9,18,27,36,10,5,4,5,20,9,9,11,32,15,12,17,40,19,17,21,"{'F': 5, 'P': 4}","{'C': 7, 'J': 5, 'Z': 5}","{'Q': 8, 'R': 5, 'S': 3, 'T': 3, 'H': 5, 'M': 3}","{'Y': 3, 'A': 3, 'B': 1, 'D': 1, 'E': 1, 'G': 3, 'I': 1, 'K': 3, 'L': 1, 'N': 1, 'O': 1, 'U': 3, 'V': 1, 'W': 1, 'X': 1}"
INV-ZZ-9764243,SCH-ZZ-1367492,ZZ,ZZ20240422MAABOM3229.0,3229.0,Airbus A320 Neo,04/22/2024,2024-04-22 00:52:00,2024-04-22 23:19:00,MAA,BOM,180.0,208,127,-53,81,18,36,54,72,20,12,6,8,40,25,11,15,61,37,17,24,86,53,19,33,"{'F': 11, 'P': 7}","{'C': 14, 'J': 11, 'Z': 11}","{'Q': 16, 'R': 11, 'S': 5, 'T': 5, 'H': 11, 'M': 5}","{'Y': 5, 'A': 5, 'B': 3, 'D': 3, 'E': 3, 'G': 5, 'I': 3, 'K': 5, 'L': 3, 'N': 3, 'O': 3, 'U': 5, 'V': 3, 'W': 3, 'X': 3}"
INV-ZZ-4793287,SCH-ZZ-1367492,ZZ,ZZ20240424MAABOM3229.0,3229.0,Airbus A320 Neo,04/24/2024,2024-04-24 00:52:00,2024-04-24 23:19:00,MAA,BOM,180.0,209,113,-67,96,18,36,54,72,21,11,7,10,40,22,14,18,61,33,21,28,80,43,29,37,"{'F': 11, 'P': 7}","{'C': 14, 'J': 11, 'Z': 11}","{'Q': 16, 'R': 11, 'S': 5, 'T': 5, 'H': 11, 'M': 5}","{'Y': 5, 'A': 5, 'B': 3, 'D': 3, 'E': 3, 'G': 5, 'I': 3, 'K': 5, 'L': 3, 'N': 3, 'O': 3, 'U': 5, 'V': 3, 'W': 3, 'X': 3}"
INV-ZZ-2144672,SCH-ZZ-1367492,ZZ,ZZ20240429MAABOM3229.0,3229.0,Airbus A320 Neo,04/29/2024,2024-04-29 00:52:00,2024-04-29 23:19:00,MAA,BOM,180.0,213,125,-55,88,18,36,54,72,20,12,6,8,40,24,12,16,62,37,17,25,82,48,24,34,"{'F': 11, 'P': 7}","{'C': 14, 'J': 11, 'Z': 11}","{'Q': 16, 'R': 11, 'S': 5, 'T': 5, 'H': 11, 'M': 5}","{'Y': 5, 'A': 5, 'B': 3, 'D': 3, 'E': 3, 'G': 5, 'I': 3, 'K': 5, 'L': 3, 'N': 3, 'O': 3, 'U': 5, 'V': 3, 'W': 3, 'X': 3}"
INV-ZZ-9838647,SCH-ZZ-1367492,ZZ,ZZ20240501MAABOM3229.0,3229.0,Airbus A320 Neo,05/01/2024,2024-05-01 00:52:00,2024-05-01 23:19:00,MAA,BOM,180.0,212,109,-71,103,18,36,54,72,21,11,7,10,40,21,15,19,62,32,22,30,83,43,29,40,"{'F': 11, 'P': 7}","{'C': 14, 'J': 11, 'Z': 11}","{'Q': 16, 'R': 11, 'S': 5, 'T': 5, 'H': 11, 'M': 5}","{'Y': 5, 'A': 5, 'B': 3, 'D': 3, 'E': 3, 'G': 5, 'I': 3, 'K': 5, 'L': 3, 'N': 3, 'O': 3, 'U': 5, 'V': 3, 'W': 3, 'X': 3}"
INV-ZZ-9956956,SCH-ZZ-1367492,ZZ,ZZ20240506MAABOM3229.0,3229.0,Airbus A320 Neo,05/06/2024,2024-05-06 00:52:00,2024-05-06 23:19:00,MAA,BOM,180.0,202,114,-66,88,18,36,54,72,20,11,7,9,42,24,12,18,60,34,20,26,80,45,27,35,"{'F': 11, 'P': 7}","{'C': 14, 'J': 11, 'Z': 11}","{'Q': 16, 'R': 11, 'S': 5, 'T': 5, 'H': 11, 'M': 5}","{'Y': 5, 'A': 5, 'B': 3, 'D': 3, 'E': 3, 'G': 5, 'I': 3, 'K': 5, 'L': 3, 'N': 3, 'O': 3, 'U': 5, 'V': 3, 'W': 3, 'X': 3}"
INV-ZZ-3194907,SCH-ZZ-1367492,ZZ,ZZ20240508MAABOM3229.0,3229.0,Airbus A320 Neo,05/08/2024,2024-05-08 00:52:00,2024-05-08 23:19:00,MAA,BOM,180.0,203,111,-69,92,18,36,54,72,20,11,7,9,40,22,14,18,63,35,19,28,84,46,26,38,"{'F': 11, 'P': 7}","{'C': 14, 'J': 11, 'Z': 11}","{'Q': 16, 'R': 11, 'S': 5, 'T': 5, 'H': 11, 'M': 5}","{'Y': 5, 'A': 5, 'B': 3, 'D': 3, 'E': 3, 'G': 5, 'I': 3, 'K': 5, 'L': 3, 'N': 3, 'O': 3, 'U': 5, 'V': 3, 'W': 3, 'X': 3}"
INV-ZZ-2147971,SCH-ZZ-1367492,ZZ,ZZ20240513MAABOM3229.0,3229.0,Airbus A320 Neo,05/13/2024,2024-05-13 00:52:00,2024-05-13 23:19:00,MAA,BOM,180.0,203,101,-79,102,18,36,54,72,20,10,8,10,40,20,16,20,63,31,23,32,80,40,32,40,"{'F': 11, 'P': 7}","{'C': 14, 'J': 11, 'Z': 11}","{'Q': 16, 'R': 11, 'S': 5, 'T': 5, 'H': 11, 'M': 5}","{'Y': 5, 'A': 5, 'B': 3, 'D': 3, 'E': 3, 'G': 5, 'I': 3, 'K': 5, 'L': 3, 'N': 3, 'O': 3, 'U': 5, 'V': 3, 'W': 3, 'X': 3}"
INV-ZZ-7932424,SCH-ZZ-1367492,ZZ,ZZ20240515MAABOM3229.0,3229.0,Airbus A320 Neo,05/15/2024,2024-05-15 00:52:00,2024-05-15 23:19:00,MAA,BOM,180.0,201,98,-82,103,18,36,54,72,21,10,8,11,43,21,15,22,61,30,24,31,84,41,31,43,"{'F': 11, 'P': 7}","{'C': 14, 'J': 11, 'Z': 11}","{'Q': 16, 'R': 11, 'S': 5, 'T': 5, 'H': 11, 'M': 5}","{'Y': 5, 'A': 5, 'B': 3, 'D': 3, 'E': 3, 'G': 5, 'I': 3, 'K': 5, 'L': 3, 'N': 3, 'O': 3, 'U': 5, 'V': 3, 'W': 3, 'X': 3}"
INV-ZZ-4372610,SCH-ZZ-1367492,ZZ,ZZ20240520MAABOM3229.0,3229.0,Airbus A320 Neo,05/20/2024,2024-05-20 00:52:00,2024-05-20 23:19:00,MAA,BOM,180.0,213,114,-66,99,18,36,54,72,20,11,7,9,43,23,13,20,65,35,19,30,83,45,27,38,"{'F': 11, 'P': 7}","{'C': 14, 'J': 11, 'Z': 11}","{'Q': 16, 'R': 11, 'S': 5, 'T': 5, 'H': 11, 'M': 5}","{'Y': 5, 'A': 5, 'B': 3, 'D': 3, 'E': 3, 'G': 5, 'I': 3, 'K': 5, 'L': 3, 'N': 3, 'O': 3, 'U': 5, 'V': 3, 'W': 3, 'X': 3}"
INV-ZZ-5768333,SCH-ZZ-1367492,ZZ,ZZ20240522MAABOM3229.0,3229.0,Airbus A320 Neo,05/22/2024,2024-05-22 00:52:00,2024-05-22 23:19:00,MAA,BOM,180.0,205,102,-78,103,18,36,54,72,20,10,8,10,41,20,16,21,60,30,24,30,81,40,32,41,"{'F': 11, 'P': 7}","{'C': 14, 'J': 11, 'Z': 11}","{'Q': 16, 'R': 11, 'S': 5, 'T': 5, 'H': 11, 'M': 5}","{'Y': 5, 'A': 5, 'B': 3, 'D': 3, 'E': 3, 'G': 5, 'I': 3, 'K': 5, 'L': 3, 'N': 3, 'O': 3, 'U': 5, 'V': 3, 'W': 3, 'X': 3}"
INV-ZZ-7777867,SCH-ZZ-1367492,ZZ,ZZ20240527MAABOM3229.0,3229.0,Airbus A320 Neo,05/27/2024,2024-05-27 00:52:00,2024-05-27 23:19:00,MAA,BOM,180.0,208,104,-76,104,18,36,54,72,20,10,8,10,40,20,16,20,60,30,24,30,84,42,30,42,"{'F': 11, 'P': 7}","{'C': 14, 'J': 11, 'Z': 11}","{'Q': 16, 'R': 11, 'S': 5, 'T': 5, 'H': 11, 'M': 5}","{'Y': 5, 'A': 5, 'B': 3, 'D': 3, 'E': 3, 'G': 5, 'I': 3, 'K': 5, 'L': 3, 'N': 3, 'O': 3, 'U': 5, 'V': 3, 'W': 3, 'X': 3}"
INV-ZZ-9075441,SCH-ZZ-1367492,ZZ,ZZ20240529MAABOM3229.0,3229.0,Airbus A320 Neo,05/29/2024,2024-05-29 00:52:00,2024-05-29 23:19:00,MAA,BOM,180.0,201,93,-87,108,18,36,54,72,20,9,9,11,42,20,16,22,60,28,26,32,80,37,35,43,"{'F': 11, 'P': 7}","{'C': 14, 'J': 11, 'Z': 11}","{'Q': 16, 'R': 11, 'S': 5, 'T': 5, 'H': 11, 'M': 5}","{'Y': 5, 'A': 5, 'B': 3, 'D': 3, 'E': 3, 'G': 5, 'I': 3, 'K': 5, 'L': 3, 'N': 3, 'O': 3, 'U': 5, 'V': 3, 'W': 3, 'X': 3}"
INV-ZZ-6443821,SCH-ZZ-1367492,ZZ,ZZ20240603MAABOM3229.0,3229.0,Airbus A320 Neo,06/03/2024,2024-06-03 00:52:00,2024-06-03 23:19:00,MAA,BOM,180.0,211,100,-80,111,18,36,54,72,21,10,8,11,41,20,16,21,60,29,25,31,83,40,32,43,"{'F': 11, 'P': 7}","{'C': 14, 'J': 11, 'Z': 11}","{'Q': 16, 'R': 11, 'S': 5, 'T': 5, 'H': 11, 'M': 5}","{'Y': 5, 'A': 5, 'B': 3, 'D': 3, 'E': 3, 'G': 5, 'I': 3, 'K': 5, 'L': 3, 'N': 3, 'O': 3, 'U': 5, 'V': 3, 'W': 3, 'X': 3}"
INV-ZZ-1997342,SCH-ZZ-1122041,ZZ,ZZ20240516AMDBLR4957.0,4957.0,Airbus A320 Neo,05/16/2024,2024-05-16 10:19:00,2024-05-16 21:50:00,AMD,BLR,180.0,202,111,-69,91,18,36,54,72,20,11,7,9,42,23,13,19,62,34,20,28,81,44,28,37,"{'F': 11, 'P': 7}","{'C': 14, 'J': 11, 'Z': 11}","{'Q': 16, 'R': 11, 'S': 5, 'T': 5, 'H': 11, 'M': 5}","{'Y': 5, 'A': 5, 'B': 3, 'D': 3, 'E': 3, 'G': 5, 'I': 3, 'K': 5, 'L': 3, 'N': 3, 'O': 3, 'U': 5, 'V': 3, 'W': 3, 'X': 3}"
INV-ZZ-5821640,SCH-ZZ-1122041,ZZ,ZZ20240518AMDBLR4957.0,4957.0,Airbus A320 Neo,05/18/2024,2024-05-18 10:19:00,2024-05-18 21:50:00,AMD,BLR,180.0,204,103,-77,101,18,36,54,72,21,11,7,10,41,21,15,20,60,30,24,30,80,40,32,40,"{'F': 11, 'P': 7}","{'C': 14, 'J': 11, 'Z': 11}","{'Q': 16, 'R': 11, 'S': 5, 'T': 5, 'H': 11, 'M': 5}","{'Y': 5, 'A': 5, 'B': 3, 'D': 3, 'E': 3, 'G': 5, 'I': 3, 'K': 5, 'L': 3, 'N': 3, 'O': 3, 'U': 5, 'V': 3, 'W': 3, 'X': 3}"
INV-ZZ-6596940,SCH-ZZ-1122041,ZZ,ZZ20240519AMDBLR4957.0,4957.0,Airbus A320 Neo,05/19/2024,2024-05-19 10:19:00,2024-05-19 21:50:00,AMD,BLR,180.0,202,108,-72,94,18,36,54,72,21,11,7,10,41,22,14,19,60,32,22,28,79,42,30,37,"{'F': 11, 'P': 7}","{'C': 14, 'J': 11, 'Z': 11}","{'Q': 16, 'R': 11, 'S': 5, 'T': 5, 'H': 11, 'M': 5}","{'Y': 5, 'A': 5, 'B': 3, 'D': 3, 'E': 3, 'G': 5, 'I': 3, 'K': 5, 'L': 3, 'N': 3, 'O': 3, 'U': 5, 'V': 3, 'W': 3, 'X': 3}"
INV-ZZ-2187595,SCH-ZZ-1122041,ZZ,ZZ20240521AMDBLR4957.0,4957.0,Airbus A320 Neo,05/21/2024,2024-05-21 10:19:00,2024-05-21 21:50:00,AMD,BLR,180.0,202,100,-80,102,18,36,54,72,21,10,8,11,40,20,16,20,64,32,22,32,86,43,29,43,"{'F': 11, 'P': 7}","{'C': 14, 'J': 11, 'Z': 11}","{'Q': 16, 'R': 11, 'S': 5, 'T': 5, 'H': 11, 'M': 5}","{'Y': 5, 'A': 5, 'B': 3, 'D': 3, 'E': 3, 'G': 5, 'I': 3, 'K': 5, 'L': 3, 'N': 3, 'O': 3, 'U': 5, 'V': 3, 'W': 3, 'X': 3}"
INV-ZZ-3097865,SCH-ZZ-1122041,ZZ,ZZ20240523AMDBLR4957.0,4957.0,Airbus A320 Neo,05/23/2024,2024-05-23 10:19:00,2024-05-23 21:50:00,AMD,BLR,180.0,205,108,-72,97,18,36,54,72,21,11,7,10,41,22,14,19,62,33,21,29,82,43,29,39,"{'F': 11, 'P': 7}","{'C': 14, 'J': 11, 'Z': 11}","{'Q': 16, 'R': 11, 'S': 5, 'T': 5, 'H': 11, 'M': 5}","{'Y': 5, 'A': 5, 'B': 3, 'D': 3, 'E': 3, 'G': 5, 'I': 3, 'K': 5, 'L': 3, 'N': 3, 'O': 3, 'U': 5, 'V': 3, 'W': 3, 'X': 3}"
INV-ZZ-9652973,SCH-ZZ-1122041,ZZ,ZZ20240525AMDBLR4957.0,4957.0,Airbus A320 Neo,05/25/2024,2024-05-25 10:19:00,2024-05-25 21:50:00,AMD,BLR,180.0,209,97,-83,112,18,36,54,72,20,9,9,11,42,20,16,22,59,27,27,32,81,38,34,43,"{'F': 11, 'P': 7}","{'C': 14, 'J': 11, 'Z': 11}","{'Q': 16, 'R': 11, 'S': 5, 'T': 5, 'H': 11, 'M': 5}","{'Y': 5, 'A': 5, 'B': 3, 'D': 3, 'E': 3, 'G': 5, 'I': 3, 'K': 5, 'L': 3, 'N': 3, 'O': 3, 'U': 5, 'V': 3, 'W': 3, 'X': 3}"
INV-ZZ-2788988,SCH-ZZ-1122041,ZZ,ZZ20240526AMDBLR4957.0,4957.0,Airbus A320 Neo,05/26/2024,2024-05-26 10:19:00,2024-05-26 21:50:00,AMD,BLR,180.0,204,108,-72,96,18,36,54,72,20,11,7,9,41,22,14,19,65,34,20,31,84,44,28,40,"{'F': 11, 'P': 7}","{'C': 14, 'J': 11, 'Z': 11}","{'Q': 16, 'R': 11, 'S': 5, 'T': 5, 'H': 11, 'M': 5}","{'Y': 5, 'A': 5, 'B': 3, 'D': 3, 'E': 3, 'G': 5, 'I': 3, 'K': 5, 'L': 3, 'N': 3, 'O': 3, 'U': 5, 'V': 3, 'W': 3, 'X': 3}"
INV-ZZ-3113517,SCH-ZZ-1122041,ZZ,ZZ20240528AMDBLR4957.0,4957.0,Airbus A320 Neo,05/28/2024,2024-05-28 10:19:00,2024-05-28 21:50:00,AMD,BLR,180.0,213,109,-71,104,18,36,54,72,20,10,8,10,40,20,16,20,64,33,21,31,79,40,32,39,"{'F': 11, 'P': 7}","{'C': 14, 'J': 11, 'Z': 11}","{'Q': 16, 'R': 11, 'S': 5, 'T': 5, 'H': 11, 'M': 5}","{'Y': 5, 'A': 5, 'B': 3, 'D': 3, 'E': 3, 'G': 5, 'I': 3, 'K': 5, 'L': 3, 'N': 3, 'O': 3, 'U': 5, 'V': 3, 'W': 3, 'X': 3}"
INV-ZZ-4704924,SCH-ZZ-1122041,ZZ,ZZ20240530AMDBLR4957.0,4957.0,Airbus A320 Neo,05/30/2024,2024-05-30 10:19:00,2024-05-30 21:50:00,AMD,BLR,180.0,203,99,-81,104,18,36,54,72,20,10,8,10,41,20,16,21,64,31,23,33,82,40,32,42,"{'F': 11, 'P': 7}","{'C': 14, 'J': 11, 'Z': 11}","{'Q': 16, 'R': 11, 'S': 5, 'T': 5, 'H': 11, 'M': 5}","{'Y': 5, 'A': 5, 'B': 3, 'D': 3, 'E': 3, 'G': 5, 'I': 3, 'K': 5, 'L': 3, 'N': 3, 'O': 3, 'U': 5, 'V': 3, 'W': 3, 'X': 3}"
INV-ZZ-3616181,SCH-ZZ-1122041,ZZ,ZZ20240601AMDBLR4957.0,4957.0,Airbus A320 Neo,06/01/2024,2024-06-01 10:19:00,2024-06-01 21:50:00,AMD,BLR,180.0,198,99,-81,99,18,36,54,72,22,11,7,11,42,21,15,21,59,29,25,30,83,41,31,42,"{'F': 11, 'P': 7}","{'C': 14, 'J': 11, 'Z': 11}","{'Q': 16, 'R': 11, 'S': 5, 'T': 5, 'H': 11, 'M': 5}","{'Y': 5, 'A': 5, 'B': 3, 'D': 3, 'E': 3, 'G': 5, 'I': 3, 'K': 5, 'L': 3, 'N': 3, 'O': 3, 'U': 5, 'V': 3, 'W': 3, 'X': 3}"
INV-ZZ-9027840,SCH-ZZ-1122041,ZZ,ZZ20240602AMDBLR4957.0,4957.0,Airbus A320 Neo,06/02/2024,2024-06-02 10:19:00,2024-06-02 21:50:00,AMD,BLR,180.0,200,91,-89,109,18,36,54,72,21,10,8,11,41,19,17,22,64,29,25,35,82,37,35,45,"{'F': 11, 'P': 7}","{'C': 14, 'J': 11, 'Z': 11}","{'Q': 16, 'R': 11, 'S': 5, 'T': 5, 'H': 11, 'M': 5}","{'Y': 5, 'A': 5, 'B': 3, 'D': 3, 'E': 3, 'G': 5, 'I': 3, 'K': 5, 'L': 3, 'N': 3, 'O': 3, 'U': 5, 'V': 3, 'W': 3, 'X': 3}"
INV-ZZ-7767901,SCH-ZZ-1122041,ZZ,ZZ20240604AMDBLR4957.0,4957.0,Airbus A320 Neo,06/04/2024,2024-06-04 10:19:00,2024-06-04 21:50:00,AMD,BLR,180.0,202,88,-92,114,18,36,54,72,21,9,9,12,42,18,18,24,64,28,26,36,86,37,35,49,"{'F': 11, 'P': 7}","{'C': 14, 'J': 11, 'Z': 11}","{'Q': 16, 'R': 11, 'S': 5, 'T': 5, 'H': 11, 'M': 5}","{'Y': 5, 'A': 5, 'B': 3, 'D': 3, 'E': 3, 'G': 5, 'I': 3, 'K': 5, 'L': 3, 'N': 3, 'O': 3, 'U': 5, 'V': 3, 'W': 3, 'X': 3}"
INV-ZZ-1838333,SCH-ZZ-1122041,ZZ,ZZ20240606AMDBLR4957.0,4957.0,Airbus A320 Neo,06/06/2024,2024-06-06 10:19:00,2024-06-06 21:50:00,AMD,BLR,180.0,200,93,-87,107,18,36,54,72,20,9,9,11,43,20,16,23,64,30,24,34,80,37,35,43,"{'F': 11, 'P': 7}","{'C': 14, 'J': 11, 'Z': 11}","{'Q': 16, 'R': 11, 'S': 5, 'T': 5, 'H': 11, 'M': 5}","{'Y': 5, 'A': 5, 'B': 3, 'D': 3, 'E': 3, 'G': 5, 'I': 3, 'K': 5, 'L': 3, 'N': 3, 'O': 3, 'U': 5, 'V': 3, 'W': 3, 'X': 3}"
INV-ZZ-9469704,SCH-ZZ-1122041,ZZ,ZZ20240608AMDBLR4957.0,4957.0,Airbus A320 Neo,06/08/2024,2024-06-08 10:19:00,2024-06-08 21:50:00,AMD,BLR,180.0,211,102,-78,109,18,36,54,72,21,10,8,11,40,19,17,21,60,29,25,31,85,41,31,44,"{'F': 11, 'P': 7}","{'C': 14, 'J': 11, 'Z': 11}","{'Q': 16, 'R': 11, 'S': 5, 'T': 5, 'H': 11, 'M': 5}","{'Y': 5, 'A': 5, 'B': 3, 'D': 3, 'E': 3, 'G': 5, 'I': 3, 'K': 5, 'L': 3, 'N': 3, 'O': 3, 'U': 5, 'V': 3, 'W': 3, 'X': 3}"
INV-ZZ-4076463,SCH-ZZ-1122041,ZZ,ZZ20240609AMDBLR4957.0,4957.0,Airbus A320 Neo,06/09/2024,2024-06-09 10:19:00,2024-06-09 21:50:00,AMD,BLR,180.0,213,103,-77,110,18,36,54,72,20,10,8,10,43,21,15,22,64,31,23,33,85,41,31,44,"{'F': 11, 'P': 7}","{'C': 14, 'J': 11, 'Z': 11}","{'Q': 16, 'R': 11, 'S': 5, 'T': 5, 'H': 11, 'M': 5}","{'Y': 5, 'A': 5, 'B': 3, 'D': 3, 'E': 3, 'G': 5, 'I': 3, 'K': 5, 'L': 3, 'N': 3, 'O': 3, 'U': 5, 'V': 3, 'W': 3, 'X': 3}"
INV-ZZ-1161738,SCH-ZZ-1122041,ZZ,ZZ20240611AMDBLR4957.0,4957.0,Airbus A320 Neo,06/11/2024,2024-06-11 10:19:00,2024-06-11 21:50:00,AMD,BLR,180.0,214,96,-84,118,18,36,54,72,20,9,9,11,42,19,17,23,65,29,25,36,81,36,36,45,"{'F': 11, 'P': 7}","{'C': 14, 'J': 11, 'Z': 11}","{'Q': 16, 'R': 11, 'S': 5, 'T': 5, 'H': 11, 'M': 5}","{'Y': 5, 'A': 5, 'B': 3, 'D': 3, 'E': 3, 'G': 5, 'I': 3, 'K': 5, 'L': 3, 'N': 3, 'O': 3, 'U': 5, 'V': 3, 'W': 3, 'X': 3}"
INV-ZZ-4863146,SCH-ZZ-1122041,ZZ,ZZ20240613AMDBLR4957.0,4957.0,Airbus A320 Neo,06/13/2024,2024-06-13 10:19:00,2024-06-13 21:50:00,AMD,BLR,180.0,210,91,-89,119,18,36,54,72,20,9,9,11,43,19,17,24,60,26,28,34,84,36,36,48,"{'F': 11, 'P': 7}","{'C': 14, 'J': 11, 'Z': 11}","{'Q': 16, 'R': 11, 'S': 5, 'T': 5, 'H': 11, 'M': 5}","{'Y': 5, 'A': 5, 'B': 3, 'D': 3, 'E': 3, 'G': 5, 'I': 3, 'K': 5, 'L': 3, 'N': 3, 'O': 3, 'U': 5, 'V': 3, 'W': 3, 'X': 3}"
INV-ZZ-8068965,SCH-ZZ-1122041,ZZ,ZZ20240615AMDBLR4957.0,4957.0,Airbus A320 Neo,06/15/2024,2024-06-15 10:19:00,2024-06-15 21:50:00,AMD,BLR,180.0,210,92,-88,118,18,36,54,72,21,9,9,12,42,18,18,24,61,27,27,34,83,36,36,47,"{'F': 11, 'P': 7}","{'C': 14, 'J': 11, 'Z': 11}","{'Q': 16, 'R': 11, 'S': 5, 'T': 5, 'H': 11, 'M': 5}","{'Y': 5, 'A': 5, 'B': 3, 'D': 3, 'E': 3, 'G': 5, 'I': 3, 'K': 5, 'L': 3, 'N': 3, 'O': 3, 'U': 5, 'V': 3, 'W': 3, 'X': 3}"
INV-ZZ-1469750,SCH-ZZ-1122041,ZZ,ZZ20240616AMDBLR4957.0,4957.0,Airbus A320 Neo,06/16/2024,2024-06-16 10:19:00,2024-06-16 21:50:00,AMD,BLR,180.0,203,90,-90,113,18,36,54,72,20,9,9,11,43,19,17,24,61,27,27,34,83,37,35,46,"{'F': 11, 'P': 7}","{'C': 14, 'J': 11, 'Z': 11}","{'Q': 16, 'R': 11, 'S': 5, 'T': 5, 'H': 11, 'M': 5}","{'Y': 5, 'A': 5, 'B': 3, 'D': 3, 'E': 3, 'G': 5, 'I': 3, 'K': 5, 'L': 3, 'N': 3, 'O': 3, 'U': 5, 'V': 3, 'W': 3, 'X': 3}"
INV-ZZ-2935025,SCH-ZZ-1122041,ZZ,ZZ20240618AMDBLR4957.0,4957.0,Airbus A320 Neo,06/18/2024,2024-06-18 10:19:00,2024-06-18 21:50:00,AMD,BLR,180.0,213,91,-89,122,18,36,54,72,22,9,9,13,40,17,19,23,65,28,26,37,84,36,36,48,"{'F': 11, 'P': 7}","{'C': 14, 'J': 11, 'Z': 11}","{'Q': 16, 'R': 11, 'S': 5, 'T': 5, 'H': 11, 'M': 5}","{'Y': 5, 'A': 5, 'B': 3, 'D': 3, 'E': 3, 'G': 5, 'I': 3, 'K': 5, 'L': 3, 'N': 3, 'O': 3, 'U': 5, 'V': 3, 'W': 3, 'X': 3}"
INV-ZZ-6289949,SCH-ZZ-1122041,ZZ,ZZ20240620AMDBLR4957.0,4957.0,Airbus A320 Neo,06/20/2024,2024-06-20 10:19:00,2024-06-20 21:50:00,AMD,BLR,180.0,209,93,-87,116,18,36,54,72,21,9,9,12,40,18,18,22,64,28,26,36,81,36,36,45,"{'F': 11, 'P': 7}","{'C': 14, 'J': 11, 'Z': 11}","{'Q': 16, 'R': 11, 'S': 5, 'T': 5, 'H': 11, 'M': 5}","{'Y': 5, 'A': 5, 'B': 3, 'D': 3, 'E': 3, 'G': 5, 'I': 3, 'K': 5, 'L': 3, 'N': 3, 'O': 3, 'U': 5, 'V': 3, 'W': 3, 'X': 3}"
INV-ZZ-2762569,SCH-ZZ-1122041,ZZ,ZZ20240622AMDBLR4957.0,4957.0,Airbus A320 Neo,06/22/2024,2024-06-22 10:19:00,2024-06-22 21:50:00,AMD,BLR,180.0,206,94,-86,112,18,36,54,72,21,10,8,11,42,19,17,23,64,29,25,35,86,39,33,47,"{'F': 11, 'P': 7}","{'C': 14, 'J': 11, 'Z': 11}","{'Q': 16, 'R': 11, 'S': 5, 'T': 5, 'H': 11, 'M': 5}","{'Y': 5, 'A': 5, 'B': 3, 'D': 3, 'E': 3, 'G': 5, 'I': 3, 'K': 5, 'L': 3, 'N': 3, 'O': 3, 'U': 5, 'V': 3, 'W': 3, 'X': 3}"
INV-ZZ-3231825,SCH-ZZ-1122041,ZZ,ZZ20240623AMDBLR4957.0,4957.0,Airbus A320 Neo,06/23/2024,2024-06-23 10:19:00,2024-06-23 21:50:00,AMD,BLR,180.0,207,90,-90,117,18,36,54,72,20,9,9,11,41,18,18,23,64,28,26,36,85,37,35,48,"{'F': 11, 'P': 7}","{'C': 14, 'J': 11, 'Z': 11}","{'Q': 16, 'R': 11, 'S': 5, 'T': 5, 'H': 11, 'M': 5}","{'Y': 5, 'A': 5, 'B': 3, 'D': 3, 'E': 3, 'G': 5, 'I': 3, 'K': 5, 'L': 3, 'N': 3, 'O': 3, 'U': 5, 'V': 3, 'W': 3, 'X': 3}"
INV-ZZ-7426153,SCH-ZZ-1122041,ZZ,ZZ20240625AMDBLR4957.0,4957.0,Airbus A320 Neo,06/25/2024,2024-06-25 10:19:00,2024-06-25 21:50:00,AMD,BLR,180.0,208,82,-98,126,18,36,54,72,21,8,10,13,40,16,20,24,64,25,29,39,86,34,38,52,"{'F': 11, 'P': 7}","{'C': 14, 'J': 11, 'Z': 11}","{'Q': 16, 'R': 11, 'S': 5, 'T': 5, 'H': 11, 'M': 5}","{'Y': 5, 'A': 5, 'B': 3, 'D': 3, 'E': 3, 'G': 5, 'I': 3, 'K': 5, 'L': 3, 'N': 3, 'O': 3, 'U': 5, 'V': 3, 'W': 3, 'X': 3}"
INV-ZZ-8655546,SCH-ZZ-1122041,ZZ,ZZ20240627AMDBLR4957.0,4957.0,Airbus A320 Neo,06/27/2024,2024-06-27 10:19:00,2024-06-27 21:50:00,AMD,BLR,180.0,201,88,-92,113,18,36,54,72,20,9,9,11,43,19,17,24,61,27,27,34,86,38,34,48,"{'F': 11, 'P': 7}","{'C': 14, 'J': 11, 'Z': 11}","{'Q': 16, 'R': 11, 'S': 5, 'T': 5, 'H': 11, 'M': 5}","{'Y': 5, 'A': 5, 'B': 3, 'D': 3, 'E': 3, 'G': 5, 'I': 3, 'K': 5, 'L': 3, 'N': 3, 'O': 3, 'U': 5, 'V': 3, 'W': 3, 'X': 3}"
INV-ZZ-1725596,SCH-ZZ-1122041,ZZ,ZZ20240629AMDBLR4957.0,4957.0,Airbus A320 Neo,06/29/2024,2024-06-29 10:19:00,2024-06-29 21:50:00,AMD,BLR,180.0,209,79,-101,130,18,36,54,72,21,8,10,13,42,16,20,26,63,24,30,39,80,30,42,50,"{'F': 11, 'P': 7}","{'C': 14, 'J': 11, 'Z': 11}","{'Q': 16, 'R': 11, 'S': 5, 'T': 5, 'H': 11, 'M': 5}","{'Y': 5, 'A': 5, 'B': 3, 'D': 3, 'E': 3, 'G': 5, 'I': 3, 'K': 5, 'L': 3, 'N': 3, 'O': 3, 'U': 5, 'V': 3, 'W': 3, 'X': 3}"
INV-ZZ-3526492,SCH-ZZ-1122041,ZZ,ZZ20240630AMDBLR4957.0,4957.0,Airbus A320 Neo,06/30/2024,2024-06-30 10:19:00,2024-06-30 21:50:00,AMD,BLR,180.0,198,86,-94,112,18,36,54,72,20,9,9,11,42,18,18,24,64,28,26,36,86,37,35,49,"{'F': 11, 'P': 7}","{'C': 14, 'J': 11, 'Z': 11}","{'Q': 16, 'R': 11, 'S': 5, 'T': 5, 'H': 11, 'M': 5}","{'Y': 5, 'A': 5, 'B': 3, 'D': 3, 'E': 3, 'G': 5, 'I': 3, 'K': 5, 'L': 3, 'N': 3, 'O': 3, 'U': 5, 'V': 3, 'W': 3, 'X': 3}"
INV-ZZ-1832976,SCH-ZZ-6544056,ZZ,ZZ20240413BOMDEL3869.0,3869.0,BAe 146,04/13/2024,2024-04-13 07:20:00,2024-04-13 09:24:00,BOM,DEL,91.0,103,65,-26,38,9,18,27,36,10,6,3,4,20,13,5,7,30,19,8,11,43,27,9,16,"{'F': 5, 'P': 4}","{'C': 7, 'J': 5, 'Z': 5}","{'Q': 8, 'R': 5, 'S': 3, 'T': 3, 'H': 5, 'M': 3}","{'Y': 3, 'A': 3, 'B': 1, 'D': 1, 'E': 1, 'G': 3, 'I': 1, 'K': 3, 'L': 1, 'N': 1, 'O': 1, 'U': 3, 'V': 1, 'W': 1, 'X': 1}"
INV-ZZ-8737965,SCH-ZZ-6544056,ZZ,ZZ20240415BOMDEL3869.0,3869.0,BAe 146,04/15/2024,2024-04-15 07:20:00,2024-04-15 09:24:00,BOM,DEL,91.0,108,60,-31,48,9,18,27,36,10,6,3,4,21,12,6,9,31,17,10,14,41,23,13,18,"{'F': 5, 'P': 4}","{'C': 7, 'J': 5, 'Z': 5}","{'Q': 8, 'R': 5, 'S': 3, 'T': 3, 'H': 5, 'M': 3}","{'Y': 3, 'A': 3, 'B': 1, 'D': 1, 'E': 1, 'G': 3, 'I': 1, 'K': 3, 'L': 1, 'N': 1, 'O': 1, 'U': 3, 'V': 1, 'W': 1, 'X': 1}"
INV-ZZ-2335694,SCH-ZZ-6544056,ZZ,ZZ20240420BOMDEL3869.0,3869.0,BAe 146,04/20/2024,2024-04-20 07:20:00,2024-04-20 09:24:00,BOM,DEL,91.0,105,60,-31,45,9,18,27,36,10,6,3,4,21,12,6,9,32,18,9,14,42,24,12,18,"{'F': 5, 'P': 4}","{'C': 7, 'J': 5, 'Z': 5}","{'Q': 8, 'R': 5, 'S': 3, 'T': 3, 'H': 5, 'M': 3}","{'Y': 3, 'A': 3, 'B': 1, 'D': 1, 'E': 1, 'G': 3, 'I': 1, 'K': 3, 'L': 1, 'N': 1, 'O': 1, 'U': 3, 'V': 1, 'W': 1, 'X': 1}"
INV-ZZ-1957001,SCH-ZZ-6544056,ZZ,ZZ20240422BOMDEL3869.0,3869.0,BAe 146,04/22/2024,2024-04-22 07:20:00,2024-04-22 09:24:00,BOM,DEL,91.0,106,66,-25,40,9,18,27,36,11,7,2,4,22,14,4,8,30,19,8,11,42,26,10,16,"{'F': 5, 'P': 4}","{'C': 7, 'J': 5, 'Z': 5}","{'Q': 8, 'R': 5, 'S': 3, 'T': 3, 'H': 5, 'M': 3}","{'Y': 3, 'A': 3, 'B': 1, 'D': 1, 'E': 1, 'G': 3, 'I': 1, 'K': 3, 'L': 1, 'N': 1, 'O': 1, 'U': 3, 'V': 1, 'W': 1, 'X': 1}"
INV-ZZ-1660465,SCH-ZZ-6544056,ZZ,ZZ20240427BOMDEL3869.0,3869.0,BAe 146,04/27/2024,2024-04-27 07:20:00,2024-04-27 09:24:00,BOM,DEL,91.0,101,60,-31,41,9,18,27,36,10,6,3,4,20,12,6,8,30,18,9,12,43,26,10,17,"{'F': 5, 'P': 4}","{'C': 7, 'J': 5, 'Z': 5}","{'Q': 8, 'R': 5, 'S': 3, 'T': 3, 'H': 5, 'M': 3}","{'Y': 3, 'A': 3, 'B': 1, 'D': 1, 'E': 1, 'G': 3, 'I': 1, 'K': 3, 'L': 1, 'N': 1, 'O': 1, 'U': 3, 'V': 1, 'W': 1, 'X': 1}"
INV-ZZ-3315702,SCH-ZZ-6544056,ZZ,ZZ20240429BOMDEL3869.0,3869.0,BAe 146,04/29/2024,2024-04-29 07:20:00,2024-04-29 09:24:00,BOM,DEL,91.0,100,61,-30,39,9,18,27,36,10,6,3,4,21,13,5,8,32,19,8,13,42,26,10,16,"{'F': 5, 'P': 4}","{'C': 7, 'J': 5, 'Z': 5}","{'Q': 8, 'R': 5, 'S': 3, 'T': 3, 'H': 5, 'M': 3}","{'Y': 3, 'A': 3, 'B': 1, 'D': 1, 'E': 1, 'G': 3, 'I': 1, 'K': 3, 'L': 1, 'N': 1, 'O': 1, 'U': 3, 'V': 1, 'W': 1, 'X': 1}"
INV-ZZ-1000517,SCH-ZZ-6544056,ZZ,ZZ20240504BOMDEL3869.0,3869.0,BAe 146,05/04/2024,2024-05-04 07:20:00,2024-05-04 09:24:00,BOM,DEL,91.0,108,60,-31,48,9,18,27,36,10,6,3,4,21,12,6,9,30,17,10,13,43,24,12,19,"{'F': 5, 'P': 4}","{'C': 7, 'J': 5, 'Z': 5}","{'Q': 8, 'R': 5, 'S': 3, 'T': 3, 'H': 5, 'M': 3}","{'Y': 3, 'A': 3, 'B': 1, 'D': 1, 'E': 1, 'G': 3, 'I': 1, 'K': 3, 'L': 1, 'N': 1, 'O': 1, 'U': 3, 'V': 1, 'W': 1, 'X': 1}"
INV-ZZ-5235833,SCH-ZZ-6544056,ZZ,ZZ20240506BOMDEL3869.0,3869.0,BAe 146,05/06/2024,2024-05-06 07:20:00,2024-05-06 09:24:00,BOM,DEL,91.0,107,58,-33,49,9,18,27,36,11,6,3,5,22,12,6,10,31,17,10,14,43,23,13,20,"{'F': 5, 'P': 4}","{'C': 7, 'J': 5, 'Z': 5}","{'Q': 8, 'R': 5, 'S': 3, 'T': 3, 'H': 5, 'M': 3}","{'Y': 3, 'A': 3, 'B': 1, 'D': 1, 'E': 1, 'G': 3, 'I': 1, 'K': 3, 'L': 1, 'N': 1, 'O': 1, 'U': 3, 'V': 1, 'W': 1, 'X': 1}"
INV-ZZ-8531232,SCH-ZZ-6544056,ZZ,ZZ20240511BOMDEL3869.0,3869.0,BAe 146,05/11/2024,2024-05-11 07:20:00,2024-05-11 09:24:00,BOM,DEL,91.0,105,60,-31,45,9,18,27,36,11,6,3,5,20,11,7,9,32,18,9,14,41,23,13,18,"{'F': 5, 'P': 4}","{'C': 7, 'J': 5, 'Z': 5}","{'Q': 8, 'R': 5, 'S': 3, 'T': 3, 'H': 5, 'M': 3}","{'Y': 3, 'A': 3, 'B': 1, 'D': 1, 'E': 1, 'G': 3, 'I': 1, 'K': 3, 'L': 1, 'N': 1, 'O': 1, 'U': 3, 'V': 1, 'W': 1, 'X': 1}"
INV-ZZ-5211947,SCH-ZZ-6544056,ZZ,ZZ20240513BOMDEL3869.0,3869.0,BAe 146,05/13/2024,2024-05-13 07:20:00,2024-05-13 09:24:00,BOM,DEL,91.0,103,55,-36,48,9,18,27,36,10,5,4,5,21,11,7,10,31,16,11,15,42,22,14,20,"{'F': 5, 'P': 4}","{'C': 7, 'J': 5, 'Z': 5}","{'Q': 8, 'R': 5, 'S': 3, 'T': 3, 'H': 5, 'M': 3}","{'Y': 3, 'A': 3, 'B': 1, 'D': 1, 'E': 1, 'G': 3, 'I': 1, 'K': 3, 'L': 1, 'N': 1, 'O': 1, 'U': 3, 'V': 1, 'W': 1, 'X': 1}"
INV-ZZ-4607728,SCH-ZZ-6544056,ZZ,ZZ20240518BOMDEL3869.0,3869.0,BAe 146,05/18/2024,2024-05-18 07:20:00,2024-05-18 09:24:00,BOM,DEL,91.0,103,53,-38,50,9,18,27,36,10,5,4,5,20,10,8,10,32,16,11,16,40,21,15,19,"{'F': 5, 'P': 4}","{'C': 7, 'J': 5, 'Z': 5}","{'Q': 8, 'R': 5, 'S': 3, 'T': 3, 'H': 5, 'M': 3}","{'Y': 3, 'A': 3, 'B': 1, 'D': 1, 'E': 1, 'G': 3, 'I': 1, 'K': 3, 'L': 1, 'N': 1, 'O': 1, 'U': 3, 'V': 1, 'W': 1, 'X': 1}"
INV-ZZ-9723853,SCH-ZZ-6544056,ZZ,ZZ20240520BOMDEL3869.0,3869.0,BAe 146,05/20/2024,2024-05-20 07:20:00,2024-05-20 09:24:00,BOM,DEL,91.0,103,51,-40,52,9,18,27,36,10,5,4,5,21,10,8,11,31,15,12,16,42,21,15,21,"{'F': 5, 'P': 4}","{'C': 7, 'J': 5, 'Z': 5}","{'Q': 8, 'R': 5, 'S': 3, 'T': 3, 'H': 5, 'M': 3}","{'Y': 3, 'A': 3, 'B': 1, 'D': 1, 'E': 1, 'G': 3, 'I': 1, 'K': 3, 'L': 1, 'N': 1, 'O': 1, 'U': 3, 'V': 1, 'W': 1, 'X': 1}"
INV-ZZ-3797226,SCH-ZZ-6544056,ZZ,ZZ20240525BOMDEL3869.0,3869.0,BAe 146,05/25/2024,2024-05-25 07:20:00,2024-05-25 09:24:00,BOM,DEL,91.0,107,55,-36,52,9,18,27,36,10,5,4,5,21,11,7,10,32,17,10,15,42,22,14,20,"{'F': 5, 'P': 4}","{'C': 7, 'J': 5, 'Z': 5}","{'Q': 8, 'R': 5, 'S': 3, 'T': 3, 'H': 5, 'M': 3}","{'Y': 3, 'A': 3, 'B': 1, 'D': 1, 'E': 1, 'G': 3, 'I': 1, 'K': 3, 'L': 1, 'N': 1, 'O': 1, 'U': 3, 'V': 1, 'W': 1, 'X': 1}"
INV-ZZ-3445620,SCH-ZZ-6544056,ZZ,ZZ20240527BOMDEL3869.0,3869.0,BAe 146,05/27/2024,2024-05-27 07:20:00,2024-05-27 09:24:00,BOM,DEL,91.0,106,54,-37,52,9,18,27,36,10,5,4,5,21,11,7,10,31,16,11,15,43,22,14,21,"{'F': 5, 'P': 4}","{'C': 7, 'J': 5, 'Z': 5}","{'Q': 8, 'R': 5, 'S': 3, 'T': 3, 'H': 5, 'M': 3}","{'Y': 3, 'A': 3, 'B': 1, 'D': 1, 'E': 1, 'G': 3, 'I': 1, 'K': 3, 'L': 1, 'N': 1, 'O': 1, 'U': 3, 'V': 1, 'W': 1, 'X': 1}"
INV-ZZ-4423532,SCH-ZZ-4077056,ZZ,ZZ20240505BOMCCU3779.0,3779.0,Boeing 757,05/05/2024,2024-05-05 02:00:00,2024-05-05 08:13:00,BOM,CCU,209.0,234,126,-83,108,20,41,62,83,23,12,8,11,48,26,15,22,74,40,22,34,99,53,30,46,"{'F': 12, 'P': 8}","{'C': 16, 'J': 12, 'Z': 12}","{'Q': 19, 'R': 12, 'S': 6, 'T': 6, 'H': 12, 'M': 6}","{'Y': 6, 'A': 6, 'B': 3, 'D': 3, 'E': 3, 'G': 6, 'I': 3, 'K': 6, 'L': 3, 'N': 3, 'O': 3, 'U': 6, 'V': 3, 'W': 3, 'X': 3}"
INV-ZZ-5367297,SCH-ZZ-4077056,ZZ,ZZ20240509BOMCCU3779.0,3779.0,Boeing 757,05/09/2024,2024-05-09 02:00:00,2024-05-09 08:13:00,BOM,CCU,209.0,234,121,-88,113,20,41,62,83,23,12,8,11,48,25,16,23,70,36,26,34,96,50,33,46,"{'F': 12, 'P': 8}","{'C': 16, 'J': 12, 'Z': 12}","{'Q': 19, 'R': 12, 'S': 6, 'T': 6, 'H': 12, 'M': 6}","{'Y': 6, 'A': 6, 'B': 3, 'D': 3, 'E': 3, 'G': 6, 'I': 3, 'K': 6, 'L': 3, 'N': 3, 'O': 3, 'U': 6, 'V': 3, 'W': 3, 'X': 3}"
INV-ZZ-5147823,SCH-ZZ-4077056,ZZ,ZZ20240511BOMCCU3779.0,3779.0,Boeing 757,05/11/2024,2024-05-11 02:00:00,2024-05-11 08:13:00,BOM,CCU,209.0,241,122,-87,119,20,41,62,83,24,12,8,12,48,24,17,24,74,38,24,36,98,50,33,48,"{'F': 12, 'P': 8}","{'C': 16, 'J': 12, 'Z': 12}","{'Q': 19, 'R': 12, 'S': 6, 'T': 6, 'H': 12, 'M': 6}","{'Y': 6, 'A': 6, 'B': 3, 'D': 3, 'E': 3, 'G': 6, 'I': 3, 'K': 6, 'L': 3, 'N': 3, 'O': 3, 'U': 6, 'V': 3, 'W': 3, 'X': 3}"
INV-ZZ-9820856,SCH-ZZ-4077056,ZZ,ZZ20240512BOMCCU3779.0,3779.0,Boeing 757,05/12/2024,2024-05-12 02:00:00,2024-05-12 08:13:00,BOM,CCU,209.0,237,136,-73,101,20,41,62,83,24,14,6,10,49,28,13,21,74,42,20,32,92,53,30,39,"{'F': 12, 'P': 8}","{'C': 16, 'J': 12, 'Z': 12}","{'Q': 19, 'R': 12, 'S': 6, 'T': 6, 'H': 12, 'M': 6}","{'Y': 6, 'A': 6, 'B': 3, 'D': 3, 'E': 3, 'G': 6, 'I': 3, 'K': 6, 'L': 3, 'N': 3, 'O': 3, 'U': 6, 'V': 3, 'W': 3, 'X': 3}"
INV-ZZ-9262196,SCH-ZZ-4077056,ZZ,ZZ20240516BOMCCU3779.0,3779.0,Boeing 757,05/16/2024,2024-05-16 02:00:00,2024-05-16 08:13:00,BOM,CCU,209.0,231,115,-94,116,20,41,62,83,24,12,8,12,47,23,18,24,71,35,27,36,93,46,37,47,"{'F': 12, 'P': 8}","{'C': 16, 'J': 12, 'Z': 12}","{'Q': 19, 'R': 12, 'S': 6, 'T': 6, 'H': 12, 'M': 6}","{'Y': 6, 'A': 6, 'B': 3, 'D': 3, 'E': 3, 'G': 6, 'I': 3, 'K': 6, 'L': 3, 'N': 3, 'O': 3, 'U': 6, 'V': 3, 'W': 3, 'X': 3}"
INV-ZZ-1016335,SCH-ZZ-4077056,ZZ,ZZ20240518BOMCCU3779.0,3779.0,Boeing 757,05/18/2024,2024-05-18 02:00:00,2024-05-18 08:13:00,BOM,CCU,209.0,239,118,-91,121,20,41,62,83,24,12,8,12,46,23,18,23,73,36,26,37,92,46,37,46,"{'F': 12, 'P': 8}","{'C': 16, 'J': 12, 'Z': 12}","{'Q': 19, 'R': 12, 'S': 6, 'T': 6, 'H': 12, 'M': 6}","{'Y': 6, 'A': 6, 'B': 3, 'D': 3, 'E': 3, 'G': 6, 'I': 3, 'K': 6, 'L': 3, 'N': 3, 'O': 3, 'U': 6, 'V': 3, 'W': 3, 'X': 3}"
INV-ZZ-9834996,SCH-ZZ-4077056,ZZ,ZZ20240519BOMCCU3779.0,3779.0,Boeing 757,05/19/2024,2024-05-19 02:00:00,2024-05-19 08:13:00,BOM,CCU,209.0,243,124,-85,119,20,41,62,83,23,12,8,11,48,25,16,23,73,37,25,36,97,50,33,47,"{'F': 12, 'P': 8}","{'C': 16, 'J': 12, 'Z': 12}","{'Q': 19, 'R': 12, 'S': 6, 'T': 6, 'H': 12, 'M': 6}","{'Y': 6, 'A': 6, 'B': 3, 'D': 3, 'E': 3, 'G': 6, 'I': 3, 'K': 6, 'L': 3, 'N': 3, 'O': 3, 'U': 6, 'V': 3, 'W': 3, 'X': 3}"
INV-ZZ-9446221,SCH-ZZ-4077056,ZZ,ZZ20240523BOMCCU3779.0,3779.0,Boeing 757,05/23/2024,2024-05-23 02:00:00,2024-05-23 08:13:00,BOM,CCU,209.0,233,119,-90,114,20,41,62,83,23,12,8,11,48,24,17,24,69,35,27,34,92,47,36,45,"{'F': 12, 'P': 8}","{'C': 16, 'J': 12, 'Z': 12}","{'Q': 19, 'R': 12, 'S': 6, 'T': 6, 'H': 12, 'M': 6}","{'Y': 6, 'A': 6, 'B': 3, 'D': 3, 'E': 3, 'G': 6, 'I': 3, 'K': 6, 'L': 3, 'N': 3, 'O': 3, 'U': 6, 'V': 3, 'W': 3, 'X': 3}"
INV-ZZ-7241563,SCH-ZZ-4077056,ZZ,ZZ20240525BOMCCU3779.0,3779.0,Boeing 757,05/25/2024,2024-05-25 02:00:00,2024-05-25 08:13:00,BOM,CCU,209.0,233,124,-85,109,20,41,62,83,22,12,8,10,49,26,15,23,74,39,23,35,98,52,31,46,"{'F': 12, 'P': 8}","{'C': 16, 'J': 12, 'Z': 12}","{'Q': 19, 'R': 12, 'S': 6, 'T': 6, 'H': 12, 'M': 6}","{'Y': 6, 'A': 6, 'B': 3, 'D': 3, 'E': 3, 'G': 6, 'I': 3, 'K': 6, 'L': 3, 'N': 3, 'O': 3, 'U': 6, 'V': 3, 'W': 3, 'X': 3}"
INV-ZZ-8252333,SCH-ZZ-4077056,ZZ,ZZ20240526BOMCCU3779.0,3779.0,Boeing 757,05/26/2024,2024-05-26 02:00:00,2024-05-26 08:13:00,BOM,CCU,209.0,233,108,-101,125,20,41,62,83,23,11,9,12,45,21,20,24,74,34,28,40,91,42,41,49,"{'F': 12, 'P': 8}","{'C': 16, 'J': 12, 'Z': 12}","{'Q': 19, 'R': 12, 'S': 6, 'T': 6, 'H': 12, 'M': 6}","{'Y': 6, 'A': 6, 'B': 3, 'D': 3, 'E': 3, 'G': 6, 'I': 3, 'K': 6, 'L': 3, 'N': 3, 'O': 3, 'U': 6, 'V': 3, 'W': 3, 'X': 3}"
INV-ZZ-7155362,SCH-ZZ-4077056,ZZ,ZZ20240530BOMCCU3779.0,3779.0,Boeing 757,05/30/2024,2024-05-30 02:00:00,2024-05-30 08:13:00,BOM,CCU,209.0,234,119,-90,115,20,41,62,83,23,12,8,11,46,23,18,23,74,38,24,36,94,48,35,46,"{'F': 12, 'P': 8}","{'C': 16, 'J': 12, 'Z': 12}","{'Q': 19, 'R': 12, 'S': 6, 'T': 6, 'H': 12, 'M': 6}","{'Y': 6, 'A': 6, 'B': 3, 'D': 3, 'E': 3, 'G': 6, 'I': 3, 'K': 6, 'L': 3, 'N': 3, 'O': 3, 'U': 6, 'V': 3, 'W': 3, 'X': 3}"
INV-ZZ-1460147,SCH-ZZ-4077056,ZZ,ZZ20240601BOMCCU3779.0,3779.0,Boeing 757,06/01/2024,2024-06-01 02:00:00,2024-06-01 08:13:00,BOM,CCU,209.0,235,113,-96,122,20,41,62,83,24,12,8,12,46,22,19,24,68,33,29,35,99,48,35,51,"{'F': 12, 'P': 8}","{'C': 16, 'J': 12, 'Z': 12}","{'Q': 19, 'R': 12, 'S': 6, 'T': 6, 'H': 12, 'M': 6}","{'Y': 6, 'A': 6, 'B': 3, 'D': 3, 'E': 3, 'G': 6, 'I': 3, 'K': 6, 'L': 3, 'N': 3, 'O': 3, 'U': 6, 'V': 3, 'W': 3, 'X': 3}"
INV-ZZ-5798864,SCH-ZZ-4077056,ZZ,ZZ20240602BOMCCU3779.0,3779.0,Boeing 757,06/02/2024,2024-06-02 02:00:00,2024-06-02 08:13:00,BOM,CCU,209.0,238,114,-95,124,20,41,62,83,23,11,9,12,48,23,18,25,74,35,27,39,96,46,37,50,"{'F': 12, 'P': 8}","{'C': 16, 'J': 12, 'Z': 12}","{'Q': 19, 'R': 12, 'S': 6, 'T': 6, 'H': 12, 'M': 6}","{'Y': 6, 'A': 6, 'B': 3, 'D': 3, 'E': 3, 'G': 6, 'I': 3, 'K': 6, 'L': 3, 'N': 3, 'O': 3, 'U': 6, 'V': 3, 'W': 3, 'X': 3}"
INV-ZZ-3220256,SCH-ZZ-4077056,ZZ,ZZ20240606BOMCCU3779.0,3779.0,Boeing 757,06/06/2024,2024-06-06 02:00:00,2024-06-06 08:13:00,BOM,CCU,209.0,235,101,-108,134,20,41,62,83,23,10,10,13,46,20,21,26,70,30,32,40,98,42,41,56,"{'F': 12, 'P': 8}","{'C': 16, 'J': 12, 'Z': 12}","{'Q': 19, 'R': 12, 'S': 6, 'T': 6, 'H': 12, 'M': 6}","{'Y': 6, 'A': 6, 'B': 3, 'D': 3, 'E': 3, 'G': 6, 'I': 3, 'K': 6, 'L': 3, 'N': 3, 'O': 3, 'U': 6, 'V': 3, 'W': 3, 'X': 3}"
INV-ZZ-5077020,SCH-ZZ-4077056,ZZ,ZZ20240608BOMCCU3779.0,3779.0,Boeing 757,06/08/2024,2024-06-08 02:00:00,2024-06-08 08:13:00,BOM,CCU,209.0,237,108,-101,129,20,41,62,83,23,10,10,13,47,21,20,26,70,32,30,38,94,43,40,51,"{'F': 12, 'P': 8}","{'C': 16, 'J': 12, 'Z': 12}","{'Q': 19, 'R': 12, 'S': 6, 'T': 6, 'H': 12, 'M': 6}","{'Y': 6, 'A': 6, 'B': 3, 'D': 3, 'E': 3, 'G': 6, 'I': 3, 'K': 6, 'L': 3, 'N': 3, 'O': 3, 'U': 6, 'V': 3, 'W': 3, 'X': 3}"
INV-ZZ-2209518,SCH-ZZ-4077056,ZZ,ZZ20240609BOMCCU3779.0,3779.0,Boeing 757,06/09/2024,2024-06-09 02:00:00,2024-06-09 08:13:00,BOM,CCU,209.0,244,119,-90,125,20,41,62,83,23,11,9,12,49,24,17,25,70,34,28,36,95,46,37,49,"{'F': 12, 'P': 8}","{'C': 16, 'J': 12, 'Z': 12}","{'Q': 19, 'R': 12, 'S': 6, 'T': 6, 'H': 12, 'M': 6}","{'Y': 6, 'A': 6, 'B': 3, 'D': 3, 'E': 3, 'G': 6, 'I': 3, 'K': 6, 'L': 3, 'N': 3, 'O': 3, 'U': 6, 'V': 3, 'W': 3, 'X': 3}"
INV-ZZ-1538353,SCH-ZZ-4077056,ZZ,ZZ20240613BOMCCU3779.0,3779.0,Boeing 757,06/13/2024,2024-06-13 02:00:00,2024-06-13 08:13:00,BOM,CCU,209.0,237,105,-104,132,20,41,62,83,23,10,10,13,48,21,20,27,69,31,31,38,93,41,42,52,"{'F': 12, 'P': 8}","{'C': 16, 'J': 12, 'Z': 12}","{'Q': 19, 'R': 12, 'S': 6, 'T': 6, 'H': 12, 'M': 6}","{'Y': 6, 'A': 6, 'B': 3, 'D': 3, 'E': 3, 'G': 6, 'I': 3, 'K': 6, 'L': 3, 'N': 3, 'O': 3, 'U': 6, 'V': 3, 'W': 3, 'X': 3}"
INV-ZZ-6596573,SCH-ZZ-4077056,ZZ,ZZ20240615BOMCCU3779.0,3779.0,Boeing 757,06/15/2024,2024-06-15 02:00:00,2024-06-15 08:13:00,BOM,CCU,209.0,237,98,-111,139,20,41,62,83,23,9,11,14,49,20,21,29,70,29,33,41,98,40,43,58,"{'F': 12, 'P': 8}","{'C': 16, 'J': 12, 'Z': 12}","{'Q': 19, 'R': 12, 'S': 6, 'T': 6, 'H': 12, 'M': 6}","{'Y': 6, 'A': 6, 'B': 3, 'D': 3, 'E': 3, 'G': 6, 'I': 3, 'K': 6, 'L': 3, 'N': 3, 'O': 3, 'U': 6, 'V': 3, 'W': 3, 'X': 3}"
INV-ZZ-4831927,SCH-ZZ-4077056,ZZ,ZZ20240616BOMCCU3779.0,3779.0,Boeing 757,06/16/2024,2024-06-16 02:00:00,2024-06-16 08:13:00,BOM,CCU,209.0,249,118,-91,131,20,41,62,83,24,11,9,13,46,22,19,24,69,33,29,36,97,46,37,51,"{'F': 12, 'P': 8}","{'C': 16, 'J': 12, 'Z': 12}","{'Q': 19, 'R': 12, 'S': 6, 'T': 6, 'H': 12, 'M': 6}","{'Y': 6, 'A': 6, 'B': 3, 'D': 3, 'E': 3, 'G': 6, 'I': 3, 'K': 6, 'L': 3, 'N': 3, 'O': 3, 'U': 6, 'V': 3, 'W': 3, 'X': 3}"
INV-ZZ-7038387,SCH-ZZ-3750409,ZZ,ZZ20240407DELBOM4516.0,4516.0,Boeing 767,04/07/2024,2024-04-07 05:29:00,2024-04-07 15:51:00,DEL,BOM,278.0,324,205,-73,119,27,55,83,111,31,20,7,11,61,39,16,22,94,59,24,35,124,78,33,46,"{'F': 16, 'P': 11}","{'C': 22, 'J': 16, 'Z': 16}","{'Q': 25, 'R': 17, 'S': 8, 'T': 8, 'H': 17, 'M': 8}","{'Y': 8, 'A': 8, 'B': 4, 'D': 4, 'E': 4, 'G': 8, 'I': 4, 'K': 8, 'L': 4, 'N': 4, 'O': 4, 'U': 8, 'V': 4, 'W': 4, 'X': 4}"
INV-ZZ-2542418,SCH-ZZ-3750409,ZZ,ZZ20240408DELBOM4516.0,4516.0,Boeing 767,04/08/2024,2024-04-08 05:29:00,2024-04-08 15:51:00,DEL,BOM,278.0,323,191,-87,132,27,55,83,111,32,19,8,13,61,36,19,25,98,58,25,40,126,74,37,52,"{'F': 16, 'P': 11}","{'C': 22, 'J': 16, 'Z': 16}","{'Q': 25, 'R': 17, 'S': 8, 'T': 8, 'H': 17, 'M': 8}","{'Y': 8, 'A': 8, 'B': 4, 'D': 4, 'E': 4, 'G': 8, 'I': 4, 'K': 8, 'L': 4, 'N': 4, 'O': 4, 'U': 8, 'V': 4, 'W': 4, 'X': 4}"
INV-ZZ-3130158,SCH-ZZ-3750409,ZZ,ZZ20240414DELBOM4516.0,4516.0,Boeing 767,04/14/2024,2024-04-14 05:29:00,2024-04-14 15:51:00,DEL,BOM,278.0,317,183,-95,134,27,55,83,111,32,18,9,14,64,37,18,27,95,55,28,40,130,75,36,55,"{'F': 16, 'P': 11}","{'C': 22, 'J': 16, 'Z': 16}","{'Q': 25, 'R': 17, 'S': 8, 'T': 8, 'H': 17, 'M': 8}","{'Y': 8, 'A': 8, 'B': 4, 'D': 4, 'E': 4, 'G': 8, 'I': 4, 'K': 8, 'L': 4, 'N': 4, 'O': 4, 'U': 8, 'V': 4, 'W': 4, 'X': 4}"
INV-ZZ-7298975,SCH-ZZ-3750409,ZZ,ZZ20240415DELBOM4516.0,4516.0,Boeing 767,04/15/2024,2024-04-15 05:29:00,2024-04-15 15:51:00,DEL,BOM,278.0,306,171,-107,135,27,55,83,111,32,18,9,14,62,35,20,27,99,55,28,44,131,73,38,58,"{'F': 16, 'P': 11}","{'C': 22, 'J': 16, 'Z': 16}","{'Q': 25, 'R': 17, 'S': 8, 'T': 8, 'H': 17, 'M': 8}","{'Y': 8, 'A': 8, 'B': 4, 'D': 4, 'E': 4, 'G': 8, 'I': 4, 'K': 8, 'L': 4, 'N': 4, 'O': 4, 'U': 8, 'V': 4, 'W': 4, 'X': 4}"
INV-ZZ-4912470,SCH-ZZ-3750409,ZZ,ZZ20240421DELBOM4516.0,4516.0,Boeing 767,04/21/2024,2024-04-21 05:29:00,2024-04-21 15:51:00,DEL,BOM,278.0,332,203,-75,129,27,55,83,111,31,19,8,12,66,40,15,26,99,61,22,38,125,76,35,49,"{'F': 16, 'P': 11}","{'C': 22, 'J': 16, 'Z': 16}","{'Q': 25, 'R': 17, 'S': 8, 'T': 8, 'H': 17, 'M': 8}","{'Y': 8, 'A': 8, 'B': 4, 'D': 4, 'E': 4, 'G': 8, 'I': 4, 'K': 8, 'L': 4, 'N': 4, 'O': 4, 'U': 8, 'V': 4, 'W': 4, 'X': 4}"
INV-ZZ-1879246,SCH-ZZ-3750409,ZZ,ZZ20240422DELBOM4516.0,4516.0,Boeing 767,04/22/2024,2024-04-22 05:29:00,2024-04-22 15:51:00,DEL,BOM,278.0,318,193,-85,125,27,55,83,111,30,18,9,12,63,38,17,25,91,55,28,36,127,77,34,50,"{'F': 16, 'P': 11}","{'C': 22, 'J': 16, 'Z': 16}","{'Q': 25, 'R': 17, 'S': 8, 'T': 8, 'H': 17, 'M': 8}","{'Y': 8, 'A': 8, 'B': 4, 'D': 4, 'E': 4, 'G': 8, 'I': 4, 'K': 8, 'L': 4, 'N': 4, 'O': 4, 'U': 8, 'V': 4, 'W': 4, 'X': 4}"
INV-ZZ-8347065,SCH-ZZ-3750409,ZZ,ZZ20240428DELBOM4516.0,4516.0,Boeing 767,04/28/2024,2024-04-28 05:29:00,2024-04-28 15:51:00,DEL,BOM,278.0,319,167,-111,152,27,55,83,111,30,16,11,14,62,32,23,30,92,48,35,44,127,66,45,61,"{'F': 16, 'P': 11}","{'C': 22, 'J': 16, 'Z': 16}","{'Q': 25, 'R': 17, 'S': 8, 'T': 8, 'H': 17, 'M': 8}","{'Y': 8, 'A': 8, 'B': 4, 'D': 4, 'E': 4, 'G': 8, 'I': 4, 'K': 8, 'L': 4, 'N': 4, 'O': 4, 'U': 8, 'V': 4, 'W': 4, 'X': 4}"
INV-ZZ-5412428,SCH-ZZ-3750409,ZZ,ZZ20240429DELBOM4516.0,4516.0,Boeing 767,04/29/2024,2024-04-29 05:29:00,2024-04-29 15:51:00,DEL,BOM,278.0,333,193,-85,140,27,55,83,111,32,19,8,13,65,38,17,27,94,55,28,39,129,75,36,54,"{'F': 16, 'P': 11}","{'C': 22, 'J': 16, 'Z': 16}","{'Q': 25, 'R': 17, 'S': 8, 'T': 8, 'H': 17, 'M': 8}","{'Y': 8, 'A': 8, 'B': 4, 'D': 4, 'E': 4, 'G': 8, 'I': 4, 'K': 8, 'L': 4, 'N': 4, 'O': 4, 'U': 8, 'V': 4, 'W': 4, 'X': 4}"
INV-ZZ-7927425,SCH-ZZ-3750409,ZZ,ZZ20240505DELBOM4516.0,4516.0,Boeing 767,05/05/2024,2024-05-05 05:29:00,2024-05-05 15:51:00,DEL,BOM,278.0,308,166,-112,142,27,55,83,111,31,17,10,14,65,35,20,30,92,50,33,42,126,68,43,58,"{'F': 16, 'P': 11}","{'C': 22, 'J': 16, 'Z': 16}","{'Q': 25, 'R': 17, 'S': 8, 'T': 8, 'H': 17, 'M': 8}","{'Y': 8, 'A': 8, 'B': 4, 'D': 4, 'E': 4, 'G': 8, 'I': 4, 'K': 8, 'L': 4, 'N': 4, 'O': 4, 'U': 8, 'V': 4, 'W': 4, 'X': 4}"
INV-ZZ-4124286,SCH-ZZ-3750409,ZZ,ZZ20240506DELBOM4516.0,4516.0,Boeing 767,05/06/2024,2024-05-06 05:29:00,2024-05-06 15:51:00,DEL,BOM,278.0,330,177,-101,153,27,55,83,111,30,16,11,14,62,33,22,29,95,51,32,44,132,71,40,61,"{'F': 16, 'P': 11}","{'C': 22, 'J': 16, 'Z': 16}","{'Q': 25, 'R': 17, 'S': 8, 'T': 8, 'H': 17, 'M': 8}","{'Y': 8, 'A': 8, 'B': 4, 'D': 4, 'E': 4, 'G': 8, 'I': 4, 'K': 8, 'L': 4, 'N': 4, 'O': 4, 'U': 8, 'V': 4, 'W': 4, 'X': 4}"
INV-ZZ-4210156,SCH-ZZ-3750409,ZZ,ZZ20240512DELBOM4516.0,4516.0,Boeing 767,05/12/2024,2024-05-12 05:29:00,2024-05-12 15:51:00,DEL,BOM,278.0,308,160,-118,148,27,55,83,111,30,16,11,14,61,32,23,29,97,50,33,47,132,69,42,63,"{'F': 16, 'P': 11}","{'C': 22, 'J': 16, 'Z': 16}","{'Q': 25, 'R': 17, 'S': 8, 'T': 8, 'H': 17, 'M': 8}","{'Y': 8, 'A': 8, 'B': 4, 'D': 4, 'E': 4, 'G': 8, 'I': 4, 'K': 8, 'L': 4, 'N': 4, 'O': 4, 'U': 8, 'V': 4, 'W': 4, 'X': 4}"
INV-ZZ-3030409,SCH-ZZ-3750409,ZZ,ZZ20240513DELBOM4516.0,4516.0,Boeing 767,05/13/2024,2024-05-13 05:29:00,2024-05-13 15:51:00,DEL,BOM,278.0,319,172,-106,147,27,55,83,111,32,17,10,15,61,33,22,28,93,50,33,43,124,67,44,57,"{'F': 16, 'P': 11}","{'C': 22, 'J': 16, 'Z': 16}","{'Q': 25, 'R': 17, 'S': 8, 'T': 8, 'H': 17, 'M': 8}","{'Y': 8, 'A': 8, 'B': 4, 'D': 4, 'E': 4, 'G': 8, 'I': 4, 'K': 8, 'L': 4, 'N': 4, 'O': 4, 'U': 8, 'V': 4, 'W': 4, 'X': 4}"
INV-ZZ-4997236,SCH-ZZ-2590363,ZZ,ZZ20240416HYDDEL2294.0,2294.0,Boeing 757,04/16/2024,2024-04-16 06:49:00,2024-04-17 06:20:00,HYD,DEL,209.0,250,154,-55,96,20,41,62,83,24,15,5,9,49,30,11,19,70,43,19,27,93,57,26,36,"{'F': 12, 'P': 8}","{'C': 16, 'J': 12, 'Z': 12}","{'Q': 19, 'R': 12, 'S': 6, 'T': 6, 'H': 12, 'M': 6}","{'Y': 6, 'A': 6, 'B': 3, 'D': 3, 'E': 3, 'G': 6, 'I': 3, 'K': 6, 'L': 3, 'N': 3, 'O': 3, 'U': 6, 'V': 3, 'W': 3, 'X': 3}"
INV-ZZ-5227729,SCH-ZZ-2590363,ZZ,ZZ20240417HYDDEL2294.0,2294.0,Boeing 757,04/17/2024,2024-04-17 06:49:00,2024-04-18 06:20:00,HYD,DEL,209.0,243,146,-63,97,20,41,62,83,24,14,6,10,46,28,13,18,73,44,18,29,97,58,25,39,"{'F': 12, 'P': 8}","{'C': 16, 'J': 12, 'Z': 12}","{'Q': 19, 'R': 12, 'S': 6, 'T': 6, 'H': 12, 'M': 6}","{'Y': 6, 'A': 6, 'B': 3, 'D': 3, 'E': 3, 'G': 6, 'I': 3, 'K': 6, 'L': 3, 'N': 3, 'O': 3, 'U': 6, 'V': 3, 'W': 3, 'X': 3}"
INV-ZZ-8695088,SCH-ZZ-2590363,ZZ,ZZ20240418HYDDEL2294.0,2294.0,Boeing 757,04/18/2024,2024-04-18 06:49:00,2024-04-19 06:20:00,HYD,DEL,209.0,240,137,-72,103,20,41,62,83,22,13,7,9,45,26,15,19,71,40,22,31,97,55,28,42,"{'F': 12, 'P': 8}","{'C': 16, 'J': 12, 'Z': 12}","{'Q': 19, 'R': 12, 'S': 6, 'T': 6, 'H': 12, 'M': 6}","{'Y': 6, 'A': 6, 'B': 3, 'D': 3, 'E': 3, 'G': 6, 'I': 3, 'K': 6, 'L': 3, 'N': 3, 'O': 3, 'U': 6, 'V': 3, 'W': 3, 'X': 3}"
INV-ZZ-3158279,SCH-ZZ-2590363,ZZ,ZZ20240420HYDDEL2294.0,2294.0,Boeing 757,04/20/2024,2024-04-20 06:49:00,2024-04-21 06:20:00,HYD,DEL,209.0,246,135,-74,111,20,41,62,83,22,12,8,10,48,26,15,22,70,38,24,32,97,53,30,44,"{'F': 12, 'P': 8}","{'C': 16, 'J': 12, 'Z': 12}","{'Q': 19, 'R': 12, 'S': 6, 'T': 6, 'H': 12, 'M': 6}","{'Y': 6, 'A': 6, 'B': 3, 'D': 3, 'E': 3, 'G': 6, 'I': 3, 'K': 6, 'L': 3, 'N': 3, 'O': 3, 'U': 6, 'V': 3, 'W': 3, 'X': 3}"
INV-ZZ-2066666,SCH-ZZ-2590363,ZZ,ZZ20240423HYDDEL2294.0,2294.0,Boeing 757,04/23/2024,2024-04-23 06:49:00,2024-04-24 06:20:00,HYD,DEL,209.0,245,138,-71,107,20,41,62,83,24,14,6,10,49,28,13,21,70,39,23,31,99,56,27,43,"{'F': 12, 'P': 8}","{'C': 16, 'J': 12, 'Z': 12}","{'Q': 19, 'R': 12, 'S': 6, 'T': 6, 'H': 12, 'M': 6}","{'Y': 6, 'A': 6, 'B': 3, 'D': 3, 'E': 3, 'G': 6, 'I': 3, 'K': 6, 'L': 3, 'N': 3, 'O': 3, 'U': 6, 'V': 3, 'W': 3, 'X': 3}"
INV-ZZ-4464433,SCH-ZZ-2590363,ZZ,ZZ20240424HYDDEL2294.0,2294.0,Boeing 757,04/24/2024,2024-04-24 06:49:00,2024-04-25 06:20:00,HYD,DEL,209.0,230,128,-81,102,20,41,62,83,23,13,7,10,47,26,15,21,69,38,24,31,93,52,31,41,"{'F': 12, 'P': 8}","{'C': 16, 'J': 12, 'Z': 12}","{'Q': 19, 'R': 12, 'S': 6, 'T': 6, 'H': 12, 'M': 6}","{'Y': 6, 'A': 6, 'B': 3, 'D': 3, 'E': 3, 'G': 6, 'I': 3, 'K': 6, 'L': 3, 'N': 3, 'O': 3, 'U': 6, 'V': 3, 'W': 3, 'X': 3}"
INV-ZZ-2582994,SCH-ZZ-2590363,ZZ,ZZ20240425HYDDEL2294.0,2294.0,Boeing 757,04/25/2024,2024-04-25 06:49:00,2024-04-26 06:20:00,HYD,DEL,209.0,248,138,-71,110,20,41,62,83,24,13,7,11,46,26,15,20,69,39,23,30,99,55,28,44,"{'F': 12, 'P': 8}","{'C': 16, 'J': 12, 'Z': 12}","{'Q': 19, 'R': 12, 'S': 6, 'T': 6, 'H': 12, 'M': 6}","{'Y': 6, 'A': 6, 'B': 3, 'D': 3, 'E': 3, 'G': 6, 'I': 3, 'K': 6, 'L': 3, 'N': 3, 'O': 3, 'U': 6, 'V': 3, 'W': 3, 'X': 3}"
INV-ZZ-1079742,SCH-ZZ-2590363,ZZ,ZZ20240427HYDDEL2294.0,2294.0,Boeing 757,04/27/2024,2024-04-27 06:49:00,2024-04-28 06:20:00,HYD,DEL,209.0,245,149,-60,96,20,41,62,83,23,14,6,9,49,30,11,19,68,41,21,27,95,58,25,37,"{'F': 12, 'P': 8}","{'C': 16, 'J': 12, 'Z': 12}","{'Q': 19, 'R': 12, 'S': 6, 'T': 6, 'H': 12, 'M': 6}","{'Y': 6, 'A': 6, 'B': 3, 'D': 3, 'E': 3, 'G': 6, 'I': 3, 'K': 6, 'L': 3, 'N': 3, 'O': 3, 'U': 6, 'V': 3, 'W': 3, 'X': 3}"
INV-ZZ-4912791,SCH-ZZ-2590363,ZZ,ZZ20240430HYDDEL2294.0,2294.0,Boeing 757,04/30/2024,2024-04-30 06:49:00,2024-05-01 06:20:00,HYD,DEL,209.0,241,141,-68,100,20,41,62,83,23,13,7,10,47,28,13,19,69,40,22,29,99,58,25,41,"{'F': 12, 'P': 8}","{'C': 16, 'J': 12, 'Z': 12}","{'Q': 19, 'R': 12, 'S': 6, 'T': 6, 'H': 12, 'M': 6}","{'Y': 6, 'A': 6, 'B': 3, 'D': 3, 'E': 3, 'G': 6, 'I': 3, 'K': 6, 'L': 3, 'N': 3, 'O': 3, 'U': 6, 'V': 3, 'W': 3, 'X': 3}"
INV-ZZ-9950791,SCH-ZZ-2590363,ZZ,ZZ20240501HYDDEL2294.0,2294.0,Boeing 757,05/01/2024,2024-05-01 06:49:00,2024-05-02 06:20:00,HYD,DEL,209.0,231,137,-72,94,20,41,62,83,23,14,6,9,47,28,13,19,73,43,19,30,91,54,29,37,"{'F': 12, 'P': 8}","{'C': 16, 'J': 12, 'Z': 12}","{'Q': 19, 'R': 12, 'S': 6, 'T': 6, 'H': 12, 'M': 6}","{'Y': 6, 'A': 6, 'B': 3, 'D': 3, 'E': 3, 'G': 6, 'I': 3, 'K': 6, 'L': 3, 'N': 3, 'O': 3, 'U': 6, 'V': 3, 'W': 3, 'X': 3}"
INV-ZZ-9082600,SCH-ZZ-2590363,ZZ,ZZ20240502HYDDEL2294.0,2294.0,Boeing 757,05/02/2024,2024-05-02 06:49:00,2024-05-03 06:20:00,HYD,DEL,209.0,233,120,-89,113,20,41,62,83,23,12,8,11,49,25,16,24,73,38,24,35,95,49,34,46,"{'F': 12, 'P': 8}","{'C': 16, 'J': 12, 'Z': 12}","{'Q': 19, 'R': 12, 'S': 6, 'T': 6, 'H': 12, 'M': 6}","{'Y': 6, 'A': 6, 'B': 3, 'D': 3, 'E': 3, 'G': 6, 'I': 3, 'K': 6, 'L': 3, 'N': 3, 'O': 3, 'U': 6, 'V': 3, 'W': 3, 'X': 3}"
INV-ZZ-2832312,SCH-ZZ-2590363,ZZ,ZZ20240504HYDDEL2294.0,2294.0,Boeing 757,05/04/2024,2024-05-04 06:49:00,2024-05-05 06:20:00,HYD,DEL,209.0,238,141,-68,97,20,41,62,83,23,14,6,9,47,28,13,19,68,40,22,28,95,56,27,39,"{'F': 12, 'P': 8}","{'C': 16, 'J': 12, 'Z': 12}","{'Q': 19, 'R': 12, 'S': 6, 'T': 6, 'H': 12, 'M': 6}","{'Y': 6, 'A': 6, 'B': 3, 'D': 3, 'E': 3, 'G': 6, 'I': 3, 'K': 6, 'L': 3, 'N': 3, 'O': 3, 'U': 6, 'V': 3, 'W': 3, 'X': 3}"
INV-ZZ-4295592,SCH-ZZ-2590363,ZZ,ZZ20240507HYDDEL2294.0,2294.0,Boeing 757,05/07/2024,2024-05-07 06:49:00,2024-05-08 06:20:00,HYD,DEL,209.0,237,125,-84,112,20,41,62,83,24,13,7,11,48,25,16,23,69,36,26,33,93,49,34,44,"{'F': 12, 'P': 8}","{'C': 16, 'J': 12, 'Z': 12}","{'Q': 19, 'R': 12, 'S': 6, 'T': 6, 'H': 12, 'M': 6}","{'Y': 6, 'A': 6, 'B': 3, 'D': 3, 'E': 3, 'G': 6, 'I': 3, 'K': 6, 'L': 3, 'N': 3, 'O': 3, 'U': 6, 'V': 3, 'W': 3, 'X': 3}"
INV-ZZ-9625891,SCH-ZZ-2590363,ZZ,ZZ20240508HYDDEL2294.0,2294.0,Boeing 757,05/08/2024,2024-05-08 06:49:00,2024-05-09 06:20:00,HYD,DEL,209.0,250,140,-69,110,20,41,62,83,23,13,7,10,46,26,15,20,74,41,21,33,95,53,30,42,"{'F': 12, 'P': 8}","{'C': 16, 'J': 12, 'Z': 12}","{'Q': 19, 'R': 12, 'S': 6, 'T': 6, 'H': 12, 'M': 6}","{'Y': 6, 'A': 6, 'B': 3, 'D': 3, 'E': 3, 'G': 6, 'I': 3, 'K': 6, 'L': 3, 'N': 3, 'O': 3, 'U': 6, 'V': 3, 'W': 3, 'X': 3}"
INV-ZZ-4405303,SCH-ZZ-2590363,ZZ,ZZ20240509HYDDEL2294.0,2294.0,Boeing 757,05/09/2024,2024-05-09 06:49:00,2024-05-10 06:20:00,HYD,DEL,209.0,239,125,-84,114,20,41,62,83,22,11,9,11,48,25,16,23,70,37,25,33,95,50,33,45,"{'F': 12, 'P': 8}","{'C': 16, 'J': 12, 'Z': 12}","{'Q': 19, 'R': 12, 'S': 6, 'T': 6, 'H': 12, 'M': 6}","{'Y': 6, 'A': 6, 'B': 3, 'D': 3, 'E': 3, 'G': 6, 'I': 3, 'K': 6, 'L': 3, 'N': 3, 'O': 3, 'U': 6, 'V': 3, 'W': 3, 'X': 3}"
INV-ZZ-5147383,SCH-ZZ-2590363,ZZ,ZZ20240511HYDDEL2294.0,2294.0,Boeing 757,05/11/2024,2024-05-11 06:49:00,2024-05-12 06:20:00,HYD,DEL,209.0,232,124,-85,108,20,41,62,83,22,12,8,10,48,26,15,22,73,39,23,34,92,49,34,43,"{'F': 12, 'P': 8}","{'C': 16, 'J': 12, 'Z': 12}","{'Q': 19, 'R': 12, 'S': 6, 'T': 6, 'H': 12, 'M': 6}","{'Y': 6, 'A': 6, 'B': 3, 'D': 3, 'E': 3, 'G': 6, 'I': 3, 'K': 6, 'L': 3, 'N': 3, 'O': 3, 'U': 6, 'V': 3, 'W': 3, 'X': 3}"
INV-ZZ-6816736,SCH-ZZ-2590363,ZZ,ZZ20240514HYDDEL2294.0,2294.0,Boeing 757,05/14/2024,2024-05-14 06:49:00,2024-05-15 06:20:00,HYD,DEL,209.0,247,135,-74,112,20,41,62,83,22,12,8,10,46,25,16,21,71,39,23,32,99,54,29,45,"{'F': 12, 'P': 8}","{'C': 16, 'J': 12, 'Z': 12}","{'Q': 19, 'R': 12, 'S': 6, 'T': 6, 'H': 12, 'M': 6}","{'Y': 6, 'A': 6, 'B': 3, 'D': 3, 'E': 3, 'G': 6, 'I': 3, 'K': 6, 'L': 3, 'N': 3, 'O': 3, 'U': 6, 'V': 3, 'W': 3, 'X': 3}"
INV-ZZ-9272887,SCH-ZZ-2590363,ZZ,ZZ20240515HYDDEL2294.0,2294.0,Boeing 757,05/15/2024,2024-05-15 06:49:00,2024-05-16 06:20:00,HYD,DEL,209.0,248,129,-80,119,20,41,62,83,23,12,8,11,49,26,15,23,69,36,26,33,97,51,32,46,"{'F': 12, 'P': 8}","{'C': 16, 'J': 12, 'Z': 12}","{'Q': 19, 'R': 12, 'S': 6, 'T': 6, 'H': 12, 'M': 6}","{'Y': 6, 'A': 6, 'B': 3, 'D': 3, 'E': 3, 'G': 6, 'I': 3, 'K': 6, 'L': 3, 'N': 3, 'O': 3, 'U': 6, 'V': 3, 'W': 3, 'X': 3}"
INV-ZZ-6388155,SCH-ZZ-2590363,ZZ,ZZ20240516HYDDEL2294.0,2294.0,Boeing 757,05/16/2024,2024-05-16 06:49:00,2024-05-17 06:20:00,HYD,DEL,209.0,240,115,-94,125,20,41,62,83,24,12,8,12,48,23,18,25,71,34,28,37,95,46,37,49,"{'F': 12, 'P': 8}","{'C': 16, 'J': 12, 'Z': 12}","{'Q': 19, 'R': 12, 'S': 6, 'T': 6, 'H': 12, 'M': 6}","{'Y': 6, 'A': 6, 'B': 3, 'D': 3, 'E': 3, 'G': 6, 'I': 3, 'K': 6, 'L': 3, 'N': 3, 'O': 3, 'U': 6, 'V': 3, 'W': 3, 'X': 3}"
INV-ZZ-3418294,SCH-ZZ-2590363,ZZ,ZZ20240518HYDDEL2294.0,2294.0,Boeing 757,05/18/2024,2024-05-18 06:49:00,2024-05-19 06:20:00,HYD,DEL,209.0,235,120,-90,116,20,41,62,83,23,12,8,11,46,23,18,23,71,36,26,35,98,50,33,48,"{'F': 12, 'P': 8}","{'C': 16, 'J': 12, 'Z': 12}","{'Q': 19, 'R': 12, 'S': 6, 'T': 6, 'H': 12, 'M': 6}","{'Y': 6, 'A': 6, 'B': 3, 'D': 3, 'E': 3, 'G': 6, 'I': 3, 'K': 6, 'L': 3, 'N': 3, 'O': 3, 'U': 6, 'V': 3, 'W': 3, 'X': 3}"
INV-ZZ-4546145,SCH-ZZ-2590363,ZZ,ZZ20240521HYDDEL2294.0,2294.0,Boeing 757,05/21/2024,2024-05-21 06:49:00,2024-05-22 06:20:00,HYD,DEL,209.0,248,118,-91,130,20,41,62,83,24,11,9,13,48,23,18,25,74,35,27,39,99,47,36,52,"{'F': 12, 'P': 8}","{'C': 16, 'J': 12, 'Z': 12}","{'Q': 19, 'R': 12, 'S': 6, 'T': 6, 'H': 12, 'M': 6}","{'Y': 6, 'A': 6, 'B': 3, 'D': 3, 'E': 3, 'G': 6, 'I': 3, 'K': 6, 'L': 3, 'N': 3, 'O': 3, 'U': 6, 'V': 3, 'W': 3, 'X': 3}"
INV-ZZ-5805975,SCH-ZZ-2590363,ZZ,ZZ20240522HYDDEL2294.0,2294.0,Boeing 757,05/22/2024,2024-05-22 06:49:00,2024-05-23 06:20:00,HYD,DEL,209.0,242,113,-96,129,20,41,62,83,24,11,9,13,49,23,18,26,71,33,29,38,96,45,38,51,"{'F': 12, 'P': 8}","{'C': 16, 'J': 12, 'Z': 12}","{'Q': 19, 'R': 12, 'S': 6, 'T': 6, 'H': 12, 'M': 6}","{'Y': 6, 'A': 6, 'B': 3, 'D': 3, 'E': 3, 'G': 6, 'I': 3, 'K': 6, 'L': 3, 'N': 3, 'O': 3, 'U': 6, 'V': 3, 'W': 3, 'X': 3}"
INV-ZZ-1560998,SCH-ZZ-2590363,ZZ,ZZ20240523HYDDEL2294.0,2294.0,Boeing 757,05/23/2024,2024-05-23 06:49:00,2024-05-24 06:20:00,HYD,DEL,209.0,243,130,-79,113,20,41,62,83,23,12,8,11,48,26,15,22,73,39,23,34,93,50,33,43,"{'F': 12, 'P': 8}","{'C': 16, 'J': 12, 'Z': 12}","{'Q': 19, 'R': 12, 'S': 6, 'T': 6, 'H': 12, 'M': 6}","{'Y': 6, 'A': 6, 'B': 3, 'D': 3, 'E': 3, 'G': 6, 'I': 3, 'K': 6, 'L': 3, 'N': 3, 'O': 3, 'U': 6, 'V': 3, 'W': 3, 'X': 3}"
INV-ZZ-8191380,SCH-ZZ-2590363,ZZ,ZZ20240525HYDDEL2294.0,2294.0,Boeing 757,05/25/2024,2024-05-25 06:49:00,2024-05-26 06:20:00,HYD,DEL,209.0,249,125,-84,124,20,41,62,83,23,12,8,11,46,23,18,23,69,35,27,34,94,47,36,47,"{'F': 12, 'P': 8}","{'C': 16, 'J': 12, 'Z': 12}","{'Q': 19, 'R': 12, 'S': 6, 'T': 6, 'H': 12, 'M': 6}","{'Y': 6, 'A': 6, 'B': 3, 'D': 3, 'E': 3, 'G': 6, 'I': 3, 'K': 6, 'L': 3, 'N': 3, 'O': 3, 'U': 6, 'V': 3, 'W': 3, 'X': 3}"
INV-ZZ-8615689,SCH-ZZ-2590363,ZZ,ZZ20240528HYDDEL2294.0,2294.0,Boeing 757,05/28/2024,2024-05-28 06:49:00,2024-05-29 06:20:00,HYD,DEL,209.0,248,120,-89,128,20,41,62,83,23,11,9,12,49,24,17,25,74,36,26,38,93,45,38,48,"{'F': 12, 'P': 8}","{'C': 16, 'J': 12, 'Z': 12}","{'Q': 19, 'R': 12, 'S': 6, 'T': 6, 'H': 12, 'M': 6}","{'Y': 6, 'A': 6, 'B': 3, 'D': 3, 'E': 3, 'G': 6, 'I': 3, 'K': 6, 'L': 3, 'N': 3, 'O': 3, 'U': 6, 'V': 3, 'W': 3, 'X': 3}"
INV-ZZ-3848267,SCH-ZZ-2590363,ZZ,ZZ20240529HYDDEL2294.0,2294.0,Boeing 757,05/29/2024,2024-05-29 06:49:00,2024-05-30 06:20:00,HYD,DEL,209.0,243,118,-91,125,20,41,62,83,22,11,9,11,45,22,19,23,69,33,29,36,99,48,35,51,"{'F': 12, 'P': 8}","{'C': 16, 'J': 12, 'Z': 12}","{'Q': 19, 'R': 12, 'S': 6, 'T': 6, 'H': 12, 'M': 6}","{'Y': 6, 'A': 6, 'B': 3, 'D': 3, 'E': 3, 'G': 6, 'I': 3, 'K': 6, 'L': 3, 'N': 3, 'O': 3, 'U': 6, 'V': 3, 'W': 3, 'X': 3}"
INV-ZZ-6782920,SCH-ZZ-2590363,ZZ,ZZ20240530HYDDEL2294.0,2294.0,Boeing 757,05/30/2024,2024-05-30 06:49:00,2024-05-31 06:20:00,HYD,DEL,209.0,241,123,-86,118,20,41,62,83,24,12,8,12,49,25,16,24,69,35,27,34,99,51,32,48,"{'F': 12, 'P': 8}","{'C': 16, 'J': 12, 'Z': 12}","{'Q': 19, 'R': 12, 'S': 6, 'T': 6, 'H': 12, 'M': 6}","{'Y': 6, 'A': 6, 'B': 3, 'D': 3, 'E': 3, 'G': 6, 'I': 3, 'K': 6, 'L': 3, 'N': 3, 'O': 3, 'U': 6, 'V': 3, 'W': 3, 'X': 3}"
INV-ZZ-8692434,SCH-ZZ-3706305,ZZ,ZZ20240501MAAAMD2840.0,2840.0,Airbus A321 Neo,05/01/2024,2024-05-01 14:07:00,2024-05-02 13:37:00,MAA,AMD,220.0,242,140,-80,102,22,44,66,88,24,14,8,10,51,30,14,21,76,44,22,32,102,59,29,43,"{'F': 13, 'P': 9}","{'C': 18, 'J': 13, 'Z': 13}","{'Q': 20, 'R': 13, 'S': 7, 'T': 7, 'H': 13, 'M': 7}","{'Y': 7, 'A': 7, 'B': 3, 'D': 3, 'E': 3, 'G': 7, 'I': 3, 'K': 7, 'L': 3, 'N': 3, 'O': 3, 'U': 7, 'V': 3, 'W': 3, 'X': 3}"
INV-ZZ-4704803,SCH-ZZ-3706305,ZZ,ZZ20240503MAAAMD2840.0,2840.0,Airbus A321 Neo,05/03/2024,2024-05-03 14:07:00,2024-05-04 13:37:00,MAA,AMD,220.0,244,142,-78,102,22,44,66,88,25,15,7,10,51,30,14,21,77,45,21,32,102,60,28,42,"{'F': 13, 'P': 9}","{'C': 18, 'J': 13, 'Z': 13}","{'Q': 20, 'R': 13, 'S': 7, 'T': 7, 'H': 13, 'M': 7}","{'Y': 7, 'A': 7, 'B': 3, 'D': 3, 'E': 3, 'G': 7, 'I': 3, 'K': 7, 'L': 3, 'N': 3, 'O': 3, 'U': 7, 'V': 3, 'W': 3, 'X': 3}"
INV-ZZ-9030530,SCH-ZZ-3706305,ZZ,ZZ20240505MAAAMD2840.0,2840.0,Airbus A321 Neo,05/05/2024,2024-05-05 14:07:00,2024-05-06 13:37:00,MAA,AMD,220.0,258,133,-87,125,22,44,66,88,26,13,9,13,48,25,19,23,76,39,27,37,98,51,37,47,"{'F': 13, 'P': 9}","{'C': 18, 'J': 13, 'Z': 13}","{'Q': 20, 'R': 13, 'S': 7, 'T': 7, 'H': 13, 'M': 7}","{'Y': 7, 'A': 7, 'B': 3, 'D': 3, 'E': 3, 'G': 7, 'I': 3, 'K': 7, 'L': 3, 'N': 3, 'O': 3, 'U': 7, 'V': 3, 'W': 3, 'X': 3}"
INV-ZZ-1493405,SCH-ZZ-3706305,ZZ,ZZ20240508MAAAMD2840.0,2840.0,Airbus A321 Neo,05/08/2024,2024-05-08 14:07:00,2024-05-09 13:37:00,MAA,AMD,220.0,257,147,-73,110,22,44,66,88,26,15,7,11,51,29,15,22,74,42,24,32,98,56,32,42,"{'F': 13, 'P': 9}","{'C': 18, 'J': 13, 'Z': 13}","{'Q': 20, 'R': 13, 'S': 7, 'T': 7, 'H': 13, 'M': 7}","{'Y': 7, 'A': 7, 'B': 3, 'D': 3, 'E': 3, 'G': 7, 'I': 3, 'K': 7, 'L': 3, 'N': 3, 'O': 3, 'U': 7, 'V': 3, 'W': 3, 'X': 3}"
INV-ZZ-8582319,SCH-ZZ-3706305,ZZ,ZZ20240510MAAAMD2840.0,2840.0,Airbus A321 Neo,05/10/2024,2024-05-10 14:07:00,2024-05-11 13:37:00,MAA,AMD,220.0,249,132,-88,117,22,44,66,88,25,13,9,12,50,27,17,23,75,40,26,35,101,54,34,47,"{'F': 13, 'P': 9}","{'C': 18, 'J': 13, 'Z': 13}","{'Q': 20, 'R': 13, 'S': 7, 'T': 7, 'H': 13, 'M': 7}","{'Y': 7, 'A': 7, 'B': 3, 'D': 3, 'E': 3, 'G': 7, 'I': 3, 'K': 7, 'L': 3, 'N': 3, 'O': 3, 'U': 7, 'V': 3, 'W': 3, 'X': 3}"
INV-ZZ-2146586,SCH-ZZ-3706305,ZZ,ZZ20240512MAAAMD2840.0,2840.0,Airbus A321 Neo,05/12/2024,2024-05-12 14:07:00,2024-05-13 13:37:00,MAA,AMD,220.0,262,130,-90,132,22,44,66,88,25,12,10,13,50,25,19,25,78,39,27,39,104,52,36,52,"{'F': 13, 'P': 9}","{'C': 18, 'J': 13, 'Z': 13}","{'Q': 20, 'R': 13, 'S': 7, 'T': 7, 'H': 13, 'M': 7}","{'Y': 7, 'A': 7, 'B': 3, 'D': 3, 'E': 3, 'G': 7, 'I': 3, 'K': 7, 'L': 3, 'N': 3, 'O': 3, 'U': 7, 'V': 3, 'W': 3, 'X': 3}"
INV-ZZ-3183513,SCH-ZZ-3706305,ZZ,ZZ20240515MAAAMD2840.0,2840.0,Airbus A321 Neo,05/15/2024,2024-05-15 14:07:00,2024-05-16 13:37:00,MAA,AMD,220.0,245,137,-83,108,22,44,66,88,25,14,8,11,49,27,17,22,73,41,25,32,102,57,31,45,"{'F': 13, 'P': 9}","{'C': 18, 'J': 13, 'Z': 13}","{'Q': 20, 'R': 13, 'S': 7, 'T': 7, 'H': 13, 'M': 7}","{'Y': 7, 'A': 7, 'B': 3, 'D': 3, 'E': 3, 'G': 7, 'I': 3, 'K': 7, 'L': 3, 'N': 3, 'O': 3, 'U': 7, 'V': 3, 'W': 3, 'X': 3}"
INV-ZZ-4707629,SCH-ZZ-3706305,ZZ,ZZ20240517MAAAMD2840.0,2840.0,Airbus A321 Neo,05/17/2024,2024-05-17 14:07:00,2024-05-18 13:37:00,MAA,AMD,220.0,254,128,-92,126,22,44,66,88,26,13,9,13,51,26,18,25,77,39,27,38,101,51,37,50,"{'F': 13, 'P': 9}","{'C': 18, 'J': 13, 'Z': 13}","{'Q': 20, 'R': 13, 'S': 7, 'T': 7, 'H': 13, 'M': 7}","{'Y': 7, 'A': 7, 'B': 3, 'D': 3, 'E': 3, 'G': 7, 'I': 3, 'K': 7, 'L': 3, 'N': 3, 'O': 3, 'U': 7, 'V': 3, 'W': 3, 'X': 3}"
INV-ZZ-5398369,SCH-ZZ-3706305,ZZ,ZZ20240519MAAAMD2840.0,2840.0,Airbus A321 Neo,05/19/2024,2024-05-19 14:07:00,2024-05-20 13:37:00,MAA,AMD,220.0,253,137,-83,116,22,44,66,88,26,14,8,12,52,28,16,24,73,40,26,33,104,57,31,47,"{'F': 13, 'P': 9}","{'C': 18, 'J': 13, 'Z': 13}","{'Q': 20, 'R': 13, 'S': 7, 'T': 7, 'H': 13, 'M': 7}","{'Y': 7, 'A': 7, 'B': 3, 'D': 3, 'E': 3, 'G': 7, 'I': 3, 'K': 7, 'L': 3, 'N': 3, 'O': 3, 'U': 7, 'V': 3, 'W': 3, 'X': 3}"
INV-ZZ-2249818,SCH-ZZ-3706305,ZZ,ZZ20240522MAAAMD2840.0,2840.0,Airbus A321 Neo,05/22/2024,2024-05-22 14:07:00,2024-05-23 13:37:00,MAA,AMD,220.0,243,123,-97,120,22,44,66,88,26,13,9,13,53,27,17,26,79,40,26,39,97,49,39,48,"{'F': 13, 'P': 9}","{'C': 18, 'J': 13, 'Z': 13}","{'Q': 20, 'R': 13, 'S': 7, 'T': 7, 'H': 13, 'M': 7}","{'Y': 7, 'A': 7, 'B': 3, 'D': 3, 'E': 3, 'G': 7, 'I': 3, 'K': 7, 'L': 3, 'N': 3, 'O': 3, 'U': 7, 'V': 3, 'W': 3, 'X': 3}"
INV-ZZ-4148207,SCH-ZZ-3706305,ZZ,ZZ20240524MAAAMD2840.0,2840.0,Airbus A321 Neo,05/24/2024,2024-05-24 14:07:00,2024-05-25 13:37:00,MAA,AMD,220.0,258,125,-95,133,22,44,66,88,26,13,9,13,51,25,19,26,76,37,29,39,105,51,37,54,"{'F': 13, 'P': 9}","{'C': 18, 'J': 13, 'Z': 13}","{'Q': 20, 'R': 13, 'S': 7, 'T': 7, 'H': 13, 'M': 7}","{'Y': 7, 'A': 7, 'B': 3, 'D': 3, 'E': 3, 'G': 7, 'I': 3, 'K': 7, 'L': 3, 'N': 3, 'O': 3, 'U': 7, 'V': 3, 'W': 3, 'X': 3}"
INV-ZZ-4538996,SCH-ZZ-3706305,ZZ,ZZ20240526MAAAMD2840.0,2840.0,Airbus A321 Neo,05/26/2024,2024-05-26 14:07:00,2024-05-27 13:37:00,MAA,AMD,220.0,260,138,-82,122,22,44,66,88,25,13,9,12,49,26,18,23,77,41,25,36,97,52,36,45,"{'F': 13, 'P': 9}","{'C': 18, 'J': 13, 'Z': 13}","{'Q': 20, 'R': 13, 'S': 7, 'T': 7, 'H': 13, 'M': 7}","{'Y': 7, 'A': 7, 'B': 3, 'D': 3, 'E': 3, 'G': 7, 'I': 3, 'K': 7, 'L': 3, 'N': 3, 'O': 3, 'U': 7, 'V': 3, 'W': 3, 'X': 3}"
INV-ZZ-6949959,SCH-ZZ-3706305,ZZ,ZZ20240529MAAAMD2840.0,2840.0,Airbus A321 Neo,05/29/2024,2024-05-29 14:07:00,2024-05-30 13:37:00,MAA,AMD,220.0,250,114,-106,136,22,44,66,88,25,11,11,14,51,23,21,28,78,36,30,42,103,47,41,56,"{'F': 13, 'P': 9}","{'C': 18, 'J': 13, 'Z': 13}","{'Q': 20, 'R': 13, 'S': 7, 'T': 7, 'H': 13, 'M': 7}","{'Y': 7, 'A': 7, 'B': 3, 'D': 3, 'E': 3, 'G': 7, 'I': 3, 'K': 7, 'L': 3, 'N': 3, 'O': 3, 'U': 7, 'V': 3, 'W': 3, 'X': 3}"
INV-ZZ-2231378,SCH-ZZ-3706305,ZZ,ZZ20240531MAAAMD2840.0,2840.0,Airbus A321 Neo,05/31/2024,2024-05-31 14:07:00,2024-06-01 13:37:00,MAA,AMD,220.0,251,129,-91,122,22,44,66,88,24,12,10,12,51,26,18,25,73,38,28,35,103,53,35,50,"{'F': 13, 'P': 9}","{'C': 18, 'J': 13, 'Z': 13}","{'Q': 20, 'R': 13, 'S': 7, 'T': 7, 'H': 13, 'M': 7}","{'Y': 7, 'A': 7, 'B': 3, 'D': 3, 'E': 3, 'G': 7, 'I': 3, 'K': 7, 'L': 3, 'N': 3, 'O': 3, 'U': 7, 'V': 3, 'W': 3, 'X': 3}"
INV-ZZ-6034445,SCH-ZZ-3706305,ZZ,ZZ20240602MAAAMD2840.0,2840.0,Airbus A321 Neo,06/02/2024,2024-06-02 14:07:00,2024-06-03 13:37:00,MAA,AMD,220.0,244,120,-100,124,22,44,66,88,24,12,10,12,53,26,18,27,78,38,28,40,103,51,37,52,"{'F': 13, 'P': 9}","{'C': 18, 'J': 13, 'Z': 13}","{'Q': 20, 'R': 13, 'S': 7, 'T': 7, 'H': 13, 'M': 7}","{'Y': 7, 'A': 7, 'B': 3, 'D': 3, 'E': 3, 'G': 7, 'I': 3, 'K': 7, 'L': 3, 'N': 3, 'O': 3, 'U': 7, 'V': 3, 'W': 3, 'X': 3}"
INV-ZZ-5884860,SCH-ZZ-3706305,ZZ,ZZ20240605MAAAMD2840.0,2840.0,Airbus A321 Neo,06/05/2024,2024-06-05 14:07:00,2024-06-06 13:37:00,MAA,AMD,220.0,245,117,-103,128,22,44,66,88,25,12,10,13,51,24,20,27,78,37,29,41,99,47,41,52,"{'F': 13, 'P': 9}","{'C': 18, 'J': 13, 'Z': 13}","{'Q': 20, 'R': 13, 'S': 7, 'T': 7, 'H': 13, 'M': 7}","{'Y': 7, 'A': 7, 'B': 3, 'D': 3, 'E': 3, 'G': 7, 'I': 3, 'K': 7, 'L': 3, 'N': 3, 'O': 3, 'U': 7, 'V': 3, 'W': 3, 'X': 3}"
INV-ZZ-7451319,SCH-ZZ-3706305,ZZ,ZZ20240607MAAAMD2840.0,2840.0,Airbus A321 Neo,06/07/2024,2024-06-07 14:07:00,2024-06-08 13:37:00,MAA,AMD,220.0,258,111,-109,147,22,44,66,88,24,10,12,14,49,21,23,28,79,34,32,45,102,44,44,58,"{'F': 13, 'P': 9}","{'C': 18, 'J': 13, 'Z': 13}","{'Q': 20, 'R': 13, 'S': 7, 'T': 7, 'H': 13, 'M': 7}","{'Y': 7, 'A': 7, 'B': 3, 'D': 3, 'E': 3, 'G': 7, 'I': 3, 'K': 7, 'L': 3, 'N': 3, 'O': 3, 'U': 7, 'V': 3, 'W': 3, 'X': 3}"
INV-ZZ-2853185,SCH-ZZ-3706305,ZZ,ZZ20240609MAAAMD2840.0,2840.0,Airbus A321 Neo,06/09/2024,2024-06-09 14:07:00,2024-06-10 13:37:00,MAA,AMD,220.0,250,107,-113,143,22,44,66,88,26,11,11,15,49,21,23,28,78,34,32,44,102,44,44,58,"{'F': 13, 'P': 9}","{'C': 18, 'J': 13, 'Z': 13}","{'Q': 20, 'R': 13, 'S': 7, 'T': 7, 'H': 13, 'M': 7}","{'Y': 7, 'A': 7, 'B': 3, 'D': 3, 'E': 3, 'G': 7, 'I': 3, 'K': 7, 'L': 3, 'N': 3, 'O': 3, 'U': 7, 'V': 3, 'W': 3, 'X': 3}"
INV-ZZ-2115049,SCH-ZZ-3706305,ZZ,ZZ20240612MAAAMD2840.0,2840.0,Airbus A321 Neo,06/12/2024,2024-06-12 14:07:00,2024-06-13 13:37:00,MAA,AMD,220.0,262,114,-106,148,22,44,66,88,25,11,11,14,51,22,22,29,73,32,34,41,106,46,42,60,"{'F': 13, 'P': 9}","{'C': 18, 'J': 13, 'Z': 13}","{'Q': 20, 'R': 13, 'S': 7, 'T': 7, 'H': 13, 'M': 7}","{'Y': 7, 'A': 7, 'B': 3, 'D': 3, 'E': 3, 'G': 7, 'I': 3, 'K': 7, 'L': 3, 'N': 3, 'O': 3, 'U': 7, 'V': 3, 'W': 3, 'X': 3}"
INV-ZZ-5468743,SCH-ZZ-3706305,ZZ,ZZ20240614MAAAMD2840.0,2840.0,Airbus A321 Neo,06/14/2024,2024-06-14 14:07:00,2024-06-15 13:37:00,MAA,AMD,220.0,252,106,-114,146,22,44,66,88,26,11,11,15,49,21,23,28,76,32,34,44,97,41,47,56,"{'F': 13, 'P': 9}","{'C': 18, 'J': 13, 'Z': 13}","{'Q': 20, 'R': 13, 'S': 7, 'T': 7, 'H': 13, 'M': 7}","{'Y': 7, 'A': 7, 'B': 3, 'D': 3, 'E': 3, 'G': 7, 'I': 3, 'K': 7, 'L': 3, 'N': 3, 'O': 3, 'U': 7, 'V': 3, 'W': 3, 'X': 3}"
INV-ZZ-4559761,SCH-ZZ-9212586,ZZ,ZZ20240420AMDDEL3431.0,3431.0,Airbus A321-200,04/20/2024,2024-04-20 01:10:00,2024-04-20 07:07:00,AMD,DEL,200.0,226,133,-67,93,20,40,60,80,23,14,6,9,45,26,14,19,72,42,18,30,91,53,27,38,"{'F': 12, 'P': 8}","{'C': 16, 'J': 12, 'Z': 12}","{'Q': 18, 'R': 12, 'S': 6, 'T': 6, 'H': 12, 'M': 6}","{'Y': 6, 'A': 6, 'B': 3, 'D': 3, 'E': 3, 'G': 6, 'I': 3, 'K': 6, 'L': 3, 'N': 3, 'O': 3, 'U': 6, 'V': 3, 'W': 3, 'X': 3}"
INV-ZZ-1060880,SCH-ZZ-9212586,ZZ,ZZ20240422AMDDEL3431.0,3431.0,Airbus A321-200,04/22/2024,2024-04-22 01:10:00,2024-04-22 07:07:00,AMD,DEL,200.0,224,120,-80,104,20,40,60,80,23,12,8,11,47,25,15,22,68,36,24,32,90,48,32,42,"{'F': 12, 'P': 8}","{'C': 16, 'J': 12, 'Z': 12}","{'Q': 18, 'R': 12, 'S': 6, 'T': 6, 'H': 12, 'M': 6}","{'Y': 6, 'A': 6, 'B': 3, 'D': 3, 'E': 3, 'G': 6, 'I': 3, 'K': 6, 'L': 3, 'N': 3, 'O': 3, 'U': 6, 'V': 3, 'W': 3, 'X': 3}"
INV-ZZ-3156289,SCH-ZZ-9212586,ZZ,ZZ20240423AMDDEL3431.0,3431.0,Airbus A321-200,04/23/2024,2024-04-23 01:10:00,2024-04-23 07:07:00,AMD,DEL,200.0,235,128,-72,107,20,40,60,80,23,12,8,11,45,24,16,21,67,36,24,31,95,52,28,43,"{'F': 12, 'P': 8}","{'C': 16, 'J': 12, 'Z': 12}","{'Q': 18, 'R': 12, 'S': 6, 'T': 6, 'H': 12, 'M': 6}","{'Y': 6, 'A': 6, 'B': 3, 'D': 3, 'E': 3, 'G': 6, 'I': 3, 'K': 6, 'L': 3, 'N': 3, 'O': 3, 'U': 6, 'V': 3, 'W': 3, 'X': 3}"
INV-ZZ-5190166,SCH-ZZ-9212586,ZZ,ZZ20240424AMDDEL3431.0,3431.0,Airbus A321-200,04/24/2024,2024-04-24 01:10:00,2024-04-24 07:07:00,AMD,DEL,200.0,223,133,-67,90,20,40,60,80,22,13,7,9,47,28,12,19,71,42,18,29,90,54,26,36,"{'F': 12, 'P': 8}","{'C': 16, 'J': 12, 'Z': 12}","{'Q': 18, 'R': 12, 'S': 6, 'T': 6, 'H': 12, 'M': 6}","{'Y': 6, 'A': 6, 'B': 3, 'D': 3, 'E': 3, 'G': 6, 'I': 3, 'K': 6, 'L': 3, 'N': 3, 'O': 3, 'U': 6, 'V': 3, 'W': 3, 'X': 3}"
INV-ZZ-8238948,SCH-ZZ-9212586,ZZ,ZZ20240425AMDDEL3431.0,3431.0,Airbus A321-200,04/25/2024,2024-04-25 01:10:00,2024-04-25 07:07:00,AMD,DEL,200.0,235,130,-70,105,20,40,60,80,24,13,7,11,47,26,14,21,68,38,22,30,94,52,28,42,"{'F': 12, 'P': 8}","{'C': 16, 'J': 12, 'Z': 12}","{'Q': 18, 'R': 12, 'S': 6, 'T': 6, 'H': 12, 'M': 6}","{'Y': 6, 'A': 6, 'B': 3, 'D': 3, 'E': 3, 'G': 6, 'I': 3, 'K': 6, 'L': 3, 'N': 3, 'O': 3, 'U': 6, 'V': 3, 'W': 3, 'X': 3}"
INV-ZZ-8871178,SCH-ZZ-9212586,ZZ,ZZ20240427AMDDEL3431.0,3431.0,Airbus A321-200,04/27/2024,2024-04-27 01:10:00,2024-04-27 07:07:00,AMD,DEL,200.0,234,143,-57,91,20,40,60,80,22,13,7,9,46,28,12,18,70,43,17,27,88,54,26,34,"{'F': 12, 'P': 8}","{'C': 16, 'J': 12, 'Z': 12}","{'Q': 18, 'R': 12, 'S': 6, 'T': 6, 'H': 12, 'M': 6}","{'Y': 6, 'A': 6, 'B': 3, 'D': 3, 'E': 3, 'G': 6, 'I': 3, 'K': 6, 'L': 3, 'N': 3, 'O': 3, 'U': 6, 'V': 3, 'W': 3, 'X': 3}"
INV-ZZ-4917463,SCH-ZZ-9212586,ZZ,ZZ20240429AMDDEL3431.0,3431.0,Airbus A321-200,04/29/2024,2024-04-29 01:10:00,2024-04-29 07:07:00,AMD,DEL,200.0,226,137,-63,89,20,40,60,80,23,14,6,9,45,27,13,18,71,43,17,28,89,54,26,35,"{'F': 12, 'P': 8}","{'C': 16, 'J': 12, 'Z': 12}","{'Q': 18, 'R': 12, 'S': 6, 'T': 6, 'H': 12, 'M': 6}","{'Y': 6, 'A': 6, 'B': 3, 'D': 3, 'E': 3, 'G': 6, 'I': 3, 'K': 6, 'L': 3, 'N': 3, 'O': 3, 'U': 6, 'V': 3, 'W': 3, 'X': 3}"
INV-ZZ-5157402,SCH-ZZ-9212586,ZZ,ZZ20240430AMDDEL3431.0,3431.0,Airbus A321-200,04/30/2024,2024-04-30 01:10:00,2024-04-30 07:07:00,AMD,DEL,200.0,225,126,-74,99,20,40,60,80,24,13,7,11,46,26,14,20,67,38,22,29,94,53,27,41,"{'F': 12, 'P': 8}","{'C': 16, 'J': 12, 'Z': 12}","{'Q': 18, 'R': 12, 'S': 6, 'T': 6, 'H': 12, 'M': 6}","{'Y': 6, 'A': 6, 'B': 3, 'D': 3, 'E': 3, 'G': 6, 'I': 3, 'K': 6, 'L': 3, 'N': 3, 'O': 3, 'U': 6, 'V': 3, 'W': 3, 'X': 3}"
INV-ZZ-6008936,SCH-ZZ-9212586,ZZ,ZZ20240501AMDDEL3431.0,3431.0,Airbus A321-200,05/01/2024,2024-05-01 01:10:00,2024-05-01 07:07:00,AMD,DEL,200.0,220,131,-69,89,20,40,60,80,24,14,6,10,47,28,12,19,71,42,18,29,94,56,24,38,"{'F': 12, 'P': 8}","{'C': 16, 'J': 12, 'Z': 12}","{'Q': 18, 'R': 12, 'S': 6, 'T': 6, 'H': 12, 'M': 6}","{'Y': 6, 'A': 6, 'B': 3, 'D': 3, 'E': 3, 'G': 6, 'I': 3, 'K': 6, 'L': 3, 'N': 3, 'O': 3, 'U': 6, 'V': 3, 'W': 3, 'X': 3}"
INV-ZZ-8944276,SCH-ZZ-9212586,ZZ,ZZ20240502AMDDEL3431.0,3431.0,Airbus A321-200,05/02/2024,2024-05-02 01:10:00,2024-05-02 07:07:00,AMD,DEL,200.0,226,134,-66,92,20,40,60,80,23,14,6,9,47,28,12,19,72,43,17,29,94,56,24,38,"{'F': 12, 'P': 8}","{'C': 16, 'J': 12, 'Z': 12}","{'Q': 18, 'R': 12, 'S': 6, 'T': 6, 'H': 12, 'M': 6}","{'Y': 6, 'A': 6, 'B': 3, 'D': 3, 'E': 3, 'G': 6, 'I': 3, 'K': 6, 'L': 3, 'N': 3, 'O': 3, 'U': 6, 'V': 3, 'W': 3, 'X': 3}"
INV-ZZ-3019482,SCH-ZZ-9212586,ZZ,ZZ20240504AMDDEL3431.0,3431.0,Airbus A321-200,05/04/2024,2024-05-04 01:10:00,2024-05-04 07:07:00,AMD,DEL,200.0,233,124,-76,109,20,40,60,80,22,12,8,10,44,23,17,21,69,37,23,32,96,51,29,45,"{'F': 12, 'P': 8}","{'C': 16, 'J': 12, 'Z': 12}","{'Q': 18, 'R': 12, 'S': 6, 'T': 6, 'H': 12, 'M': 6}","{'Y': 6, 'A': 6, 'B': 3, 'D': 3, 'E': 3, 'G': 6, 'I': 3, 'K': 6, 'L': 3, 'N': 3, 'O': 3, 'U': 6, 'V': 3, 'W': 3, 'X': 3}"
INV-ZZ-5005703,SCH-ZZ-9212586,ZZ,ZZ20240506AMDDEL3431.0,3431.0,Airbus A321-200,05/06/2024,2024-05-06 01:10:00,2024-05-06 07:07:00,AMD,DEL,200.0,224,123,-77,101,20,40,60,80,24,13,7,11,45,25,15,20,68,37,23,31,90,50,30,40,"{'F': 12, 'P': 8}","{'C': 16, 'J': 12, 'Z': 12}","{'Q': 18, 'R': 12, 'S': 6, 'T': 6, 'H': 12, 'M': 6}","{'Y': 6, 'A': 6, 'B': 3, 'D': 3, 'E': 3, 'G': 6, 'I': 3, 'K': 6, 'L': 3, 'N': 3, 'O': 3, 'U': 6, 'V': 3, 'W': 3, 'X': 3}"
INV-ZZ-8589841,SCH-ZZ-9212586,ZZ,ZZ20240507AMDDEL3431.0,3431.0,Airbus A321-200,05/07/2024,2024-05-07 01:10:00,2024-05-07 07:07:00,AMD,DEL,200.0,227,124,-76,103,20,40,60,80,23,13,7,10,47,26,14,21,69,38,22,31,92,50,30,42,"{'F': 12, 'P': 8}","{'C': 16, 'J': 12, 'Z': 12}","{'Q': 18, 'R': 12, 'S': 6, 'T': 6, 'H': 12, 'M': 6}","{'Y': 6, 'A': 6, 'B': 3, 'D': 3, 'E': 3, 'G': 6, 'I': 3, 'K': 6, 'L': 3, 'N': 3, 'O': 3, 'U': 6, 'V': 3, 'W': 3, 'X': 3}"
INV-ZZ-5739927,SCH-ZZ-9212586,ZZ,ZZ20240508AMDDEL3431.0,3431.0,Airbus A321-200,05/08/2024,2024-05-08 01:10:00,2024-05-08 07:07:00,AMD,DEL,200.0,224,119,-81,105,20,40,60,80,23,12,8,11,46,24,16,22,68,36,24,32,89,47,33,42,"{'F': 12, 'P': 8}","{'C': 16, 'J': 12, 'Z': 12}","{'Q': 18, 'R': 12, 'S': 6, 'T': 6, 'H': 12, 'M': 6}","{'Y': 6, 'A': 6, 'B': 3, 'D': 3, 'E': 3, 'G': 6, 'I': 3, 'K': 6, 'L': 3, 'N': 3, 'O': 3, 'U': 6, 'V': 3, 'W': 3, 'X': 3}"
INV-ZZ-8109871,SCH-ZZ-9212586,ZZ,ZZ20240509AMDDEL3431.0,3431.0,Airbus A321-200,05/09/2024,2024-05-09 01:10:00,2024-05-09 07:07:00,AMD,DEL,200.0,229,132,-68,97,20,40,60,80,23,13,7,10,47,27,13,20,72,42,18,30,91,52,28,39,"{'F': 12, 'P': 8}","{'C': 16, 'J': 12, 'Z': 12}","{'Q': 18, 'R': 12, 'S': 6, 'T': 6, 'H': 12, 'M': 6}","{'Y': 6, 'A': 6, 'B': 3, 'D': 3, 'E': 3, 'G': 6, 'I': 3, 'K': 6, 'L': 3, 'N': 3, 'O': 3, 'U': 6, 'V': 3, 'W': 3, 'X': 3}"
INV-ZZ-9513437,SCH-ZZ-9212586,ZZ,ZZ20240511AMDDEL3431.0,3431.0,Airbus A321-200,05/11/2024,2024-05-11 01:10:00,2024-05-11 07:07:00,AMD,DEL,200.0,235,122,-78,113,20,40,60,80,22,11,9,11,46,24,16,22,70,36,24,34,90,47,33,43,"{'F': 12, 'P': 8}","{'C': 16, 'J': 12, 'Z': 12}","{'Q': 18, 'R': 12, 'S': 6, 'T': 6, 'H': 12, 'M': 6}","{'Y': 6, 'A': 6, 'B': 3, 'D': 3, 'E': 3, 'G': 6, 'I': 3, 'K': 6, 'L': 3, 'N': 3, 'O': 3, 'U': 6, 'V': 3, 'W': 3, 'X': 3}"
INV-ZZ-2313092,SCH-ZZ-9212586,ZZ,ZZ20240513AMDDEL3431.0,3431.0,Airbus A321-200,05/13/2024,2024-05-13 01:10:00,2024-05-13 07:07:00,AMD,DEL,200.0,223,113,-87,110,20,40,60,80,23,12,8,11,45,23,17,22,72,37,23,35,94,48,32,46,"{'F': 12, 'P': 8}","{'C': 16, 'J': 12, 'Z': 12}","{'Q': 18, 'R': 12, 'S': 6, 'T': 6, 'H': 12, 'M': 6}","{'Y': 6, 'A': 6, 'B': 3, 'D': 3, 'E': 3, 'G': 6, 'I': 3, 'K': 6, 'L': 3, 'N': 3, 'O': 3, 'U': 6, 'V': 3, 'W': 3, 'X': 3}"
INV-ZZ-7480149,SCH-ZZ-9212586,ZZ,ZZ20240514AMDDEL3431.0,3431.0,Airbus A321-200,05/14/2024,2024-05-14 01:10:00,2024-05-14 07:07:00,AMD,DEL,200.0,227,121,-79,106,20,40,60,80,22,12,8,10,47,25,15,22,67,36,24,31,95,51,29,44,"{'F': 12, 'P': 8}","{'C': 16, 'J': 12, 'Z': 12}","{'Q': 18, 'R': 12, 'S': 6, 'T': 6, 'H': 12, 'M': 6}","{'Y': 6, 'A': 6, 'B': 3, 'D': 3, 'E': 3, 'G': 6, 'I': 3, 'K': 6, 'L': 3, 'N': 3, 'O': 3, 'U': 6, 'V': 3, 'W': 3, 'X': 3}"
INV-ZZ-3709223,SCH-ZZ-9212586,ZZ,ZZ20240515AMDDEL3431.0,3431.0,Airbus A321-200,05/15/2024,2024-05-15 01:10:00,2024-05-15 07:07:00,AMD,DEL,200.0,237,122,-78,115,20,40,60,80,23,12,8,11,46,24,16,22,66,34,26,32,91,47,33,44,"{'F': 12, 'P': 8}","{'C': 16, 'J': 12, 'Z': 12}","{'Q': 18, 'R': 12, 'S': 6, 'T': 6, 'H': 12, 'M': 6}","{'Y': 6, 'A': 6, 'B': 3, 'D': 3, 'E': 3, 'G': 6, 'I': 3, 'K': 6, 'L': 3, 'N': 3, 'O': 3, 'U': 6, 'V': 3, 'W': 3, 'X': 3}"
INV-ZZ-8207761,SCH-ZZ-9212586,ZZ,ZZ20240516AMDDEL3431.0,3431.0,Airbus A321-200,05/16/2024,2024-05-16 01:10:00,2024-05-16 07:07:00,AMD,DEL,200.0,220,120,-80,100,20,40,60,80,24,13,7,11,45,25,15,20,70,38,22,32,92,50,30,42,"{'F': 12, 'P': 8}","{'C': 16, 'J': 12, 'Z': 12}","{'Q': 18, 'R': 12, 'S': 6, 'T': 6, 'H': 12, 'M': 6}","{'Y': 6, 'A': 6, 'B': 3, 'D': 3, 'E': 3, 'G': 6, 'I': 3, 'K': 6, 'L': 3, 'N': 3, 'O': 3, 'U': 6, 'V': 3, 'W': 3, 'X': 3}"
INV-ZZ-7409178,SCH-ZZ-9212586,ZZ,ZZ20240518AMDDEL3431.0,3431.0,Airbus A321-200,05/18/2024,2024-05-18 01:10:00,2024-05-18 07:07:00,AMD,DEL,200.0,231,112,-88,119,20,40,60,80,22,11,9,11,46,22,18,24,68,33,27,35,94,46,34,48,"{'F': 12, 'P': 8}","{'C': 16, 'J': 12, 'Z': 12}","{'Q': 18, 'R': 12, 'S': 6, 'T': 6, 'H': 12, 'M': 6}","{'Y': 6, 'A': 6, 'B': 3, 'D': 3, 'E': 3, 'G': 6, 'I': 3, 'K': 6, 'L': 3, 'N': 3, 'O': 3, 'U': 6, 'V': 3, 'W': 3, 'X': 3}"
INV-ZZ-1930796,SCH-ZZ-9212586,ZZ,ZZ20240520AMDDEL3431.0,3431.0,Airbus A321-200,05/20/2024,2024-05-20 01:10:00,2024-05-20 07:07:00,AMD,DEL,200.0,234,118,-82,116,20,40,60,80,23,12,8,11,48,24,16,24,68,34,26,34,90,45,35,45,"{'F': 12, 'P': 8}","{'C': 16, 'J': 12, 'Z': 12}","{'Q': 18, 'R': 12, 'S': 6, 'T': 6, 'H': 12, 'M': 6}","{'Y': 6, 'A': 6, 'B': 3, 'D': 3, 'E': 3, 'G': 6, 'I': 3, 'K': 6, 'L': 3, 'N': 3, 'O': 3, 'U': 6, 'V': 3, 'W': 3, 'X': 3}"
INV-ZZ-1420745,SCH-ZZ-9212586,ZZ,ZZ20240521AMDDEL3431.0,3431.0,Airbus A321-200,05/21/2024,2024-05-21 01:10:00,2024-05-21 07:07:00,AMD,DEL,200.0,225,113,-87,112,20,40,60,80,24,12,8,12,47,24,16,23,67,34,26,33,93,47,33,46,"{'F': 12, 'P': 8}","{'C': 16, 'J': 12, 'Z': 12}","{'Q': 18, 'R': 12, 'S': 6, 'T': 6, 'H': 12, 'M': 6}","{'Y': 6, 'A': 6, 'B': 3, 'D': 3, 'E': 3, 'G': 6, 'I': 3, 'K': 6, 'L': 3, 'N': 3, 'O': 3, 'U': 6, 'V': 3, 'W': 3, 'X': 3}"
INV-ZZ-6528112,SCH-ZZ-9212586,ZZ,ZZ20240522AMDDEL3431.0,3431.0,Airbus A321-200,05/22/2024,2024-05-22 01:10:00,2024-05-22 07:07:00,AMD,DEL,200.0,231,109,-91,122,20,40,60,80,22,10,10,12,45,21,19,24,69,33,27,36,93,44,36,49,"{'F': 12, 'P': 8}","{'C': 16, 'J': 12, 'Z': 12}","{'Q': 18, 'R': 12, 'S': 6, 'T': 6, 'H': 12, 'M': 6}","{'Y': 6, 'A': 6, 'B': 3, 'D': 3, 'E': 3, 'G': 6, 'I': 3, 'K': 6, 'L': 3, 'N': 3, 'O': 3, 'U': 6, 'V': 3, 'W': 3, 'X': 3}"
INV-ZZ-6522917,SCH-ZZ-9212586,ZZ,ZZ20240523AMDDEL3431.0,3431.0,Airbus A321-200,05/23/2024,2024-05-23 01:10:00,2024-05-23 07:07:00,AMD,DEL,200.0,223,110,-90,113,20,40,60,80,23,11,9,12,46,23,17,23,71,35,25,36,90,45,35,45,"{'F': 12, 'P': 8}","{'C': 16, 'J': 12, 'Z': 12}","{'Q': 18, 'R': 12, 'S': 6, 'T': 6, 'H': 12, 'M': 6}","{'Y': 6, 'A': 6, 'B': 3, 'D': 3, 'E': 3, 'G': 6, 'I': 3, 'K': 6, 'L': 3, 'N': 3, 'O': 3, 'U': 6, 'V': 3, 'W': 3, 'X': 3}"
INV-ZZ-3041946,SCH-ZZ-9212586,ZZ,ZZ20240525AMDDEL3431.0,3431.0,Airbus A321-200,05/25/2024,2024-05-25 01:10:00,2024-05-25 07:07:00,AMD,DEL,200.0,235,116,-84,119,20,40,60,80,22,11,9,11,47,23,17,24,71,35,25,36,93,46,34,47,"{'F': 12, 'P': 8}","{'C': 16, 'J': 12, 'Z': 12}","{'Q': 18, 'R': 12, 'S': 6, 'T': 6, 'H': 12, 'M': 6}","{'Y': 6, 'A': 6, 'B': 3, 'D': 3, 'E': 3, 'G': 6, 'I': 3, 'K': 6, 'L': 3, 'N': 3, 'O': 3, 'U': 6, 'V': 3, 'W': 3, 'X': 3}"
INV-ZZ-8645575,SCH-ZZ-9212586,ZZ,ZZ20240527AMDDEL3431.0,3431.0,Airbus A321-200,05/27/2024,2024-05-27 01:10:00,2024-05-27 07:07:00,AMD,DEL,200.0,229,115,-85,114,20,40,60,80,24,12,8,12,47,24,16,23,70,35,25,35,90,45,35,45,"{'F': 12, 'P': 8}","{'C': 16, 'J': 12, 'Z': 12}","{'Q': 18, 'R': 12, 'S': 6, 'T': 6, 'H': 12, 'M': 6}","{'Y': 6, 'A': 6, 'B': 3, 'D': 3, 'E': 3, 'G': 6, 'I': 3, 'K': 6, 'L': 3, 'N': 3, 'O': 3, 'U': 6, 'V': 3, 'W': 3, 'X': 3}"
INV-ZZ-8296320,SCH-ZZ-9212586,ZZ,ZZ20240528AMDDEL3431.0,3431.0,Airbus A321-200,05/28/2024,2024-05-28 01:10:00,2024-05-28 07:07:00,AMD,DEL,200.0,228,113,-87,115,20,40,60,80,23,11,9,12,46,23,17,23,70,35,25,35,92,46,34,46,"{'F': 12, 'P': 8}","{'C': 16, 'J': 12, 'Z': 12}","{'Q': 18, 'R': 12, 'S': 6, 'T': 6, 'H': 12, 'M': 6}","{'Y': 6, 'A': 6, 'B': 3, 'D': 3, 'E': 3, 'G': 6, 'I': 3, 'K': 6, 'L': 3, 'N': 3, 'O': 3, 'U': 6, 'V': 3, 'W': 3, 'X': 3}"
INV-ZZ-5325115,SCH-ZZ-9212586,ZZ,ZZ20240529AMDDEL3431.0,3431.0,Airbus A321-200,05/29/2024,2024-05-29 01:10:00,2024-05-29 07:07:00,AMD,DEL,200.0,236,114,-86,122,20,40,60,80,23,11,9,12,46,22,18,24,67,32,28,35,93,45,35,48,"{'F': 12, 'P': 8}","{'C': 16, 'J': 12, 'Z': 12}","{'Q': 18, 'R': 12, 'S': 6, 'T': 6, 'H': 12, 'M': 6}","{'Y': 6, 'A': 6, 'B': 3, 'D': 3, 'E': 3, 'G': 6, 'I': 3, 'K': 6, 'L': 3, 'N': 3, 'O': 3, 'U': 6, 'V': 3, 'W': 3, 'X': 3}"
INV-ZZ-8631600,SCH-ZZ-9212586,ZZ,ZZ20240530AMDDEL3431.0,3431.0,Airbus A321-200,05/30/2024,2024-05-30 01:10:00,2024-05-30 07:07:00,AMD,DEL,200.0,232,105,-95,127,20,40,60,80,24,11,9,13,47,21,19,26,68,31,29,37,94,42,38,52,"{'F': 12, 'P': 8}","{'C': 16, 'J': 12, 'Z': 12}","{'Q': 18, 'R': 12, 'S': 6, 'T': 6, 'H': 12, 'M': 6}","{'Y': 6, 'A': 6, 'B': 3, 'D': 3, 'E': 3, 'G': 6, 'I': 3, 'K': 6, 'L': 3, 'N': 3, 'O': 3, 'U': 6, 'V': 3, 'W': 3, 'X': 3}"
INV-ZZ-5198628,SCH-ZZ-9212586,ZZ,ZZ20240601AMDDEL3431.0,3431.0,Airbus A321-200,06/01/2024,2024-06-01 01:10:00,2024-06-01 07:07:00,AMD,DEL,200.0,222,110,-90,112,20,40,60,80,23,11,9,12,46,23,17,23,72,36,24,36,91,45,35,46,"{'F': 12, 'P': 8}","{'C': 16, 'J': 12, 'Z': 12}","{'Q': 18, 'R': 12, 'S': 6, 'T': 6, 'H': 12, 'M': 6}","{'Y': 6, 'A': 6, 'B': 3, 'D': 3, 'E': 3, 'G': 6, 'I': 3, 'K': 6, 'L': 3, 'N': 3, 'O': 3, 'U': 6, 'V': 3, 'W': 3, 'X': 3}"
INV-ZZ-9779199,SCH-ZZ-9212586,ZZ,ZZ20240603AMDDEL3431.0,3431.0,Airbus A321-200,06/03/2024,2024-06-03 01:10:00,2024-06-03 07:07:00,AMD,DEL,200.0,233,109,-91,124,20,40,60,80,23,11,9,12,44,21,19,23,69,32,28,37,89,42,38,47,"{'F': 12, 'P': 8}","{'C': 16, 'J': 12, 'Z': 12}","{'Q': 18, 'R': 12, 'S': 6, 'T': 6, 'H': 12, 'M': 6}","{'Y': 6, 'A': 6, 'B': 3, 'D': 3, 'E': 3, 'G': 6, 'I': 3, 'K': 6, 'L': 3, 'N': 3, 'O': 3, 'U': 6, 'V': 3, 'W': 3, 'X': 3}"
INV-ZZ-2029583,SCH-ZZ-9212586,ZZ,ZZ20240604AMDDEL3431.0,3431.0,Airbus A321-200,06/04/2024,2024-06-04 01:10:00,2024-06-04 07:07:00,AMD,DEL,200.0,230,106,-94,124,20,40,60,80,23,11,9,12,47,22,18,25,69,32,28,37,96,44,36,52,"{'F': 12, 'P': 8}","{'C': 16, 'J': 12, 'Z': 12}","{'Q': 18, 'R': 12, 'S': 6, 'T': 6, 'H': 12, 'M': 6}","{'Y': 6, 'A': 6, 'B': 3, 'D': 3, 'E': 3, 'G': 6, 'I': 3, 'K': 6, 'L': 3, 'N': 3, 'O': 3, 'U': 6, 'V': 3, 'W': 3, 'X': 3}"
INV-ZZ-2926226,SCH-ZZ-4843596,ZZ,ZZ20240412AMDBLR3041.0,3041.0,Airbus A321-200,04/12/2024,2024-04-12 14:26:00,2024-04-12 18:12:00,AMD,BLR,200.0,239,148,-52,91,20,40,60,80,22,14,6,8,48,30,10,18,66,41,19,25,92,57,23,35,"{'F': 12, 'P': 8}","{'C': 16, 'J': 12, 'Z': 12}","{'Q': 18, 'R': 12, 'S': 6, 'T': 6, 'H': 12, 'M': 6}","{'Y': 6, 'A': 6, 'B': 3, 'D': 3, 'E': 3, 'G': 6, 'I': 3, 'K': 6, 'L': 3, 'N': 3, 'O': 3, 'U': 6, 'V': 3, 'W': 3, 'X': 3}"
INV-ZZ-4393457,SCH-ZZ-4843596,ZZ,ZZ20240414AMDBLR3041.0,3041.0,Airbus A321-200,04/14/2024,2024-04-14 14:26:00,2024-04-14 18:12:00,AMD,BLR,200.0,235,136,-64,99,20,40,60,80,23,13,7,10,46,27,13,19,72,42,18,30,88,51,29,37,"{'F': 12, 'P': 8}","{'C': 16, 'J': 12, 'Z': 12}","{'Q': 18, 'R': 12, 'S': 6, 'T': 6, 'H': 12, 'M': 6}","{'Y': 6, 'A': 6, 'B': 3, 'D': 3, 'E': 3, 'G': 6, 'I': 3, 'K': 6, 'L': 3, 'N': 3, 'O': 3, 'U': 6, 'V': 3, 'W': 3, 'X': 3}"
INV-ZZ-4825429,SCH-ZZ-4843596,ZZ,ZZ20240415AMDBLR3041.0,3041.0,Airbus A321-200,04/15/2024,2024-04-15 14:26:00,2024-04-15 18:12:00,AMD,BLR,200.0,232,142,-58,90,20,40,60,80,24,15,5,9,48,29,11,19,69,42,18,27,89,54,26,35,"{'F': 12, 'P': 8}","{'C': 16, 'J': 12, 'Z': 12}","{'Q': 18, 'R': 12, 'S': 6, 'T': 6, 'H': 12, 'M': 6}","{'Y': 6, 'A': 6, 'B': 3, 'D': 3, 'E': 3, 'G': 6, 'I': 3, 'K': 6, 'L': 3, 'N': 3, 'O': 3, 'U': 6, 'V': 3, 'W': 3, 'X': 3}"
INV-ZZ-9024315,SCH-ZZ-4843596,ZZ,ZZ20240419AMDBLR3041.0,3041.0,Airbus A321-200,04/19/2024,2024-04-19 14:26:00,2024-04-19 18:12:00,AMD,BLR,200.0,224,137,-63,87,20,40,60,80,23,14,6,9,46,28,12,18,71,43,17,28,91,56,24,35,"{'F': 12, 'P': 8}","{'C': 16, 'J': 12, 'Z': 12}","{'Q': 18, 'R': 12, 'S': 6, 'T': 6, 'H': 12, 'M': 6}","{'Y': 6, 'A': 6, 'B': 3, 'D': 3, 'E': 3, 'G': 6, 'I': 3, 'K': 6, 'L': 3, 'N': 3, 'O': 3, 'U': 6, 'V': 3, 'W': 3, 'X': 3}"
INV-ZZ-6330205,SCH-ZZ-4843596,ZZ,ZZ20240421AMDBLR3041.0,3041.0,Airbus A321-200,04/21/2024,2024-04-21 14:26:00,2024-04-21 18:12:00,AMD,BLR,200.0,222,132,-68,90,20,40,60,80,24,14,6,10,47,28,12,19,68,40,20,28,88,52,28,36,"{'F': 12, 'P': 8}","{'C': 16, 'J': 12, 'Z': 12}","{'Q': 18, 'R': 12, 'S': 6, 'T': 6, 'H': 12, 'M': 6}","{'Y': 6, 'A': 6, 'B': 3, 'D': 3, 'E': 3, 'G': 6, 'I': 3, 'K': 6, 'L': 3, 'N': 3, 'O': 3, 'U': 6, 'V': 3, 'W': 3, 'X': 3}"
INV-ZZ-7856630,SCH-ZZ-4843596,ZZ,ZZ20240422AMDBLR3041.0,3041.0,Airbus A321-200,04/22/2024,2024-04-22 14:26:00,2024-04-22 18:12:00,AMD,BLR,200.0,233,129,-71,104,20,40,60,80,24,13,7,11,44,24,16,20,68,38,22,30,93,52,28,41,"{'F': 12, 'P': 8}","{'C': 16, 'J': 12, 'Z': 12}","{'Q': 18, 'R': 12, 'S': 6, 'T': 6, 'H': 12, 'M': 6}","{'Y': 6, 'A': 6, 'B': 3, 'D': 3, 'E': 3, 'G': 6, 'I': 3, 'K': 6, 'L': 3, 'N': 3, 'O': 3, 'U': 6, 'V': 3, 'W': 3, 'X': 3}"
INV-ZZ-2949180,SCH-ZZ-4843596,ZZ,ZZ20240426AMDBLR3041.0,3041.0,Airbus A321-200,04/26/2024,2024-04-26 14:26:00,2024-04-26 18:12:00,AMD,BLR,200.0,237,140,-60,97,20,40,60,80,23,14,6,9,45,27,13,18,69,41,19,28,94,56,24,38,"{'F': 12, 'P': 8}","{'C': 16, 'J': 12, 'Z': 12}","{'Q': 18, 'R': 12, 'S': 6, 'T': 6, 'H': 12, 'M': 6}","{'Y': 6, 'A': 6, 'B': 3, 'D': 3, 'E': 3, 'G': 6, 'I': 3, 'K': 6, 'L': 3, 'N': 3, 'O': 3, 'U': 6, 'V': 3, 'W': 3, 'X': 3}"
INV-ZZ-6197656,SCH-ZZ-4843596,ZZ,ZZ20240428AMDBLR3041.0,3041.0,Airbus A321-200,04/28/2024,2024-04-28 14:26:00,2024-04-28 18:12:00,AMD,BLR,200.0,239,130,-70,109,20,40,60,80,22,12,8,10,45,24,16,21,68,37,23,31,92,50,30,42,"{'F': 12, 'P': 8}","{'C': 16, 'J': 12, 'Z': 12}","{'Q': 18, 'R': 12, 'S': 6, 'T': 6, 'H': 12, 'M': 6}","{'Y': 6, 'A': 6, 'B': 3, 'D': 3, 'E': 3, 'G': 6, 'I': 3, 'K': 6, 'L': 3, 'N': 3, 'O': 3, 'U': 6, 'V': 3, 'W': 3, 'X': 3}"
INV-ZZ-1684335,SCH-ZZ-4843596,ZZ,ZZ20240429AMDBLR3041.0,3041.0,Airbus A321-200,04/29/2024,2024-04-29 14:26:00,2024-04-29 18:12:00,AMD,BLR,200.0,236,132,-68,104,20,40,60,80,23,13,7,10,46,26,14,20,68,38,22,30,96,53,27,43,"{'F': 12, 'P': 8}","{'C': 16, 'J': 12, 'Z': 12}","{'Q': 18, 'R': 12, 'S': 6, 'T': 6, 'H': 12, 'M': 6}","{'Y': 6, 'A': 6, 'B': 3, 'D': 3, 'E': 3, 'G': 6, 'I': 3, 'K': 6, 'L': 3, 'N': 3, 'O': 3, 'U': 6, 'V': 3, 'W': 3, 'X': 3}"
INV-ZZ-4844977,SCH-ZZ-4843596,ZZ,ZZ20240503AMDBLR3041.0,3041.0,Airbus A321-200,05/03/2024,2024-05-03 14:26:00,2024-05-03 18:12:00,AMD,BLR,200.0,222,115,-85,107,20,40,60,80,23,12,8,11,46,24,16,22,70,36,24,34,95,49,31,46,"{'F': 12, 'P': 8}","{'C': 16, 'J': 12, 'Z': 12}","{'Q': 18, 'R': 12, 'S': 6, 'T': 6, 'H': 12, 'M': 6}","{'Y': 6, 'A': 6, 'B': 3, 'D': 3, 'E': 3, 'G': 6, 'I': 3, 'K': 6, 'L': 3, 'N': 3, 'O': 3, 'U': 6, 'V': 3, 'W': 3, 'X': 3}"
INV-ZZ-9418007,SCH-ZZ-4843596,ZZ,ZZ20240505AMDBLR3041.0,3041.0,Airbus A321-200,05/05/2024,2024-05-05 14:26:00,2024-05-05 18:12:00,AMD,BLR,200.0,231,124,-76,107,20,40,60,80,22,12,8,10,47,25,15,22,71,38,22,33,95,51,29,44,"{'F': 12, 'P': 8}","{'C': 16, 'J': 12, 'Z': 12}","{'Q': 18, 'R': 12, 'S': 6, 'T': 6, 'H': 12, 'M': 6}","{'Y': 6, 'A': 6, 'B': 3, 'D': 3, 'E': 3, 'G': 6, 'I': 3, 'K': 6, 'L': 3, 'N': 3, 'O': 3, 'U': 6, 'V': 3, 'W': 3, 'X': 3}"
INV-ZZ-1062778,SCH-ZZ-4843596,ZZ,ZZ20240506AMDBLR3041.0,3041.0,Airbus A321-200,05/06/2024,2024-05-06 14:26:00,2024-05-06 18:12:00,AMD,BLR,200.0,235,137,-63,98,20,40,60,80,22,13,7,9,44,26,14,18,67,39,21,28,88,51,29,37,"{'F': 12, 'P': 8}","{'C': 16, 'J': 12, 'Z': 12}","{'Q': 18, 'R': 12, 'S': 6, 'T': 6, 'H': 12, 'M': 6}","{'Y': 6, 'A': 6, 'B': 3, 'D': 3, 'E': 3, 'G': 6, 'I': 3, 'K': 6, 'L': 3, 'N': 3, 'O': 3, 'U': 6, 'V': 3, 'W': 3, 'X': 3}"
INV-ZZ-9970144,SCH-ZZ-4843596,ZZ,ZZ20240510AMDBLR3041.0,3041.0,Airbus A321-200,05/10/2024,2024-05-10 14:26:00,2024-05-10 18:12:00,AMD,BLR,200.0,221,119,-81,102,20,40,60,80,22,12,8,10,48,26,14,22,71,38,22,33,89,48,32,41,"{'F': 12, 'P': 8}","{'C': 16, 'J': 12, 'Z': 12}","{'Q': 18, 'R': 12, 'S': 6, 'T': 6, 'H': 12, 'M': 6}","{'Y': 6, 'A': 6, 'B': 3, 'D': 3, 'E': 3, 'G': 6, 'I': 3, 'K': 6, 'L': 3, 'N': 3, 'O': 3, 'U': 6, 'V': 3, 'W': 3, 'X': 3}"
INV-ZZ-6723698,SCH-ZZ-4843596,ZZ,ZZ20240512AMDBLR3041.0,3041.0,Airbus A321-200,05/12/2024,2024-05-12 14:26:00,2024-05-12 18:12:00,AMD,BLR,200.0,237,132,-68,105,20,40,60,80,24,13,7,11,46,26,14,20,68,38,22,30,92,51,29,41,"{'F': 12, 'P': 8}","{'C': 16, 'J': 12, 'Z': 12}","{'Q': 18, 'R': 12, 'S': 6, 'T': 6, 'H': 12, 'M': 6}","{'Y': 6, 'A': 6, 'B': 3, 'D': 3, 'E': 3, 'G': 6, 'I': 3, 'K': 6, 'L': 3, 'N': 3, 'O': 3, 'U': 6, 'V': 3, 'W': 3, 'X': 3}"
INV-ZZ-3456701,SCH-ZZ-4843596,ZZ,ZZ20240513AMDBLR3041.0,3041.0,Airbus A321-200,05/13/2024,2024-05-13 14:26:00,2024-05-13 18:12:00,AMD,BLR,200.0,236,133,-67,103,20,40,60,80,23,13,7,10,45,25,15,20,67,38,22,29,93,52,28,41,"{'F': 12, 'P': 8}","{'C': 16, 'J': 12, 'Z': 12}","{'Q': 18, 'R': 12, 'S': 6, 'T': 6, 'H': 12, 'M': 6}","{'Y': 6, 'A': 6, 'B': 3, 'D': 3, 'E': 3, 'G': 6, 'I': 3, 'K': 6, 'L': 3, 'N': 3, 'O': 3, 'U': 6, 'V': 3, 'W': 3, 'X': 3}"
INV-ZZ-8466132,SCH-ZZ-4843596,ZZ,ZZ20240517AMDBLR3041.0,3041.0,Airbus A321-200,05/17/2024,2024-05-17 14:26:00,2024-05-17 18:12:00,AMD,BLR,200.0,237,122,-78,115,20,40,60,80,23,12,8,11,45,23,17,22,70,36,24,34,92,47,33,45,"{'F': 12, 'P': 8}","{'C': 16, 'J': 12, 'Z': 12}","{'Q': 18, 'R': 12, 'S': 6, 'T': 6, 'H': 12, 'M': 6}","{'Y': 6, 'A': 6, 'B': 3, 'D': 3, 'E': 3, 'G': 6, 'I': 3, 'K': 6, 'L': 3, 'N': 3, 'O': 3, 'U': 6, 'V': 3, 'W': 3, 'X': 3}"
INV-ZZ-4855587,SCH-ZZ-4843596,ZZ,ZZ20240519AMDBLR3041.0,3041.0,Airbus A321-200,05/19/2024,2024-05-19 14:26:00,2024-05-19 18:12:00,AMD,BLR,200.0,235,112,-88,123,20,40,60,80,23,11,9,12,47,22,18,25,68,32,28,36,93,44,36,49,"{'F': 12, 'P': 8}","{'C': 16, 'J': 12, 'Z': 12}","{'Q': 18, 'R': 12, 'S': 6, 'T': 6, 'H': 12, 'M': 6}","{'Y': 6, 'A': 6, 'B': 3, 'D': 3, 'E': 3, 'G': 6, 'I': 3, 'K': 6, 'L': 3, 'N': 3, 'O': 3, 'U': 6, 'V': 3, 'W': 3, 'X': 3}"
INV-ZZ-4725843,SCH-ZZ-4843596,ZZ,ZZ20240520AMDBLR3041.0,3041.0,Airbus A321-200,05/20/2024,2024-05-20 14:26:00,2024-05-20 18:12:00,AMD,BLR,200.0,221,107,-93,114,20,40,60,80,23,11,9,12,47,23,17,24,69,33,27,36,92,45,35,47,"{'F': 12, 'P': 8}","{'C': 16, 'J': 12, 'Z': 12}","{'Q': 18, 'R': 12, 'S': 6, 'T': 6, 'H': 12, 'M': 6}","{'Y': 6, 'A': 6, 'B': 3, 'D': 3, 'E': 3, 'G': 6, 'I': 3, 'K': 6, 'L': 3, 'N': 3, 'O': 3, 'U': 6, 'V': 3, 'W': 3, 'X': 3}"
INV-ZZ-1805422,SCH-ZZ-4843596,ZZ,ZZ20240524AMDBLR3041.0,3041.0,Airbus A321-200,05/24/2024,2024-05-24 14:26:00,2024-05-24 18:12:00,AMD,BLR,200.0,236,119,-81,117,20,40,60,80,23,12,8,11,46,23,17,23,67,34,26,33,92,46,34,46,"{'F': 12, 'P': 8}","{'C': 16, 'J': 12, 'Z': 12}","{'Q': 18, 'R': 12, 'S': 6, 'T': 6, 'H': 12, 'M': 6}","{'Y': 6, 'A': 6, 'B': 3, 'D': 3, 'E': 3, 'G': 6, 'I': 3, 'K': 6, 'L': 3, 'N': 3, 'O': 3, 'U': 6, 'V': 3, 'W': 3, 'X': 3}"
INV-ZZ-6244039,SCH-ZZ-4843596,ZZ,ZZ20240526AMDBLR3041.0,3041.0,Airbus A321-200,05/26/2024,2024-05-26 14:26:00,2024-05-26 18:12:00,AMD,BLR,200.0,235,108,-92,127,20,40,60,80,23,11,9,12,45,21,19,24,67,31,29,36,90,41,39,49,"{'F': 12, 'P': 8}","{'C': 16, 'J': 12, 'Z': 12}","{'Q': 18, 'R': 12, 'S': 6, 'T': 6, 'H': 12, 'M': 6}","{'Y': 6, 'A': 6, 'B': 3, 'D': 3, 'E': 3, 'G': 6, 'I': 3, 'K': 6, 'L': 3, 'N': 3, 'O': 3, 'U': 6, 'V': 3, 'W': 3, 'X': 3}"
INV-ZZ-4426236,SCH-ZZ-4843596,ZZ,ZZ20240527AMDBLR3041.0,3041.0,Airbus A321-200,05/27/2024,2024-05-27 14:26:00,2024-05-27 18:12:00,AMD,BLR,200.0,231,108,-92,123,20,40,60,80,23,11,9,12,45,21,19,24,71,33,27,38,90,42,38,48,"{'F': 12, 'P': 8}","{'C': 16, 'J': 12, 'Z': 12}","{'Q': 18, 'R': 12, 'S': 6, 'T': 6, 'H': 12, 'M': 6}","{'Y': 6, 'A': 6, 'B': 3, 'D': 3, 'E': 3, 'G': 6, 'I': 3, 'K': 6, 'L': 3, 'N': 3, 'O': 3, 'U': 6, 'V': 3, 'W': 3, 'X': 3}"
INV-ZZ-9936496,SCH-ZZ-3249150,ZZ,ZZ20240413BOMAMD4704.0,4704.0,BAe 146,04/13/2024,2024-04-13 13:45:00,2024-04-13 19:31:00,BOM,AMD,91.0,102,62,-29,40,9,18,27,36,11,7,2,4,21,13,5,8,31,19,8,12,41,25,11,16,"{'F': 5, 'P': 4}","{'C': 7, 'J': 5, 'Z': 5}","{'Q': 8, 'R': 5, 'S': 3, 'T': 3, 'H': 5, 'M': 3}","{'Y': 3, 'A': 3, 'B': 1, 'D': 1, 'E': 1, 'G': 3, 'I': 1, 'K': 3, 'L': 1, 'N': 1, 'O': 1, 'U': 3, 'V': 1, 'W': 1, 'X': 1}"
INV-ZZ-8869205,SCH-ZZ-3249150,ZZ,ZZ20240414BOMAMD4704.0,4704.0,BAe 146,04/14/2024,2024-04-14 13:45:00,2024-04-14 19:31:00,BOM,AMD,91.0,101,63,-28,38,9,18,27,36,10,6,3,4,21,13,5,8,30,19,8,11,41,25,11,16,"{'F': 5, 'P': 4}","{'C': 7, 'J': 5, 'Z': 5}","{'Q': 8, 'R': 5, 'S': 3, 'T': 3, 'H': 5, 'M': 3}","{'Y': 3, 'A': 3, 'B': 1, 'D': 1, 'E': 1, 'G': 3, 'I': 1, 'K': 3, 'L': 1, 'N': 1, 'O': 1, 'U': 3, 'V': 1, 'W': 1, 'X': 1}"
INV-ZZ-6029799,SCH-ZZ-3249150,ZZ,ZZ20240415BOMAMD4704.0,4704.0,BAe 146,04/15/2024,2024-04-15 13:45:00,2024-04-15 19:31:00,BOM,AMD,91.0,108,60,-31,48,9,18,27,36,11,6,3,5,21,12,6,9,31,17,10,14,41,23,13,18,"{'F': 5, 'P': 4}","{'C': 7, 'J': 5, 'Z': 5}","{'Q': 8, 'R': 5, 'S': 3, 'T': 3, 'H': 5, 'M': 3}","{'Y': 3, 'A': 3, 'B': 1, 'D': 1, 'E': 1, 'G': 3, 'I': 1, 'K': 3, 'L': 1, 'N': 1, 'O': 1, 'U': 3, 'V': 1, 'W': 1, 'X': 1}"
INV-ZZ-7403881,SCH-ZZ-3249150,ZZ,ZZ20240417BOMAMD4704.0,4704.0,BAe 146,04/17/2024,2024-04-17 13:45:00,2024-04-17 19:31:00,BOM,AMD,91.0,101,62,-29,39,9,18,27,36,11,7,2,4,20,12,6,8,30,18,9,12,40,25,11,15,"{'F': 5, 'P': 4}","{'C': 7, 'J': 5, 'Z': 5}","{'Q': 8, 'R': 5, 'S': 3, 'T': 3, 'H': 5, 'M': 3}","{'Y': 3, 'A': 3, 'B': 1, 'D': 1, 'E': 1, 'G': 3, 'I': 1, 'K': 3, 'L': 1, 'N': 1, 'O': 1, 'U': 3, 'V': 1, 'W': 1, 'X': 1}"
INV-ZZ-4396538,SCH-ZZ-3249150,ZZ,ZZ20240420BOMAMD4704.0,4704.0,BAe 146,04/20/2024,2024-04-20 13:45:00,2024-04-20 19:31:00,BOM,AMD,91.0,102,61,-30,41,9,18,27,36,11,7,2,4,21,13,5,8,30,18,9,12,41,25,11,16,"{'F': 5, 'P': 4}","{'C': 7, 'J': 5, 'Z': 5}","{'Q': 8, 'R': 5, 'S': 3, 'T': 3, 'H': 5, 'M': 3}","{'Y': 3, 'A': 3, 'B': 1, 'D': 1, 'E': 1, 'G': 3, 'I': 1, 'K': 3, 'L': 1, 'N': 1, 'O': 1, 'U': 3, 'V': 1, 'W': 1, 'X': 1}"
INV-ZZ-4137684,SCH-ZZ-3249150,ZZ,ZZ20240421BOMAMD4704.0,4704.0,BAe 146,04/21/2024,2024-04-21 13:45:00,2024-04-21 19:31:00,BOM,AMD,91.0,109,63,-28,46,9,18,27,36,11,6,3,5,20,12,6,8,32,19,8,13,40,23,13,17,"{'F': 5, 'P': 4}","{'C': 7, 'J': 5, 'Z': 5}","{'Q': 8, 'R': 5, 'S': 3, 'T': 3, 'H': 5, 'M': 3}","{'Y': 3, 'A': 3, 'B': 1, 'D': 1, 'E': 1, 'G': 3, 'I': 1, 'K': 3, 'L': 1, 'N': 1, 'O': 1, 'U': 3, 'V': 1, 'W': 1, 'X': 1}"
INV-ZZ-3950022,SCH-ZZ-3249150,ZZ,ZZ20240422BOMAMD4704.0,4704.0,BAe 146,04/22/2024,2024-04-22 13:45:00,2024-04-22 19:31:00,BOM,AMD,91.0,103,62,-29,41,9,18,27,36,11,7,2,4,21,13,5,8,31,19,8,12,40,24,12,16,"{'F': 5, 'P': 4}","{'C': 7, 'J': 5, 'Z': 5}","{'Q': 8, 'R': 5, 'S': 3, 'T': 3, 'H': 5, 'M': 3}","{'Y': 3, 'A': 3, 'B': 1, 'D': 1, 'E': 1, 'G': 3, 'I': 1, 'K': 3, 'L': 1, 'N': 1, 'O': 1, 'U': 3, 'V': 1, 'W': 1, 'X': 1}"
INV-ZZ-2376230,SCH-ZZ-3249150,ZZ,ZZ20240424BOMAMD4704.0,4704.0,BAe 146,04/24/2024,2024-04-24 13:45:00,2024-04-24 19:31:00,BOM,AMD,91.0,100,54,-37,46,9,18,27,36,10,5,4,5,22,12,6,10,31,17,10,14,41,22,14,19,"{'F': 5, 'P': 4}","{'C': 7, 'J': 5, 'Z': 5}","{'Q': 8, 'R': 5, 'S': 3, 'T': 3, 'H': 5, 'M': 3}","{'Y': 3, 'A': 3, 'B': 1, 'D': 1, 'E': 1, 'G': 3, 'I': 1, 'K': 3, 'L': 1, 'N': 1, 'O': 1, 'U': 3, 'V': 1, 'W': 1, 'X': 1}"
INV-ZZ-9440680,SCH-ZZ-3249150,ZZ,ZZ20240427BOMAMD4704.0,4704.0,BAe 146,04/27/2024,2024-04-27 13:45:00,2024-04-27 19:31:00,BOM,AMD,91.0,105,62,-29,43,9,18,27,36,10,6,3,4,20,12,6,8,31,18,9,13,40,24,12,16,"{'F': 5, 'P': 4}","{'C': 7, 'J': 5, 'Z': 5}","{'Q': 8, 'R': 5, 'S': 3, 'T': 3, 'H': 5, 'M': 3}","{'Y': 3, 'A': 3, 'B': 1, 'D': 1, 'E': 1, 'G': 3, 'I': 1, 'K': 3, 'L': 1, 'N': 1, 'O': 1, 'U': 3, 'V': 1, 'W': 1, 'X': 1}"
INV-ZZ-7010715,SCH-ZZ-3249150,ZZ,ZZ20240428BOMAMD4704.0,4704.0,BAe 146,04/28/2024,2024-04-28 13:45:00,2024-04-28 19:31:00,BOM,AMD,91.0,108,59,-32,49,9,18,27,36,10,5,4,5,22,12,6,10,31,17,10,14,41,22,14,19,"{'F': 5, 'P': 4}","{'C': 7, 'J': 5, 'Z': 5}","{'Q': 8, 'R': 5, 'S': 3, 'T': 3, 'H': 5, 'M': 3}","{'Y': 3, 'A': 3, 'B': 1, 'D': 1, 'E': 1, 'G': 3, 'I': 1, 'K': 3, 'L': 1, 'N': 1, 'O': 1, 'U': 3, 'V': 1, 'W': 1, 'X': 1}"
INV-ZZ-4416867,SCH-ZZ-3249150,ZZ,ZZ20240429BOMAMD4704.0,4704.0,BAe 146,04/29/2024,2024-04-29 13:45:00,2024-04-29 19:31:00,BOM,AMD,91.0,103,58,-33,45,9,18,27,36,10,6,3,4,20,11,7,9,32,18,9,14,41,23,13,18,"{'F': 5, 'P': 4}","{'C': 7, 'J': 5, 'Z': 5}","{'Q': 8, 'R': 5, 'S': 3, 'T': 3, 'H': 5, 'M': 3}","{'Y': 3, 'A': 3, 'B': 1, 'D': 1, 'E': 1, 'G': 3, 'I': 1, 'K': 3, 'L': 1, 'N': 1, 'O': 1, 'U': 3, 'V': 1, 'W': 1, 'X': 1}"
INV-ZZ-4902419,SCH-ZZ-3249150,ZZ,ZZ20240501BOMAMD4704.0,4704.0,BAe 146,05/01/2024,2024-05-01 13:45:00,2024-05-01 19:31:00,BOM,AMD,91.0,101,57,-34,44,9,18,27,36,11,6,3,5,20,11,7,9,30,17,10,13,40,22,14,18,"{'F': 5, 'P': 4}","{'C': 7, 'J': 5, 'Z': 5}","{'Q': 8, 'R': 5, 'S': 3, 'T': 3, 'H': 5, 'M': 3}","{'Y': 3, 'A': 3, 'B': 1, 'D': 1, 'E': 1, 'G': 3, 'I': 1, 'K': 3, 'L': 1, 'N': 1, 'O': 1, 'U': 3, 'V': 1, 'W': 1, 'X': 1}"
INV-ZZ-9396396,SCH-ZZ-3249150,ZZ,ZZ20240504BOMAMD4704.0,4704.0,BAe 146,05/04/2024,2024-05-04 13:45:00,2024-05-04 19:31:00,BOM,AMD,91.0,102,54,-37,48,9,18,27,36,11,6,3,5,21,11,7,10,31,17,10,14,42,22,14,20,"{'F': 5, 'P': 4}","{'C': 7, 'J': 5, 'Z': 5}","{'Q': 8, 'R': 5, 'S': 3, 'T': 3, 'H': 5, 'M': 3}","{'Y': 3, 'A': 3, 'B': 1, 'D': 1, 'E': 1, 'G': 3, 'I': 1, 'K': 3, 'L': 1, 'N': 1, 'O': 1, 'U': 3, 'V': 1, 'W': 1, 'X': 1}"
INV-ZZ-7921793,SCH-ZZ-3249150,ZZ,ZZ20240505BOMAMD4704.0,4704.0,BAe 146,05/05/2024,2024-05-05 13:45:00,2024-05-05 19:31:00,BOM,AMD,91.0,106,56,-35,50,9,18,27,36,10,5,4,5,21,11,7,10,31,16,11,15,42,22,14,20,"{'F': 5, 'P': 4}","{'C': 7, 'J': 5, 'Z': 5}","{'Q': 8, 'R': 5, 'S': 3, 'T': 3, 'H': 5, 'M': 3}","{'Y': 3, 'A': 3, 'B': 1, 'D': 1, 'E': 1, 'G': 3, 'I': 1, 'K': 3, 'L': 1, 'N': 1, 'O': 1, 'U': 3, 'V': 1, 'W': 1, 'X': 1}"
INV-ZZ-2849755,SCH-ZZ-3249150,ZZ,ZZ20240506BOMAMD4704.0,4704.0,BAe 146,05/06/2024,2024-05-06 13:45:00,2024-05-06 19:31:00,BOM,AMD,91.0,105,59,-32,46,9,18,27,36,11,6,3,5,21,12,6,9,30,17,10,13,40,22,14,18,"{'F': 5, 'P': 4}","{'C': 7, 'J': 5, 'Z': 5}","{'Q': 8, 'R': 5, 'S': 3, 'T': 3, 'H': 5, 'M': 3}","{'Y': 3, 'A': 3, 'B': 1, 'D': 1, 'E': 1, 'G': 3, 'I': 1, 'K': 3, 'L': 1, 'N': 1, 'O': 1, 'U': 3, 'V': 1, 'W': 1, 'X': 1}"
INV-ZZ-8343368,SCH-ZZ-3249150,ZZ,ZZ20240508BOMAMD4704.0,4704.0,BAe 146,05/08/2024,2024-05-08 13:45:00,2024-05-08 19:31:00,BOM,AMD,91.0,101,51,-40,50,9,18,27,36,10,5,4,5,21,11,7,10,32,16,11,16,41,21,15,20,"{'F': 5, 'P': 4}","{'C': 7, 'J': 5, 'Z': 5}","{'Q': 8, 'R': 5, 'S': 3, 'T': 3, 'H': 5, 'M': 3}","{'Y': 3, 'A': 3, 'B': 1, 'D': 1, 'E': 1, 'G': 3, 'I': 1, 'K': 3, 'L': 1, 'N': 1, 'O': 1, 'U': 3, 'V': 1, 'W': 1, 'X': 1}"
INV-ZZ-9166592,SCH-ZZ-3249150,ZZ,ZZ20240511BOMAMD4704.0,4704.0,BAe 146,05/11/2024,2024-05-11 13:45:00,2024-05-11 19:31:00,BOM,AMD,91.0,103,51,-40,52,9,18,27,36,11,5,4,6,20,10,8,10,31,15,12,16,42,21,15,21,"{'F': 5, 'P': 4}","{'C': 7, 'J': 5, 'Z': 5}","{'Q': 8, 'R': 5, 'S': 3, 'T': 3, 'H': 5, 'M': 3}","{'Y': 3, 'A': 3, 'B': 1, 'D': 1, 'E': 1, 'G': 3, 'I': 1, 'K': 3, 'L': 1, 'N': 1, 'O': 1, 'U': 3, 'V': 1, 'W': 1, 'X': 1}"
INV-ZZ-5899518,SCH-ZZ-3249150,ZZ,ZZ20240512BOMAMD4704.0,4704.0,BAe 146,05/12/2024,2024-05-12 13:45:00,2024-05-12 19:31:00,BOM,AMD,91.0,105,53,-38,52,9,18,27,36,10,5,4,5,21,11,7,10,31,16,11,15,40,20,16,20,"{'F': 5, 'P': 4}","{'C': 7, 'J': 5, 'Z': 5}","{'Q': 8, 'R': 5, 'S': 3, 'T': 3, 'H': 5, 'M': 3}","{'Y': 3, 'A': 3, 'B': 1, 'D': 1, 'E': 1, 'G': 3, 'I': 1, 'K': 3, 'L': 1, 'N': 1, 'O': 1, 'U': 3, 'V': 1, 'W': 1, 'X': 1}"
INV-ZZ-9522445,SCH-ZZ-3249150,ZZ,ZZ20240513BOMAMD4704.0,4704.0,BAe 146,05/13/2024,2024-05-13 13:45:00,2024-05-13 19:31:00,BOM,AMD,91.0,104,57,-34,47,9,18,27,36,10,5,4,5,20,11,7,9,31,17,10,14,42,23,13,19,"{'F': 5, 'P': 4}","{'C': 7, 'J': 5, 'Z': 5}","{'Q': 8, 'R': 5, 'S': 3, 'T': 3, 'H': 5, 'M': 3}","{'Y': 3, 'A': 3, 'B': 1, 'D': 1, 'E': 1, 'G': 3, 'I': 1, 'K': 3, 'L': 1, 'N': 1, 'O': 1, 'U': 3, 'V': 1, 'W': 1, 'X': 1}"
INV-ZZ-1769110,SCH-ZZ-3249150,ZZ,ZZ20240515BOMAMD4704.0,4704.0,BAe 146,05/15/2024,2024-05-15 13:45:00,2024-05-15 19:31:00,BOM,AMD,91.0,101,49,-42,52,9,18,27,36,10,5,4,5,21,10,8,11,31,15,12,16,42,20,16,22,"{'F': 5, 'P': 4}","{'C': 7, 'J': 5, 'Z': 5}","{'Q': 8, 'R': 5, 'S': 3, 'T': 3, 'H': 5, 'M': 3}","{'Y': 3, 'A': 3, 'B': 1, 'D': 1, 'E': 1, 'G': 3, 'I': 1, 'K': 3, 'L': 1, 'N': 1, 'O': 1, 'U': 3, 'V': 1, 'W': 1, 'X': 1}"
INV-ZZ-3483223,SCH-ZZ-3249150,ZZ,ZZ20240518BOMAMD4704.0,4704.0,BAe 146,05/18/2024,2024-05-18 13:45:00,2024-05-18 19:31:00,BOM,AMD,91.0,108,55,-36,53,9,18,27,36,10,5,4,5,21,11,7,10,32,16,11,16,40,20,16,20,"{'F': 5, 'P': 4}","{'C': 7, 'J': 5, 'Z': 5}","{'Q': 8, 'R': 5, 'S': 3, 'T': 3, 'H': 5, 'M': 3}","{'Y': 3, 'A': 3, 'B': 1, 'D': 1, 'E': 1, 'G': 3, 'I': 1, 'K': 3, 'L': 1, 'N': 1, 'O': 1, 'U': 3, 'V': 1, 'W': 1, 'X': 1}"
INV-ZZ-9960133,SCH-ZZ-3249150,ZZ,ZZ20240519BOMAMD4704.0,4704.0,BAe 146,05/19/2024,2024-05-19 13:45:00,2024-05-19 19:31:00,BOM,AMD,91.0,104,55,-36,49,9,18,27,36,10,5,4,5,20,11,7,9,31,16,11,15,42,22,14,20,"{'F': 5, 'P': 4}","{'C': 7, 'J': 5, 'Z': 5}","{'Q': 8, 'R': 5, 'S': 3, 'T': 3, 'H': 5, 'M': 3}","{'Y': 3, 'A': 3, 'B': 1, 'D': 1, 'E': 1, 'G': 3, 'I': 1, 'K': 3, 'L': 1, 'N': 1, 'O': 1, 'U': 3, 'V': 1, 'W': 1, 'X': 1}"
INV-ZZ-8092261,SCH-ZZ-3249150,ZZ,ZZ20240520BOMAMD4704.0,4704.0,BAe 146,05/20/2024,2024-05-20 13:45:00,2024-05-20 19:31:00,BOM,AMD,91.0,100,52,-39,48,9,18,27,36,11,6,3,5,20,10,8,10,30,16,11,14,42,22,14,20,"{'F': 5, 'P': 4}","{'C': 7, 'J': 5, 'Z': 5}","{'Q': 8, 'R': 5, 'S': 3, 'T': 3, 'H': 5, 'M': 3}","{'Y': 3, 'A': 3, 'B': 1, 'D': 1, 'E': 1, 'G': 3, 'I': 1, 'K': 3, 'L': 1, 'N': 1, 'O': 1, 'U': 3, 'V': 1, 'W': 1, 'X': 1}"
INV-ZZ-4345508,SCH-ZZ-3249150,ZZ,ZZ20240522BOMAMD4704.0,4704.0,BAe 146,05/22/2024,2024-05-22 13:45:00,2024-05-22 19:31:00,BOM,AMD,91.0,107,54,-37,53,9,18,27,36,11,6,3,5,20,10,8,10,31,16,11,15,40,20,16,20,"{'F': 5, 'P': 4}","{'C': 7, 'J': 5, 'Z': 5}","{'Q': 8, 'R': 5, 'S': 3, 'T': 3, 'H': 5, 'M': 3}","{'Y': 3, 'A': 3, 'B': 1, 'D': 1, 'E': 1, 'G': 3, 'I': 1, 'K': 3, 'L': 1, 'N': 1, 'O': 1, 'U': 3, 'V': 1, 'W': 1, 'X': 1}"
INV-ZZ-7811121,SCH-ZZ-3249150,ZZ,ZZ20240525BOMAMD4704.0,4704.0,BAe 146,05/25/2024,2024-05-25 13:45:00,2024-05-25 19:31:00,BOM,AMD,91.0,108,53,-38,55,9,18,27,36,11,5,4,6,20,10,8,10,32,16,11,16,40,20,16,20,"{'F': 5, 'P': 4}","{'C': 7, 'J': 5, 'Z': 5}","{'Q': 8, 'R': 5, 'S': 3, 'T': 3, 'H': 5, 'M': 3}","{'Y': 3, 'A': 3, 'B': 1, 'D': 1, 'E': 1, 'G': 3, 'I': 1, 'K': 3, 'L': 1, 'N': 1, 'O': 1, 'U': 3, 'V': 1, 'W': 1, 'X': 1}"
INV-ZZ-5846170,SCH-ZZ-3249150,ZZ,ZZ20240526BOMAMD4704.0,4704.0,BAe 146,05/26/2024,2024-05-26 13:45:00,2024-05-26 19:31:00,BOM,AMD,91.0,103,50,-41,53,9,18,27,36,11,5,4,6,21,10,8,11,30,15,12,15,41,20,16,21,"{'F': 5, 'P': 4}","{'C': 7, 'J': 5, 'Z': 5}","{'Q': 8, 'R': 5, 'S': 3, 'T': 3, 'H': 5, 'M': 3}","{'Y': 3, 'A': 3, 'B': 1, 'D': 1, 'E': 1, 'G': 3, 'I': 1, 'K': 3, 'L': 1, 'N': 1, 'O': 1, 'U': 3, 'V': 1, 'W': 1, 'X': 1}"
INV-ZZ-4403728,SCH-ZZ-3608272,ZZ,ZZ20240516AMDHYD4341.0,4341.0,Airbus A320-200,05/16/2024,2024-05-16 09:32:00,2024-05-16 16:53:00,AMD,HYD,150.0,174,94,-56,80,15,30,45,60,17,9,6,8,34,18,12,16,52,28,17,24,71,38,22,33,"{'F': 9, 'P': 6}","{'C': 12, 'J': 9, 'Z': 9}","{'Q': 14, 'R': 9, 'S': 4, 'T': 4, 'H': 9, 'M': 4}","{'Y': 4, 'A': 4, 'B': 2, 'D': 2, 'E': 2, 'G': 4, 'I': 2, 'K': 4, 'L': 2, 'N': 2, 'O': 2, 'U': 4, 'V': 2, 'W': 2, 'X': 2}"
INV-ZZ-8305907,SCH-ZZ-3608272,ZZ,ZZ20240518AMDHYD4341.0,4341.0,Airbus A320-200,05/18/2024,2024-05-18 09:32:00,2024-05-18 16:53:00,AMD,HYD,150.0,172,89,-61,83,15,30,45,60,18,9,6,9,33,17,13,16,50,26,19,24,69,36,24,33,"{'F': 9, 'P': 6}","{'C': 12, 'J': 9, 'Z': 9}","{'Q': 14, 'R': 9, 'S': 4, 'T': 4, 'H': 9, 'M': 4}","{'Y': 4, 'A': 4, 'B': 2, 'D': 2, 'E': 2, 'G': 4, 'I': 2, 'K': 4, 'L': 2, 'N': 2, 'O': 2, 'U': 4, 'V': 2, 'W': 2, 'X': 2}"
INV-ZZ-3705458,SCH-ZZ-3608272,ZZ,ZZ20240521AMDHYD4341.0,4341.0,Airbus A320-200,05/21/2024,2024-05-21 09:32:00,2024-05-21 16:53:00,AMD,HYD,150.0,170,80,-70,90,15,30,45,60,18,8,7,10,34,16,14,18,50,24,21,26,69,32,28,37,"{'F': 9, 'P': 6}","{'C': 12, 'J': 9, 'Z': 9}","{'Q': 14, 'R': 9, 'S': 4, 'T': 4, 'H': 9, 'M': 4}","{'Y': 4, 'A': 4, 'B': 2, 'D': 2, 'E': 2, 'G': 4, 'I': 2, 'K': 4, 'L': 2, 'N': 2, 'O': 2, 'U': 4, 'V': 2, 'W': 2, 'X': 2}"
INV-ZZ-4218811,SCH-ZZ-3608272,ZZ,ZZ20240523AMDHYD4341.0,4341.0,Airbus A320-200,05/23/2024,2024-05-23 09:32:00,2024-05-23 16:53:00,AMD,HYD,150.0,175,94,-56,81,15,30,45,60,18,10,5,8,33,18,12,15,52,28,17,24,70,37,23,33,"{'F': 9, 'P': 6}","{'C': 12, 'J': 9, 'Z': 9}","{'Q': 14, 'R': 9, 'S': 4, 'T': 4, 'H': 9, 'M': 4}","{'Y': 4, 'A': 4, 'B': 2, 'D': 2, 'E': 2, 'G': 4, 'I': 2, 'K': 4, 'L': 2, 'N': 2, 'O': 2, 'U': 4, 'V': 2, 'W': 2, 'X': 2}"
INV-ZZ-3619045,SCH-ZZ-3608272,ZZ,ZZ20240525AMDHYD4341.0,4341.0,Airbus A320-200,05/25/2024,2024-05-25 09:32:00,2024-05-25 16:53:00,AMD,HYD,150.0,170,87,-63,83,15,30,45,60,17,9,6,8,35,18,12,17,54,28,17,26,69,35,25,34,"{'F': 9, 'P': 6}","{'C': 12, 'J': 9, 'Z': 9}","{'Q': 14, 'R': 9, 'S': 4, 'T': 4, 'H': 9, 'M': 4}","{'Y': 4, 'A': 4, 'B': 2, 'D': 2, 'E': 2, 'G': 4, 'I': 2, 'K': 4, 'L': 2, 'N': 2, 'O': 2, 'U': 4, 'V': 2, 'W': 2, 'X': 2}"
INV-ZZ-1509697,SCH-ZZ-3608272,ZZ,ZZ20240528AMDHYD4341.0,4341.0,Airbus A320-200,05/28/2024,2024-05-28 09:32:00,2024-05-28 16:53:00,AMD,HYD,150.0,169,78,-72,91,15,30,45,60,18,8,7,10,34,16,14,18,51,24,21,27,71,33,27,38,"{'F': 9, 'P': 6}","{'C': 12, 'J': 9, 'Z': 9}","{'Q': 14, 'R': 9, 'S': 4, 'T': 4, 'H': 9, 'M': 4}","{'Y': 4, 'A': 4, 'B': 2, 'D': 2, 'E': 2, 'G': 4, 'I': 2, 'K': 4, 'L': 2, 'N': 2, 'O': 2, 'U': 4, 'V': 2, 'W': 2, 'X': 2}"
INV-ZZ-1789818,SCH-ZZ-3608272,ZZ,ZZ20240530AMDHYD4341.0,4341.0,Airbus A320-200,05/30/2024,2024-05-30 09:32:00,2024-05-30 16:53:00,AMD,HYD,150.0,170,77,-73,93,15,30,45,60,18,8,7,10,34,15,15,19,51,23,22,28,68,31,29,37,"{'F': 9, 'P': 6}","{'C': 12, 'J': 9, 'Z': 9}","{'Q': 14, 'R': 9, 'S': 4, 'T': 4, 'H': 9, 'M': 4}","{'Y': 4, 'A': 4, 'B': 2, 'D': 2, 'E': 2, 'G': 4, 'I': 2, 'K': 4, 'L': 2, 'N': 2, 'O': 2, 'U': 4, 'V': 2, 'W': 2, 'X': 2}"
INV-ZZ-7872823,SCH-ZZ-3608272,ZZ,ZZ20240601AMDHYD4341.0,4341.0,Airbus A320-200,06/01/2024,2024-06-01 09:32:00,2024-06-01 16:53:00,AMD,HYD,150.0,167,77,-73,90,15,30,45,60,18,8,7,10,34,16,14,18,51,23,22,28,70,32,28,38,"{'F': 9, 'P': 6}","{'C': 12, 'J': 9, 'Z': 9}","{'Q': 14, 'R': 9, 'S': 4, 'T': 4, 'H': 9, 'M': 4}","{'Y': 4, 'A': 4, 'B': 2, 'D': 2, 'E': 2, 'G': 4, 'I': 2, 'K': 4, 'L': 2, 'N': 2, 'O': 2, 'U': 4, 'V': 2, 'W': 2, 'X': 2}"
INV-ZZ-5651881,SCH-ZZ-3608272,ZZ,ZZ20240604AMDHYD4341.0,4341.0,Airbus A320-200,06/04/2024,2024-06-04 09:32:00,2024-06-04 16:53:00,AMD,HYD,150.0,165,72,-78,93,15,30,45,60,17,7,8,10,35,15,15,20,53,23,22,30,68,29,31,39,"{'F': 9, 'P': 6}","{'C': 12, 'J': 9, 'Z': 9}","{'Q': 14, 'R': 9, 'S': 4, 'T': 4, 'H': 9, 'M': 4}","{'Y': 4, 'A': 4, 'B': 2, 'D': 2, 'E': 2, 'G': 4, 'I': 2, 'K': 4, 'L': 2, 'N': 2, 'O': 2, 'U': 4, 'V': 2, 'W': 2, 'X': 2}"
INV-ZZ-4339360,SCH-ZZ-3608272,ZZ,ZZ20240606AMDHYD4341.0,4341.0,Airbus A320-200,06/06/2024,2024-06-06 09:32:00,2024-06-06 16:53:00,AMD,HYD,150.0,179,80,-70,99,15,30,45,60,17,8,7,9,33,15,15,18,51,23,22,28,69,31,29,38,"{'F': 9, 'P': 6}","{'C': 12, 'J': 9, 'Z': 9}","{'Q': 14, 'R': 9, 'S': 4, 'T': 4, 'H': 9, 'M': 4}","{'Y': 4, 'A': 4, 'B': 2, 'D': 2, 'E': 2, 'G': 4, 'I': 2, 'K': 4, 'L': 2, 'N': 2, 'O': 2, 'U': 4, 'V': 2, 'W': 2, 'X': 2}"
INV-ZZ-3492821,SCH-ZZ-3608272,ZZ,ZZ20240608AMDHYD4341.0,4341.0,Airbus A320-200,06/08/2024,2024-06-08 09:32:00,2024-06-08 16:53:00,AMD,HYD,150.0,166,75,-75,91,15,30,45,60,17,8,7,9,35,16,14,19,53,24,21,29,66,30,30,36,"{'F': 9, 'P': 6}","{'C': 12, 'J': 9, 'Z': 9}","{'Q': 14, 'R': 9, 'S': 4, 'T': 4, 'H': 9, 'M': 4}","{'Y': 4, 'A': 4, 'B': 2, 'D': 2, 'E': 2, 'G': 4, 'I': 2, 'K': 4, 'L': 2, 'N': 2, 'O': 2, 'U': 4, 'V': 2, 'W': 2, 'X': 2}"
INV-ZZ-1507983,SCH-ZZ-3608272,ZZ,ZZ20240611AMDHYD4341.0,4341.0,Airbus A320-200,06/11/2024,2024-06-11 09:32:00,2024-06-11 16:53:00,AMD,HYD,150.0,165,77,-73,88,15,30,45,60,17,8,7,9,36,17,13,19,51,24,21,27,66,31,29,35,"{'F': 9, 'P': 6}","{'C': 12, 'J': 9, 'Z': 9}","{'Q': 14, 'R': 9, 'S': 4, 'T': 4, 'H': 9, 'M': 4}","{'Y': 4, 'A': 4, 'B': 2, 'D': 2, 'E': 2, 'G': 4, 'I': 2, 'K': 4, 'L': 2, 'N': 2, 'O': 2, 'U': 4, 'V': 2, 'W': 2, 'X': 2}"
INV-ZZ-2997334,SCH-ZZ-3608272,ZZ,ZZ20240613AMDHYD4341.0,4341.0,Airbus A320-200,06/13/2024,2024-06-13 09:32:00,2024-06-13 16:53:00,AMD,HYD,150.0,166,79,-71,87,15,30,45,60,18,9,6,9,33,16,14,17,51,24,21,27,72,34,26,38,"{'F': 9, 'P': 6}","{'C': 12, 'J': 9, 'Z': 9}","{'Q': 14, 'R': 9, 'S': 4, 'T': 4, 'H': 9, 'M': 4}","{'Y': 4, 'A': 4, 'B': 2, 'D': 2, 'E': 2, 'G': 4, 'I': 2, 'K': 4, 'L': 2, 'N': 2, 'O': 2, 'U': 4, 'V': 2, 'W': 2, 'X': 2}"
INV-ZZ-8966287,SCH-ZZ-3608272,ZZ,ZZ20240615AMDHYD4341.0,4341.0,Airbus A320-200,06/15/2024,2024-06-15 09:32:00,2024-06-15 16:53:00,AMD,HYD,150.0,177,78,-72,99,15,30,45,60,17,7,8,10,35,15,15,20,53,23,22,30,72,32,28,40,"{'F': 9, 'P': 6}","{'C': 12, 'J': 9, 'Z': 9}","{'Q': 14, 'R': 9, 'S': 4, 'T': 4, 'H': 9, 'M': 4}","{'Y': 4, 'A': 4, 'B': 2, 'D': 2, 'E': 2, 'G': 4, 'I': 2, 'K': 4, 'L': 2, 'N': 2, 'O': 2, 'U': 4, 'V': 2, 'W': 2, 'X': 2}"
INV-ZZ-2921679,SCH-ZZ-3608272,ZZ,ZZ20240618AMDHYD4341.0,4341.0,Airbus A320-200,06/18/2024,2024-06-18 09:32:00,2024-06-18 16:53:00,AMD,HYD,150.0,169,79,-71,90,15,30,45,60,17,8,7,9,36,17,13,19,52,24,21,28,70,33,27,37,"{'F': 9, 'P': 6}","{'C': 12, 'J': 9, 'Z': 9}","{'Q': 14, 'R': 9, 'S': 4, 'T': 4, 'H': 9, 'M': 4}","{'Y': 4, 'A': 4, 'B': 2, 'D': 2, 'E': 2, 'G': 4, 'I': 2, 'K': 4, 'L': 2, 'N': 2, 'O': 2, 'U': 4, 'V': 2, 'W': 2, 'X': 2}"
INV-ZZ-3854836,SCH-ZZ-3608272,ZZ,ZZ20240620AMDHYD4341.0,4341.0,Airbus A320-200,06/20/2024,2024-06-20 09:32:00,2024-06-20 16:53:00,AMD,HYD,150.0,166,70,-80,96,15,30,45,60,17,7,8,10,35,15,15,20,53,22,23,31,68,29,31,39,"{'F': 9, 'P': 6}","{'C': 12, 'J': 9, 'Z': 9}","{'Q': 14, 'R': 9, 'S': 4, 'T': 4, 'H': 9, 'M': 4}","{'Y': 4, 'A': 4, 'B': 2, 'D': 2, 'E': 2, 'G': 4, 'I': 2, 'K': 4, 'L': 2, 'N': 2, 'O': 2, 'U': 4, 'V': 2, 'W': 2, 'X': 2}"
INV-ZZ-9407249,SCH-ZZ-3608272,ZZ,ZZ20240622AMDHYD4341.0,4341.0,Airbus A320-200,06/22/2024,2024-06-22 09:32:00,2024-06-22 16:53:00,AMD,HYD,150.0,179,72,-78,107,15,30,45,60,18,7,8,11,35,14,16,21,53,21,24,32,67,27,33,40,"{'F': 9, 'P': 6}","{'C': 12, 'J': 9, 'Z': 9}","{'Q': 14, 'R': 9, 'S': 4, 'T': 4, 'H': 9, 'M': 4}","{'Y': 4, 'A': 4, 'B': 2, 'D': 2, 'E': 2, 'G': 4, 'I': 2, 'K': 4, 'L': 2, 'N': 2, 'O': 2, 'U': 4, 'V': 2, 'W': 2, 'X': 2}"
INV-ZZ-7953855,SCH-ZZ-3608272,ZZ,ZZ20240625AMDHYD4341.0,4341.0,Airbus A320-200,06/25/2024,2024-06-25 09:32:00,2024-06-25 16:53:00,AMD,HYD,150.0,179,79,-71,100,15,30,45,60,18,8,7,10,34,15,15,19,51,22,23,29,70,31,29,39,"{'F': 9, 'P': 6}","{'C': 12, 'J': 9, 'Z': 9}","{'Q': 14, 'R': 9, 'S': 4, 'T': 4, 'H': 9, 'M': 4}","{'Y': 4, 'A': 4, 'B': 2, 'D': 2, 'E': 2, 'G': 4, 'I': 2, 'K': 4, 'L': 2, 'N': 2, 'O': 2, 'U': 4, 'V': 2, 'W': 2, 'X': 2}"
INV-ZZ-8157571,SCH-ZZ-3608272,ZZ,ZZ20240627AMDHYD4341.0,4341.0,Airbus A320-200,06/27/2024,2024-06-27 09:32:00,2024-06-27 16:53:00,AMD,HYD,150.0,170,74,-76,96,15,30,45,60,17,7,8,10,33,14,16,19,54,23,22,31,68,30,30,38,"{'F': 9, 'P': 6}","{'C': 12, 'J': 9, 'Z': 9}","{'Q': 14, 'R': 9, 'S': 4, 'T': 4, 'H': 9, 'M': 4}","{'Y': 4, 'A': 4, 'B': 2, 'D': 2, 'E': 2, 'G': 4, 'I': 2, 'K': 4, 'L': 2, 'N': 2, 'O': 2, 'U': 4, 'V': 2, 'W': 2, 'X': 2}"
INV-ZZ-3620339,SCH-ZZ-3608272,ZZ,ZZ20240629AMDHYD4341.0,4341.0,Airbus A320-200,06/29/2024,2024-06-29 09:32:00,2024-06-29 16:53:00,AMD,HYD,150.0,170,71,-79,99,15,30,45,60,18,8,7,10,34,14,16,20,50,21,24,29,71,30,30,41,"{'F': 9, 'P': 6}","{'C': 12, 'J': 9, 'Z': 9}","{'Q': 14, 'R': 9, 'S': 4, 'T': 4, 'H': 9, 'M': 4}","{'Y': 4, 'A': 4, 'B': 2, 'D': 2, 'E': 2, 'G': 4, 'I': 2, 'K': 4, 'L': 2, 'N': 2, 'O': 2, 'U': 4, 'V': 2, 'W': 2, 'X': 2}"
INV-ZZ-1748690,SCH-ZZ-2693534,ZZ,ZZ20240408MAACJB4341.0,4341.0,Boeing 757,04/08/2024,2024-04-08 17:09:00,2024-04-08 22:11:00,MAA,CJB,209.0,235,156,-53,79,20,41,62,83,22,15,5,7,47,31,10,16,74,49,13,25,96,64,19,32,"{'F': 12, 'P': 8}","{'C': 16, 'J': 12, 'Z': 12}","{'Q': 19, 'R': 12, 'S': 6, 'T': 6, 'H': 12, 'M': 6}","{'Y': 6, 'A': 6, 'B': 3, 'D': 3, 'E': 3, 'G': 6, 'I': 3, 'K': 6, 'L': 3, 'N': 3, 'O': 3, 'U': 6, 'V': 3, 'W': 3, 'X': 3}"
INV-ZZ-5237537,SCH-ZZ-2693534,ZZ,ZZ20240415MAACJB4341.0,4341.0,Boeing 757,04/15/2024,2024-04-15 17:09:00,2024-04-15 22:11:00,MAA,CJB,209.0,230,127,-82,103,20,41,62,83,23,13,7,10,48,26,15,22,69,38,24,31,97,53,30,44,"{'F': 12, 'P': 8}","{'C': 16, 'J': 12, 'Z': 12}","{'Q': 19, 'R': 12, 'S': 6, 'T': 6, 'H': 12, 'M': 6}","{'Y': 6, 'A': 6, 'B': 3, 'D': 3, 'E': 3, 'G': 6, 'I': 3, 'K': 6, 'L': 3, 'N': 3, 'O': 3, 'U': 6, 'V': 3, 'W': 3, 'X': 3}"
INV-ZZ-3994892,SCH-ZZ-2693534,ZZ,ZZ20240422MAACJB4341.0,4341.0,Boeing 757,04/22/2024,2024-04-22 17:09:00,2024-04-22 22:11:00,MAA,CJB,209.0,231,135,-74,96,20,41,62,83,23,13,7,10,48,28,13,20,72,42,20,30,92,54,29,38,"{'F': 12, 'P': 8}","{'C': 16, 'J': 12, 'Z': 12}","{'Q': 19, 'R': 12, 'S': 6, 'T': 6, 'H': 12, 'M': 6}","{'Y': 6, 'A': 6, 'B': 3, 'D': 3, 'E': 3, 'G': 6, 'I': 3, 'K': 6, 'L': 3, 'N': 3, 'O': 3, 'U': 6, 'V': 3, 'W': 3, 'X': 3}"
INV-ZZ-7631262,SCH-ZZ-2693534,ZZ,ZZ20240429MAACJB4341.0,4341.0,Boeing 757,04/29/2024,2024-04-29 17:09:00,2024-04-29 22:11:00,MAA,CJB,209.0,246,131,-78,115,20,41,62,83,22,12,8,10,49,26,15,23,69,37,25,32,98,52,31,46,"{'F': 12, 'P': 8}","{'C': 16, 'J': 12, 'Z': 12}","{'Q': 19, 'R': 12, 'S': 6, 'T': 6, 'H': 12, 'M': 6}","{'Y': 6, 'A': 6, 'B': 3, 'D': 3, 'E': 3, 'G': 6, 'I': 3, 'K': 6, 'L': 3, 'N': 3, 'O': 3, 'U': 6, 'V': 3, 'W': 3, 'X': 3}"
INV-ZZ-8689644,SCH-ZZ-2693534,ZZ,ZZ20240506MAACJB4341.0,4341.0,Boeing 757,05/06/2024,2024-05-06 17:09:00,2024-05-06 22:11:00,MAA,CJB,209.0,243,128,-81,115,20,41,62,83,24,13,7,11,47,25,16,22,71,37,25,34,92,49,34,43,"{'F': 12, 'P': 8}","{'C': 16, 'J': 12, 'Z': 12}","{'Q': 19, 'R': 12, 'S': 6, 'T': 6, 'H': 12, 'M': 6}","{'Y': 6, 'A': 6, 'B': 3, 'D': 3, 'E': 3, 'G': 6, 'I': 3, 'K': 6, 'L': 3, 'N': 3, 'O': 3, 'U': 6, 'V': 3, 'W': 3, 'X': 3}"
INV-ZZ-4805867,SCH-ZZ-2693534,ZZ,ZZ20240513MAACJB4341.0,4341.0,Boeing 757,05/13/2024,2024-05-13 17:09:00,2024-05-13 22:11:00,MAA,CJB,209.0,233,114,-95,119,20,41,62,83,24,12,8,12,46,22,19,24,70,34,28,36,94,46,37,48,"{'F': 12, 'P': 8}","{'C': 16, 'J': 12, 'Z': 12}","{'Q': 19, 'R': 12, 'S': 6, 'T': 6, 'H': 12, 'M': 6}","{'Y': 6, 'A': 6, 'B': 3, 'D': 3, 'E': 3, 'G': 6, 'I': 3, 'K': 6, 'L': 3, 'N': 3, 'O': 3, 'U': 6, 'V': 3, 'W': 3, 'X': 3}"
INV-ZZ-1555095,SCH-ZZ-2693534,ZZ,ZZ20240520MAACJB4341.0,4341.0,Boeing 757,05/20/2024,2024-05-20 17:09:00,2024-05-20 22:11:00,MAA,CJB,209.0,233,119,-90,114,20,41,62,83,24,12,8,12,45,23,18,22,72,37,25,35,99,51,32,48,"{'F': 12, 'P': 8}","{'C': 16, 'J': 12, 'Z': 12}","{'Q': 19, 'R': 12, 'S': 6, 'T': 6, 'H': 12, 'M': 6}","{'Y': 6, 'A': 6, 'B': 3, 'D': 3, 'E': 3, 'G': 6, 'I': 3, 'K': 6, 'L': 3, 'N': 3, 'O': 3, 'U': 6, 'V': 3, 'W': 3, 'X': 3}"
INV-ZZ-2384101,SCH-ZZ-7589545,ZZ,ZZ20240406MAATRV2008.0,2008.0,Boeing 787,04/06/2024,2024-04-06 02:25:00,2024-04-06 21:44:00,MAA,TRV,270.0,322,196,-74,126,27,54,81,108,31,19,8,12,62,38,16,24,94,57,24,37,120,73,35,47,"{'F': 16, 'P': 11}","{'C': 22, 'J': 16, 'Z': 16}","{'Q': 24, 'R': 16, 'S': 8, 'T': 8, 'H': 16, 'M': 8}","{'Y': 8, 'A': 8, 'B': 4, 'D': 4, 'E': 4, 'G': 8, 'I': 4, 'K': 8, 'L': 4, 'N': 4, 'O': 4, 'U': 8, 'V': 4, 'W': 4, 'X': 4}"
INV-ZZ-3417474,SCH-ZZ-7589545,ZZ,ZZ20240407MAATRV2008.0,2008.0,Boeing 787,04/07/2024,2024-04-07 02:25:00,2024-04-07 21:44:00,MAA,TRV,270.0,298,177,-93,121,27,54,81,108,31,18,9,13,63,37,17,26,94,56,25,38,124,74,34,50,"{'F': 16, 'P': 11}","{'C': 22, 'J': 16, 'Z': 16}","{'Q': 24, 'R': 16, 'S': 8, 'T': 8, 'H': 16, 'M': 8}","{'Y': 8, 'A': 8, 'B': 4, 'D': 4, 'E': 4, 'G': 8, 'I': 4, 'K': 8, 'L': 4, 'N': 4, 'O': 4, 'U': 8, 'V': 4, 'W': 4, 'X': 4}"
INV-ZZ-6550612,SCH-ZZ-7589545,ZZ,ZZ20240409MAATRV2008.0,2008.0,Boeing 787,04/09/2024,2024-04-09 02:25:00,2024-04-09 21:44:00,MAA,TRV,270.0,314,196,-74,118,27,54,81,108,31,19,8,12,62,39,15,23,90,56,25,34,119,74,34,45,"{'F': 16, 'P': 11}","{'C': 22, 'J': 16, 'Z': 16}","{'Q': 24, 'R': 16, 'S': 8, 'T': 8, 'H': 16, 'M': 8}","{'Y': 8, 'A': 8, 'B': 4, 'D': 4, 'E': 4, 'G': 8, 'I': 4, 'K': 8, 'L': 4, 'N': 4, 'O': 4, 'U': 8, 'V': 4, 'W': 4, 'X': 4}"
INV-ZZ-7954823,SCH-ZZ-7589545,ZZ,ZZ20240410MAATRV2008.0,2008.0,Boeing 787,04/10/2024,2024-04-10 02:25:00,2024-04-10 21:44:00,MAA,TRV,270.0,316,184,-86,132,27,54,81,108,31,18,9,13,64,37,17,27,90,52,29,38,123,72,36,51,"{'F': 16, 'P': 11}","{'C': 22, 'J': 16, 'Z': 16}","{'Q': 24, 'R': 16, 'S': 8, 'T': 8, 'H': 16, 'M': 8}","{'Y': 8, 'A': 8, 'B': 4, 'D': 4, 'E': 4, 'G': 8, 'I': 4, 'K': 8, 'L': 4, 'N': 4, 'O': 4, 'U': 8, 'V': 4, 'W': 4, 'X': 4}"
INV-ZZ-7863792,SCH-ZZ-7589545,ZZ,ZZ20240411MAATRV2008.0,2008.0,Boeing 787,04/11/2024,2024-04-11 02:25:00,2024-04-11 21:44:00,MAA,TRV,270.0,298,180,-90,118,27,54,81,108,31,19,8,12,60,36,18,24,90,55,26,35,121,73,35,48,"{'F': 16, 'P': 11}","{'C': 22, 'J': 16, 'Z': 16}","{'Q': 24, 'R': 16, 'S': 8, 'T': 8, 'H': 16, 'M': 8}","{'Y': 8, 'A': 8, 'B': 4, 'D': 4, 'E': 4, 'G': 8, 'I': 4, 'K': 8, 'L': 4, 'N': 4, 'O': 4, 'U': 8, 'V': 4, 'W': 4, 'X': 4}"
INV-ZZ-8927770,SCH-ZZ-7589545,ZZ,ZZ20240413MAATRV2008.0,2008.0,Boeing 787,04/13/2024,2024-04-13 02:25:00,2024-04-13 21:44:00,MAA,TRV,270.0,315,191,-79,124,27,54,81,108,32,19,8,13,59,36,18,23,91,55,26,36,124,75,33,49,"{'F': 16, 'P': 11}","{'C': 22, 'J': 16, 'Z': 16}","{'Q': 24, 'R': 16, 'S': 8, 'T': 8, 'H': 16, 'M': 8}","{'Y': 8, 'A': 8, 'B': 4, 'D': 4, 'E': 4, 'G': 8, 'I': 4, 'K': 8, 'L': 4, 'N': 4, 'O': 4, 'U': 8, 'V': 4, 'W': 4, 'X': 4}"
INV-ZZ-6384369,SCH-ZZ-7589545,ZZ,ZZ20240414MAATRV2008.0,2008.0,Boeing 787,04/14/2024,2024-04-14 02:25:00,2024-04-14 21:44:00,MAA,TRV,270.0,306,197,-73,109,27,54,81,108,31,20,7,11,61,39,15,22,92,59,22,33,119,77,31,42,"{'F': 16, 'P': 11}","{'C': 22, 'J': 16, 'Z': 16}","{'Q': 24, 'R': 16, 'S': 8, 'T': 8, 'H': 16, 'M': 8}","{'Y': 8, 'A': 8, 'B': 4, 'D': 4, 'E': 4, 'G': 8, 'I': 4, 'K': 8, 'L': 4, 'N': 4, 'O': 4, 'U': 8, 'V': 4, 'W': 4, 'X': 4}"
INV-ZZ-6504518,SCH-ZZ-7589545,ZZ,ZZ20240416MAATRV2008.0,2008.0,Boeing 787,04/16/2024,2024-04-16 02:25:00,2024-04-16 21:44:00,MAA,TRV,270.0,317,196,-74,121,27,54,81,108,31,19,8,12,62,38,16,24,91,56,25,35,127,79,29,48,"{'F': 16, 'P': 11}","{'C': 22, 'J': 16, 'Z': 16}","{'Q': 24, 'R': 16, 'S': 8, 'T': 8, 'H': 16, 'M': 8}","{'Y': 8, 'A': 8, 'B': 4, 'D': 4, 'E': 4, 'G': 8, 'I': 4, 'K': 8, 'L': 4, 'N': 4, 'O': 4, 'U': 8, 'V': 4, 'W': 4, 'X': 4}"
INV-ZZ-6094233,SCH-ZZ-7589545,ZZ,ZZ20240417MAATRV2008.0,2008.0,Boeing 787,04/17/2024,2024-04-17 02:25:00,2024-04-17 21:44:00,MAA,TRV,270.0,311,173,-97,138,27,54,81,108,32,18,9,14,60,33,21,27,96,54,27,42,126,70,38,56,"{'F': 16, 'P': 11}","{'C': 22, 'J': 16, 'Z': 16}","{'Q': 24, 'R': 16, 'S': 8, 'T': 8, 'H': 16, 'M': 8}","{'Y': 8, 'A': 8, 'B': 4, 'D': 4, 'E': 4, 'G': 8, 'I': 4, 'K': 8, 'L': 4, 'N': 4, 'O': 4, 'U': 8, 'V': 4, 'W': 4, 'X': 4}"
INV-ZZ-2698906,SCH-ZZ-7589545,ZZ,ZZ20240418MAATRV2008.0,2008.0,Boeing 787,04/18/2024,2024-04-18 02:25:00,2024-04-18 21:44:00,MAA,TRV,270.0,298,177,-93,121,27,54,81,108,31,18,9,13,62,37,17,25,90,54,27,36,129,77,31,52,"{'F': 16, 'P': 11}","{'C': 22, 'J': 16, 'Z': 16}","{'Q': 24, 'R': 16, 'S': 8, 'T': 8, 'H': 16, 'M': 8}","{'Y': 8, 'A': 8, 'B': 4, 'D': 4, 'E': 4, 'G': 8, 'I': 4, 'K': 8, 'L': 4, 'N': 4, 'O': 4, 'U': 8, 'V': 4, 'W': 4, 'X': 4}"
INV-ZZ-1947192,SCH-ZZ-7589545,ZZ,ZZ20240420MAATRV2008.0,2008.0,Boeing 787,04/20/2024,2024-04-20 02:25:00,2024-04-20 21:44:00,MAA,TRV,270.0,312,171,-99,141,27,54,81,108,32,18,9,14,60,33,21,27,89,49,32,40,125,68,40,57,"{'F': 16, 'P': 11}","{'C': 22, 'J': 16, 'Z': 16}","{'Q': 24, 'R': 16, 'S': 8, 'T': 8, 'H': 16, 'M': 8}","{'Y': 8, 'A': 8, 'B': 4, 'D': 4, 'E': 4, 'G': 8, 'I': 4, 'K': 8, 'L': 4, 'N': 4, 'O': 4, 'U': 8, 'V': 4, 'W': 4, 'X': 4}"
INV-ZZ-9633373,SCH-ZZ-7589545,ZZ,ZZ20240421MAATRV2008.0,2008.0,Boeing 787,04/21/2024,2024-04-21 02:25:00,2024-04-21 21:44:00,MAA,TRV,270.0,309,182,-88,127,27,54,81,108,30,18,9,12,63,37,17,26,96,57,24,39,127,75,33,52,"{'F': 16, 'P': 11}","{'C': 22, 'J': 16, 'Z': 16}","{'Q': 24, 'R': 16, 'S': 8, 'T': 8, 'H': 16, 'M': 8}","{'Y': 8, 'A': 8, 'B': 4, 'D': 4, 'E': 4, 'G': 8, 'I': 4, 'K': 8, 'L': 4, 'N': 4, 'O': 4, 'U': 8, 'V': 4, 'W': 4, 'X': 4}"
INV-ZZ-1594157,SCH-ZZ-7589545,ZZ,ZZ20240423MAATRV2008.0,2008.0,Boeing 787,04/23/2024,2024-04-23 02:25:00,2024-04-23 21:44:00,MAA,TRV,270.0,307,179,-91,128,27,54,81,108,32,19,8,13,65,38,16,27,97,56,25,41,124,72,36,52,"{'F': 16, 'P': 11}","{'C': 22, 'J': 16, 'Z': 16}","{'Q': 24, 'R': 16, 'S': 8, 'T': 8, 'H': 16, 'M': 8}","{'Y': 8, 'A': 8, 'B': 4, 'D': 4, 'E': 4, 'G': 8, 'I': 4, 'K': 8, 'L': 4, 'N': 4, 'O': 4, 'U': 8, 'V': 4, 'W': 4, 'X': 4}"
INV-ZZ-4079407,SCH-ZZ-7589545,ZZ,ZZ20240424MAATRV2008.0,2008.0,Boeing 787,04/24/2024,2024-04-24 02:25:00,2024-04-24 21:44:00,MAA,TRV,270.0,301,181,-89,120,27,54,81,108,31,19,8,12,62,37,17,25,93,56,25,37,130,78,30,52,"{'F': 16, 'P': 11}","{'C': 22, 'J': 16, 'Z': 16}","{'Q': 24, 'R': 16, 'S': 8, 'T': 8, 'H': 16, 'M': 8}","{'Y': 8, 'A': 8, 'B': 4, 'D': 4, 'E': 4, 'G': 8, 'I': 4, 'K': 8, 'L': 4, 'N': 4, 'O': 4, 'U': 8, 'V': 4, 'W': 4, 'X': 4}"
INV-ZZ-5906781,SCH-ZZ-7589545,ZZ,ZZ20240425MAATRV2008.0,2008.0,Boeing 787,04/25/2024,2024-04-25 02:25:00,2024-04-25 21:44:00,MAA,TRV,270.0,323,181,-89,142,27,54,81,108,31,17,10,14,62,35,19,27,90,50,31,40,123,69,39,54,"{'F': 16, 'P': 11}","{'C': 22, 'J': 16, 'Z': 16}","{'Q': 24, 'R': 16, 'S': 8, 'T': 8, 'H': 16, 'M': 8}","{'Y': 8, 'A': 8, 'B': 4, 'D': 4, 'E': 4, 'G': 8, 'I': 4, 'K': 8, 'L': 4, 'N': 4, 'O': 4, 'U': 8, 'V': 4, 'W': 4, 'X': 4}"
INV-ZZ-4330576,SCH-ZZ-7589545,ZZ,ZZ20240427MAATRV2008.0,2008.0,Boeing 787,04/27/2024,2024-04-27 02:25:00,2024-04-27 21:44:00,MAA,TRV,270.0,323,171,-99,152,27,54,81,108,32,17,10,15,64,34,20,30,93,49,32,44,124,65,43,59,"{'F': 16, 'P': 11}","{'C': 22, 'J': 16, 'Z': 16}","{'Q': 24, 'R': 16, 'S': 8, 'T': 8, 'H': 16, 'M': 8}","{'Y': 8, 'A': 8, 'B': 4, 'D': 4, 'E': 4, 'G': 8, 'I': 4, 'K': 8, 'L': 4, 'N': 4, 'O': 4, 'U': 8, 'V': 4, 'W': 4, 'X': 4}"
INV-ZZ-7719032,SCH-ZZ-7589545,ZZ,ZZ20240428MAATRV2008.0,2008.0,Boeing 787,04/28/2024,2024-04-28 02:25:00,2024-04-28 21:44:00,MAA,TRV,270.0,300,166,-104,134,27,54,81,108,32,18,9,14,64,35,19,29,97,54,27,43,122,68,40,54,"{'F': 16, 'P': 11}","{'C': 22, 'J': 16, 'Z': 16}","{'Q': 24, 'R': 16, 'S': 8, 'T': 8, 'H': 16, 'M': 8}","{'Y': 8, 'A': 8, 'B': 4, 'D': 4, 'E': 4, 'G': 8, 'I': 4, 'K': 8, 'L': 4, 'N': 4, 'O': 4, 'U': 8, 'V': 4, 'W': 4, 'X': 4}"
INV-ZZ-6125407,SCH-ZZ-7589545,ZZ,ZZ20240430MAATRV2008.0,2008.0,Boeing 787,04/30/2024,2024-04-30 02:25:00,2024-04-30 21:44:00,MAA,TRV,270.0,315,167,-103,148,27,54,81,108,32,17,10,15,65,34,20,31,92,49,32,43,124,66,42,58,"{'F': 16, 'P': 11}","{'C': 22, 'J': 16, 'Z': 16}","{'Q': 24, 'R': 16, 'S': 8, 'T': 8, 'H': 16, 'M': 8}","{'Y': 8, 'A': 8, 'B': 4, 'D': 4, 'E': 4, 'G': 8, 'I': 4, 'K': 8, 'L': 4, 'N': 4, 'O': 4, 'U': 8, 'V': 4, 'W': 4, 'X': 4}"
INV-ZZ-9066926,SCH-ZZ-7589545,ZZ,ZZ20240501MAATRV2008.0,2008.0,Boeing 787,05/01/2024,2024-05-01 02:25:00,2024-05-01 21:44:00,MAA,TRV,270.0,312,160,-110,152,27,54,81,108,32,16,11,16,62,32,22,30,92,47,34,45,127,65,43,62,"{'F': 16, 'P': 11}","{'C': 22, 'J': 16, 'Z': 16}","{'Q': 24, 'R': 16, 'S': 8, 'T': 8, 'H': 16, 'M': 8}","{'Y': 8, 'A': 8, 'B': 4, 'D': 4, 'E': 4, 'G': 8, 'I': 4, 'K': 8, 'L': 4, 'N': 4, 'O': 4, 'U': 8, 'V': 4, 'W': 4, 'X': 4}"
INV-ZZ-8965861,SCH-ZZ-7589545,ZZ,ZZ20240502MAATRV2008.0,2008.0,Boeing 787,05/02/2024,2024-05-02 02:25:00,2024-05-02 21:44:00,MAA,TRV,270.0,323,192,-78,131,27,54,81,108,30,18,9,12,61,36,18,25,97,58,23,39,124,74,34,50,"{'F': 16, 'P': 11}","{'C': 22, 'J': 16, 'Z': 16}","{'Q': 24, 'R': 16, 'S': 8, 'T': 8, 'H': 16, 'M': 8}","{'Y': 8, 'A': 8, 'B': 4, 'D': 4, 'E': 4, 'G': 8, 'I': 4, 'K': 8, 'L': 4, 'N': 4, 'O': 4, 'U': 8, 'V': 4, 'W': 4, 'X': 4}"
INV-ZZ-3487779,SCH-ZZ-7589545,ZZ,ZZ20240504MAATRV2008.0,2008.0,Boeing 787,05/04/2024,2024-05-04 02:25:00,2024-05-04 21:44:00,MAA,TRV,270.0,300,160,-110,140,27,54,81,108,31,16,11,15,62,33,21,29,93,49,32,44,127,68,40,59,"{'F': 16, 'P': 11}","{'C': 22, 'J': 16, 'Z': 16}","{'Q': 24, 'R': 16, 'S': 8, 'T': 8, 'H': 16, 'M': 8}","{'Y': 8, 'A': 8, 'B': 4, 'D': 4, 'E': 4, 'G': 8, 'I': 4, 'K': 8, 'L': 4, 'N': 4, 'O': 4, 'U': 8, 'V': 4, 'W': 4, 'X': 4}"
INV-ZZ-1583711,SCH-ZZ-7589545,ZZ,ZZ20240505MAATRV2008.0,2008.0,Boeing 787,05/05/2024,2024-05-05 02:25:00,2024-05-05 21:44:00,MAA,TRV,270.0,303,161,-109,142,27,54,81,108,31,16,11,15,62,33,21,29,97,52,29,45,122,65,43,57,"{'F': 16, 'P': 11}","{'C': 22, 'J': 16, 'Z': 16}","{'Q': 24, 'R': 16, 'S': 8, 'T': 8, 'H': 16, 'M': 8}","{'Y': 8, 'A': 8, 'B': 4, 'D': 4, 'E': 4, 'G': 8, 'I': 4, 'K': 8, 'L': 4, 'N': 4, 'O': 4, 'U': 8, 'V': 4, 'W': 4, 'X': 4}"
INV-ZZ-7881533,SCH-ZZ-7589545,ZZ,ZZ20240507MAATRV2008.0,2008.0,Boeing 787,05/07/2024,2024-05-07 02:25:00,2024-05-07 21:44:00,MAA,TRV,270.0,304,155,-115,149,27,54,81,108,32,16,11,16,60,30,24,30,95,48,33,47,128,65,43,63,"{'F': 16, 'P': 11}","{'C': 22, 'J': 16, 'Z': 16}","{'Q': 24, 'R': 16, 'S': 8, 'T': 8, 'H': 16, 'M': 8}","{'Y': 8, 'A': 8, 'B': 4, 'D': 4, 'E': 4, 'G': 8, 'I': 4, 'K': 8, 'L': 4, 'N': 4, 'O': 4, 'U': 8, 'V': 4, 'W': 4, 'X': 4}"
INV-ZZ-7135189,SCH-ZZ-7589545,ZZ,ZZ20240508MAATRV2008.0,2008.0,Boeing 787,05/08/2024,2024-05-08 02:25:00,2024-05-08 21:44:00,MAA,TRV,270.0,306,158,-112,148,27,54,81,108,32,17,10,15,60,31,23,29,91,47,34,44,120,62,46,58,"{'F': 16, 'P': 11}","{'C': 22, 'J': 16, 'Z': 16}","{'Q': 24, 'R': 16, 'S': 8, 'T': 8, 'H': 16, 'M': 8}","{'Y': 8, 'A': 8, 'B': 4, 'D': 4, 'E': 4, 'G': 8, 'I': 4, 'K': 8, 'L': 4, 'N': 4, 'O': 4, 'U': 8, 'V': 4, 'W': 4, 'X': 4}"
INV-ZZ-8890666,SCH-ZZ-7589545,ZZ,ZZ20240509MAATRV2008.0,2008.0,Boeing 787,05/09/2024,2024-05-09 02:25:00,2024-05-09 21:44:00,MAA,TRV,270.0,315,166,-104,149,27,54,81,108,31,16,11,15,62,33,21,29,91,48,33,43,127,67,41,60,"{'F': 16, 'P': 11}","{'C': 22, 'J': 16, 'Z': 16}","{'Q': 24, 'R': 16, 'S': 8, 'T': 8, 'H': 16, 'M': 8}","{'Y': 8, 'A': 8, 'B': 4, 'D': 4, 'E': 4, 'G': 8, 'I': 4, 'K': 8, 'L': 4, 'N': 4, 'O': 4, 'U': 8, 'V': 4, 'W': 4, 'X': 4}"
INV-ZZ-4532448,SCH-ZZ-7589545,ZZ,ZZ20240511MAATRV2008.0,2008.0,Boeing 787,05/11/2024,2024-05-11 02:25:00,2024-05-11 21:44:00,MAA,TRV,270.0,323,181,-89,142,27,54,81,108,31,17,10,14,64,36,18,28,94,53,28,41,127,71,37,56,"{'F': 16, 'P': 11}","{'C': 22, 'J': 16, 'Z': 16}","{'Q': 24, 'R': 16, 'S': 8, 'T': 8, 'H': 16, 'M': 8}","{'Y': 8, 'A': 8, 'B': 4, 'D': 4, 'E': 4, 'G': 8, 'I': 4, 'K': 8, 'L': 4, 'N': 4, 'O': 4, 'U': 8, 'V': 4, 'W': 4, 'X': 4}"
INV-ZZ-7186576,SCH-ZZ-7589545,ZZ,ZZ20240512MAATRV2008.0,2008.0,Boeing 787,05/12/2024,2024-05-12 02:25:00,2024-05-12 21:44:00,MAA,TRV,270.0,305,157,-113,148,27,54,81,108,32,16,11,16,64,33,21,31,92,47,34,45,127,65,43,62,"{'F': 16, 'P': 11}","{'C': 22, 'J': 16, 'Z': 16}","{'Q': 24, 'R': 16, 'S': 8, 'T': 8, 'H': 16, 'M': 8}","{'Y': 8, 'A': 8, 'B': 4, 'D': 4, 'E': 4, 'G': 8, 'I': 4, 'K': 8, 'L': 4, 'N': 4, 'O': 4, 'U': 8, 'V': 4, 'W': 4, 'X': 4}"
INV-ZZ-6972590,SCH-ZZ-7589545,ZZ,ZZ20240514MAATRV2008.0,2008.0,Boeing 787,05/14/2024,2024-05-14 02:25:00,2024-05-14 21:44:00,MAA,TRV,270.0,316,171,-99,145,27,54,81,108,32,17,10,15,60,32,22,28,92,50,31,42,122,66,42,56,"{'F': 16, 'P': 11}","{'C': 22, 'J': 16, 'Z': 16}","{'Q': 24, 'R': 16, 'S': 8, 'T': 8, 'H': 16, 'M': 8}","{'Y': 8, 'A': 8, 'B': 4, 'D': 4, 'E': 4, 'G': 8, 'I': 4, 'K': 8, 'L': 4, 'N': 4, 'O': 4, 'U': 8, 'V': 4, 'W': 4, 'X': 4}"
INV-ZZ-3049518,SCH-ZZ-7589545,ZZ,ZZ20240515MAATRV2008.0,2008.0,Boeing 787,05/15/2024,2024-05-15 02:25:00,2024-05-15 21:44:00,MAA,TRV,270.0,303,153,-117,150,27,54,81,108,32,16,11,16,65,33,21,32,92,46,35,46,126,63,45,63,"{'F': 16, 'P': 11}","{'C': 22, 'J': 16, 'Z': 16}","{'Q': 24, 'R': 16, 'S': 8, 'T': 8, 'H': 16, 'M': 8}","{'Y': 8, 'A': 8, 'B': 4, 'D': 4, 'E': 4, 'G': 8, 'I': 4, 'K': 8, 'L': 4, 'N': 4, 'O': 4, 'U': 8, 'V': 4, 'W': 4, 'X': 4}"
INV-ZZ-2138539,SCH-ZZ-7589545,ZZ,ZZ20240516MAATRV2008.0,2008.0,Boeing 787,05/16/2024,2024-05-16 02:25:00,2024-05-16 21:44:00,MAA,TRV,270.0,315,162,-108,153,27,54,81,108,31,16,11,15,63,32,22,31,92,47,34,45,119,61,47,58,"{'F': 16, 'P': 11}","{'C': 22, 'J': 16, 'Z': 16}","{'Q': 24, 'R': 16, 'S': 8, 'T': 8, 'H': 16, 'M': 8}","{'Y': 8, 'A': 8, 'B': 4, 'D': 4, 'E': 4, 'G': 8, 'I': 4, 'K': 8, 'L': 4, 'N': 4, 'O': 4, 'U': 8, 'V': 4, 'W': 4, 'X': 4}"
INV-ZZ-1810256,SCH-ZZ-7589545,ZZ,ZZ20240518MAATRV2008.0,2008.0,Boeing 787,05/18/2024,2024-05-18 02:25:00,2024-05-18 21:44:00,MAA,TRV,270.0,303,168,-102,135,27,54,81,108,30,17,10,13,60,33,21,27,92,51,30,41,121,67,41,54,"{'F': 16, 'P': 11}","{'C': 22, 'J': 16, 'Z': 16}","{'Q': 24, 'R': 16, 'S': 8, 'T': 8, 'H': 16, 'M': 8}","{'Y': 8, 'A': 8, 'B': 4, 'D': 4, 'E': 4, 'G': 8, 'I': 4, 'K': 8, 'L': 4, 'N': 4, 'O': 4, 'U': 8, 'V': 4, 'W': 4, 'X': 4}"
INV-ZZ-9044639,SCH-ZZ-7589545,ZZ,ZZ20240519MAATRV2008.0,2008.0,Boeing 787,05/19/2024,2024-05-19 02:25:00,2024-05-19 21:44:00,MAA,TRV,270.0,297,156,-114,141,27,54,81,108,30,16,11,14,60,32,22,28,91,48,33,43,126,66,42,60,"{'F': 16, 'P': 11}","{'C': 22, 'J': 16, 'Z': 16}","{'Q': 24, 'R': 16, 'S': 8, 'T': 8, 'H': 16, 'M': 8}","{'Y': 8, 'A': 8, 'B': 4, 'D': 4, 'E': 4, 'G': 8, 'I': 4, 'K': 8, 'L': 4, 'N': 4, 'O': 4, 'U': 8, 'V': 4, 'W': 4, 'X': 4}"
INV-ZZ-4306317,SCH-ZZ-4269181,ZZ,ZZ20240412MAACJB2885.0,2885.0,Boeing 777,04/12/2024,2024-04-12 17:43:00,2024-04-13 09:14:00,MAA,CJB,425.0,507,330,-95,177,42,85,127,170,47,31,11,16,101,66,19,35,150,97,30,53,193,125,45,68,"{'F': 25, 'P': 17}","{'C': 34, 'J': 26, 'Z': 26}","{'Q': 38, 'R': 25, 'S': 13, 'T': 13, 'H': 25, 'M': 13}","{'Y': 13, 'A': 13, 'B': 6, 'D': 6, 'E': 6, 'G': 13, 'I': 6, 'K': 13, 'L': 6, 'N': 6, 'O': 6, 'U': 13, 'V': 6, 'W': 6, 'X': 6}"
INV-ZZ-8897340,SCH-ZZ-4269181,ZZ,ZZ20240414MAACJB2885.0,2885.0,Boeing 777,04/14/2024,2024-04-14 17:43:00,2024-04-15 09:14:00,MAA,CJB,425.0,493,292,-133,201,42,85,127,170,49,29,13,20,99,59,26,40,146,86,41,60,191,113,57,78,"{'F': 25, 'P': 17}","{'C': 34, 'J': 26, 'Z': 26}","{'Q': 38, 'R': 25, 'S': 13, 'T': 13, 'H': 25, 'M': 13}","{'Y': 13, 'A': 13, 'B': 6, 'D': 6, 'E': 6, 'G': 13, 'I': 6, 'K': 13, 'L': 6, 'N': 6, 'O': 6, 'U': 13, 'V': 6, 'W': 6, 'X': 6}"
INV-ZZ-9167971,SCH-ZZ-4269181,ZZ,ZZ20240419MAACJB2885.0,2885.0,Boeing 777,04/19/2024,2024-04-19 17:43:00,2024-04-20 09:14:00,MAA,CJB,425.0,471,262,-163,209,42,85,127,170,49,27,15,22,95,53,32,42,152,85,42,67,201,112,58,89,"{'F': 25, 'P': 17}","{'C': 34, 'J': 26, 'Z': 26}","{'Q': 38, 'R': 25, 'S': 13, 'T': 13, 'H': 25, 'M': 13}","{'Y': 13, 'A': 13, 'B': 6, 'D': 6, 'E': 6, 'G': 13, 'I': 6, 'K': 13, 'L': 6, 'N': 6, 'O': 6, 'U': 13, 'V': 6, 'W': 6, 'X': 6}"
INV-ZZ-5744100,SCH-ZZ-4269181,ZZ,ZZ20240421MAACJB2885.0,2885.0,Boeing 777,04/21/2024,2024-04-21 17:43:00,2024-04-22 09:14:00,MAA,CJB,425.0,492,296,-129,196,42,85,127,170,48,29,13,19,96,58,27,38,147,88,39,59,193,116,54,77,"{'F': 25, 'P': 17}","{'C': 34, 'J': 26, 'Z': 26}","{'Q': 38, 'R': 25, 'S': 13, 'T': 13, 'H': 25, 'M': 13}","{'Y': 13, 'A': 13, 'B': 6, 'D': 6, 'E': 6, 'G': 13, 'I': 6, 'K': 13, 'L': 6, 'N': 6, 'O': 6, 'U': 13, 'V': 6, 'W': 6, 'X': 6}"
INV-ZZ-4268399,SCH-ZZ-4269181,ZZ,ZZ20240426MAACJB2885.0,2885.0,Boeing 777,04/26/2024,2024-04-26 17:43:00,2024-04-27 09:14:00,MAA,CJB,425.0,503,304,-121,199,42,85,127,170,48,29,13,19,101,61,24,40,143,86,41,57,193,117,53,76,"{'F': 25, 'P': 17}","{'C': 34, 'J': 26, 'Z': 26}","{'Q': 38, 'R': 25, 'S': 13, 'T': 13, 'H': 25, 'M': 13}","{'Y': 13, 'A': 13, 'B': 6, 'D': 6, 'E': 6, 'G': 13, 'I': 6, 'K': 13, 'L': 6, 'N': 6, 'O': 6, 'U': 13, 'V': 6, 'W': 6, 'X': 6}"
INV-ZZ-9552898,SCH-ZZ-4269181,ZZ,ZZ20240428MAACJB2885.0,2885.0,Boeing 777,04/28/2024,2024-04-28 17:43:00,2024-04-29 09:14:00,MAA,CJB,425.0,506,285,-140,221,42,85,127,170,47,26,16,21,101,57,28,44,150,85,42,65,195,110,60,85,"{'F': 25, 'P': 17}","{'C': 34, 'J': 26, 'Z': 26}","{'Q': 38, 'R': 25, 'S': 13, 'T': 13, 'H': 25, 'M': 13}","{'Y': 13, 'A': 13, 'B': 6, 'D': 6, 'E': 6, 'G': 13, 'I': 6, 'K': 13, 'L': 6, 'N': 6, 'O': 6, 'U': 13, 'V': 6, 'W': 6, 'X': 6}"
INV-ZZ-8794164,SCH-ZZ-4269181,ZZ,ZZ20240503MAACJB2885.0,2885.0,Boeing 777,05/03/2024,2024-05-03 17:43:00,2024-05-04 09:14:00,MAA,CJB,425.0,486,286,-139,200,42,85,127,170,50,29,13,21,99,58,27,41,141,83,44,58,194,114,56,80,"{'F': 25, 'P': 17}","{'C': 34, 'J': 26, 'Z': 26}","{'Q': 38, 'R': 25, 'S': 13, 'T': 13, 'H': 25, 'M': 13}","{'Y': 13, 'A': 13, 'B': 6, 'D': 6, 'E': 6, 'G': 13, 'I': 6, 'K': 13, 'L': 6, 'N': 6, 'O': 6, 'U': 13, 'V': 6, 'W': 6, 'X': 6}"
INV-ZZ-1450166,SCH-ZZ-4269181,ZZ,ZZ20240505MAACJB2885.0,2885.0,Boeing 777,05/05/2024,2024-05-05 17:43:00,2024-05-06 09:14:00,MAA,CJB,425.0,504,278,-147,226,42,85,127,170,49,27,15,22,101,56,29,45,146,81,46,65,188,104,66,84,"{'F': 25, 'P': 17}","{'C': 34, 'J': 26, 'Z': 26}","{'Q': 38, 'R': 25, 'S': 13, 'T': 13, 'H': 25, 'M': 13}","{'Y': 13, 'A': 13, 'B': 6, 'D': 6, 'E': 6, 'G': 13, 'I': 6, 'K': 13, 'L': 6, 'N': 6, 'O': 6, 'U': 13, 'V': 6, 'W': 6, 'X': 6}"
INV-ZZ-1247065,SCH-ZZ-4269181,ZZ,ZZ20240510MAACJB2885.0,2885.0,Boeing 777,05/10/2024,2024-05-10 17:43:00,2024-05-11 09:14:00,MAA,CJB,425.0,509,289,-136,220,42,85,127,170,49,28,14,21,98,56,29,42,152,86,41,66,190,108,62,82,"{'F': 25, 'P': 17}","{'C': 34, 'J': 26, 'Z': 26}","{'Q': 38, 'R': 25, 'S': 13, 'T': 13, 'H': 25, 'M': 13}","{'Y': 13, 'A': 13, 'B': 6, 'D': 6, 'E': 6, 'G': 13, 'I': 6, 'K': 13, 'L': 6, 'N': 6, 'O': 6, 'U': 13, 'V': 6, 'W': 6, 'X': 6}"
INV-ZZ-2227207,SCH-ZZ-4269181,ZZ,ZZ20240512MAACJB2885.0,2885.0,Boeing 777,05/12/2024,2024-05-12 17:43:00,2024-05-13 09:14:00,MAA,CJB,425.0,474,237,-188,237,42,85,127,170,47,24,18,23,98,49,36,49,152,76,51,76,203,102,68,101,"{'F': 25, 'P': 17}","{'C': 34, 'J': 26, 'Z': 26}","{'Q': 38, 'R': 25, 'S': 13, 'T': 13, 'H': 25, 'M': 13}","{'Y': 13, 'A': 13, 'B': 6, 'D': 6, 'E': 6, 'G': 13, 'I': 6, 'K': 13, 'L': 6, 'N': 6, 'O': 6, 'U': 13, 'V': 6, 'W': 6, 'X': 6}"
INV-ZZ-2698641,SCH-ZZ-4269181,ZZ,ZZ20240517MAACJB2885.0,2885.0,Boeing 777,05/17/2024,2024-05-17 17:43:00,2024-05-18 09:14:00,MAA,CJB,425.0,492,272,-153,220,42,85,127,170,48,27,15,21,97,54,31,43,151,83,44,68,191,106,64,85,"{'F': 25, 'P': 17}","{'C': 34, 'J': 26, 'Z': 26}","{'Q': 38, 'R': 25, 'S': 13, 'T': 13, 'H': 25, 'M': 13}","{'Y': 13, 'A': 13, 'B': 6, 'D': 6, 'E': 6, 'G': 13, 'I': 6, 'K': 13, 'L': 6, 'N': 6, 'O': 6, 'U': 13, 'V': 6, 'W': 6, 'X': 6}"
INV-ZZ-7005336,SCH-ZZ-4269181,ZZ,ZZ20240519MAACJB2885.0,2885.0,Boeing 777,05/19/2024,2024-05-19 17:43:00,2024-05-20 09:14:00,MAA,CJB,425.0,501,268,-157,233,42,85,127,170,49,26,16,23,94,50,35,44,143,76,51,67,201,107,63,94,"{'F': 25, 'P': 17}","{'C': 34, 'J': 26, 'Z': 26}","{'Q': 38, 'R': 25, 'S': 13, 'T': 13, 'H': 25, 'M': 13}","{'Y': 13, 'A': 13, 'B': 6, 'D': 6, 'E': 6, 'G': 13, 'I': 6, 'K': 13, 'L': 6, 'N': 6, 'O': 6, 'U': 13, 'V': 6, 'W': 6, 'X': 6}"
INV-ZZ-4640115,SCH-ZZ-4269181,ZZ,ZZ20240524MAACJB2885.0,2885.0,Boeing 777,05/24/2024,2024-05-24 17:43:00,2024-05-25 09:14:00,MAA,CJB,425.0,504,249,-176,255,42,85,127,170,48,24,18,24,97,48,37,49,145,72,55,73,188,93,77,95,"{'F': 25, 'P': 17}","{'C': 34, 'J': 26, 'Z': 26}","{'Q': 38, 'R': 25, 'S': 13, 'T': 13, 'H': 25, 'M': 13}","{'Y': 13, 'A': 13, 'B': 6, 'D': 6, 'E': 6, 'G': 13, 'I': 6, 'K': 13, 'L': 6, 'N': 6, 'O': 6, 'U': 13, 'V': 6, 'W': 6, 'X': 6}"
INV-ZZ-8322256,SCH-ZZ-4269181,ZZ,ZZ20240526MAACJB2885.0,2885.0,Boeing 777,05/26/2024,2024-05-26 17:43:00,2024-05-27 09:14:00,MAA,CJB,425.0,504,229,-196,275,42,85,127,170,48,22,20,26,95,43,42,52,149,68,59,81,203,92,78,111,"{'F': 25, 'P': 17}","{'C': 34, 'J': 26, 'Z': 26}","{'Q': 38, 'R': 25, 'S': 13, 'T': 13, 'H': 25, 'M': 13}","{'Y': 13, 'A': 13, 'B': 6, 'D': 6, 'E': 6, 'G': 13, 'I': 6, 'K': 13, 'L': 6, 'N': 6, 'O': 6, 'U': 13, 'V': 6, 'W': 6, 'X': 6}"
INV-ZZ-6714281,SCH-ZZ-2922736,ZZ,ZZ20240506BOMPNQ2977.0,2977.0,BAe 146,05/06/2024,2024-05-06 14:12:00,2024-05-06 16:17:00,BOM,PNQ,91.0,101,54,-37,47,9,18,27,36,10,5,4,5,20,11,7,9,31,16,11,15,42,22,14,20,"{'F': 5, 'P': 4}","{'C': 7, 'J': 5, 'Z': 5}","{'Q': 8, 'R': 5, 'S': 3, 'T': 3, 'H': 5, 'M': 3}","{'Y': 3, 'A': 3, 'B': 1, 'D': 1, 'E': 1, 'G': 3, 'I': 1, 'K': 3, 'L': 1, 'N': 1, 'O': 1, 'U': 3, 'V': 1, 'W': 1, 'X': 1}"
INV-ZZ-7407376,SCH-ZZ-2922736,ZZ,ZZ20240507BOMPNQ2977.0,2977.0,BAe 146,05/07/2024,2024-05-07 14:12:00,2024-05-07 16:17:00,BOM,PNQ,91.0,102,58,-33,44,9,18,27,36,10,6,3,4,20,11,7,9,31,17,10,14,42,24,12,18,"{'F': 5, 'P': 4}","{'C': 7, 'J': 5, 'Z': 5}","{'Q': 8, 'R': 5, 'S': 3, 'T': 3, 'H': 5, 'M': 3}","{'Y': 3, 'A': 3, 'B': 1, 'D': 1, 'E': 1, 'G': 3, 'I': 1, 'K': 3, 'L': 1, 'N': 1, 'O': 1, 'U': 3, 'V': 1, 'W': 1, 'X': 1}"
INV-ZZ-7347489,SCH-ZZ-2922736,ZZ,ZZ20240508BOMPNQ2977.0,2977.0,BAe 146,05/08/2024,2024-05-08 14:12:00,2024-05-08 16:17:00,BOM,PNQ,91.0,104,52,-39,52,9,18,27,36,11,6,3,5,22,11,7,11,31,16,11,15,41,21,15,20,"{'F': 5, 'P': 4}","{'C': 7, 'J': 5, 'Z': 5}","{'Q': 8, 'R': 5, 'S': 3, 'T': 3, 'H': 5, 'M': 3}","{'Y': 3, 'A': 3, 'B': 1, 'D': 1, 'E': 1, 'G': 3, 'I': 1, 'K': 3, 'L': 1, 'N': 1, 'O': 1, 'U': 3, 'V': 1, 'W': 1, 'X': 1}"
INV-ZZ-2212713,SCH-ZZ-2922736,ZZ,ZZ20240510BOMPNQ2977.0,2977.0,BAe 146,05/10/2024,2024-05-10 14:12:00,2024-05-10 16:17:00,BOM,PNQ,91.0,104,57,-34,47,9,18,27,36,10,6,3,4,21,12,6,9,31,17,10,14,43,24,12,19,"{'F': 5, 'P': 4}","{'C': 7, 'J': 5, 'Z': 5}","{'Q': 8, 'R': 5, 'S': 3, 'T': 3, 'H': 5, 'M': 3}","{'Y': 3, 'A': 3, 'B': 1, 'D': 1, 'E': 1, 'G': 3, 'I': 1, 'K': 3, 'L': 1, 'N': 1, 'O': 1, 'U': 3, 'V': 1, 'W': 1, 'X': 1}"
INV-ZZ-3588408,SCH-ZZ-2922736,ZZ,ZZ20240511BOMPNQ2977.0,2977.0,BAe 146,05/11/2024,2024-05-11 14:12:00,2024-05-11 16:17:00,BOM,PNQ,91.0,107,54,-37,53,9,18,27,36,10,5,4,5,21,11,7,10,32,16,11,16,40,20,16,20,"{'F': 5, 'P': 4}","{'C': 7, 'J': 5, 'Z': 5}","{'Q': 8, 'R': 5, 'S': 3, 'T': 3, 'H': 5, 'M': 3}","{'Y': 3, 'A': 3, 'B': 1, 'D': 1, 'E': 1, 'G': 3, 'I': 1, 'K': 3, 'L': 1, 'N': 1, 'O': 1, 'U': 3, 'V': 1, 'W': 1, 'X': 1}"
INV-ZZ-9153449,SCH-ZZ-2922736,ZZ,ZZ20240513BOMPNQ2977.0,2977.0,BAe 146,05/13/2024,2024-05-13 14:12:00,2024-05-13 16:17:00,BOM,PNQ,91.0,105,56,-35,49,9,18,27,36,11,6,3,5,21,11,7,10,32,17,10,15,41,22,14,19,"{'F': 5, 'P': 4}","{'C': 7, 'J': 5, 'Z': 5}","{'Q': 8, 'R': 5, 'S': 3, 'T': 3, 'H': 5, 'M': 3}","{'Y': 3, 'A': 3, 'B': 1, 'D': 1, 'E': 1, 'G': 3, 'I': 1, 'K': 3, 'L': 1, 'N': 1, 'O': 1, 'U': 3, 'V': 1, 'W': 1, 'X': 1}"
INV-ZZ-6577298,SCH-ZZ-2922736,ZZ,ZZ20240514BOMPNQ2977.0,2977.0,BAe 146,05/14/2024,2024-05-14 14:12:00,2024-05-14 16:17:00,BOM,PNQ,91.0,108,54,-37,54,9,18,27,36,10,5,4,5,21,11,7,10,31,16,11,15,43,22,14,21,"{'F': 5, 'P': 4}","{'C': 7, 'J': 5, 'Z': 5}","{'Q': 8, 'R': 5, 'S': 3, 'T': 3, 'H': 5, 'M': 3}","{'Y': 3, 'A': 3, 'B': 1, 'D': 1, 'E': 1, 'G': 3, 'I': 1, 'K': 3, 'L': 1, 'N': 1, 'O': 1, 'U': 3, 'V': 1, 'W': 1, 'X': 1}"
INV-ZZ-3037491,SCH-ZZ-2922736,ZZ,ZZ20240515BOMPNQ2977.0,2977.0,BAe 146,05/15/2024,2024-05-15 14:12:00,2024-05-15 16:17:00,BOM,PNQ,91.0,104,51,-40,53,9,18,27,36,11,5,4,6,20,10,8,10,31,15,12,16,43,21,15,22,"{'F': 5, 'P': 4}","{'C': 7, 'J': 5, 'Z': 5}","{'Q': 8, 'R': 5, 'S': 3, 'T': 3, 'H': 5, 'M': 3}","{'Y': 3, 'A': 3, 'B': 1, 'D': 1, 'E': 1, 'G': 3, 'I': 1, 'K': 3, 'L': 1, 'N': 1, 'O': 1, 'U': 3, 'V': 1, 'W': 1, 'X': 1}"
INV-ZZ-3010989,SCH-ZZ-2922736,ZZ,ZZ20240517BOMPNQ2977.0,2977.0,BAe 146,05/17/2024,2024-05-17 14:12:00,2024-05-17 16:17:00,BOM,PNQ,91.0,108,54,-37,54,9,18,27,36,10,5,4,5,21,10,8,11,30,15,12,15,42,21,15,21,"{'F': 5, 'P': 4}","{'C': 7, 'J': 5, 'Z': 5}","{'Q': 8, 'R': 5, 'S': 3, 'T': 3, 'H': 5, 'M': 3}","{'Y': 3, 'A': 3, 'B': 1, 'D': 1, 'E': 1, 'G': 3, 'I': 1, 'K': 3, 'L': 1, 'N': 1, 'O': 1, 'U': 3, 'V': 1, 'W': 1, 'X': 1}"
INV-ZZ-3369281,SCH-ZZ-2922736,ZZ,ZZ20240518BOMPNQ2977.0,2977.0,BAe 146,05/18/2024,2024-05-18 14:12:00,2024-05-18 16:17:00,BOM,PNQ,91.0,100,49,-42,51,9,18,27,36,11,5,4,6,20,10,8,10,31,15,12,16,42,21,15,21,"{'F': 5, 'P': 4}","{'C': 7, 'J': 5, 'Z': 5}","{'Q': 8, 'R': 5, 'S': 3, 'T': 3, 'H': 5, 'M': 3}","{'Y': 3, 'A': 3, 'B': 1, 'D': 1, 'E': 1, 'G': 3, 'I': 1, 'K': 3, 'L': 1, 'N': 1, 'O': 1, 'U': 3, 'V': 1, 'W': 1, 'X': 1}"
INV-ZZ-1509535,SCH-ZZ-2922736,ZZ,ZZ20240520BOMPNQ2977.0,2977.0,BAe 146,05/20/2024,2024-05-20 14:12:00,2024-05-20 16:17:00,BOM,PNQ,91.0,109,57,-34,52,9,18,27,36,10,5,4,5,21,11,7,10,30,16,11,14,42,22,14,20,"{'F': 5, 'P': 4}","{'C': 7, 'J': 5, 'Z': 5}","{'Q': 8, 'R': 5, 'S': 3, 'T': 3, 'H': 5, 'M': 3}","{'Y': 3, 'A': 3, 'B': 1, 'D': 1, 'E': 1, 'G': 3, 'I': 1, 'K': 3, 'L': 1, 'N': 1, 'O': 1, 'U': 3, 'V': 1, 'W': 1, 'X': 1}"
INV-ZZ-1155599,SCH-ZZ-2922736,ZZ,ZZ20240521BOMPNQ2977.0,2977.0,BAe 146,05/21/2024,2024-05-21 14:12:00,2024-05-21 16:17:00,BOM,PNQ,91.0,102,54,-37,48,9,18,27,36,11,6,3,5,20,11,7,9,32,17,10,15,41,22,14,19,"{'F': 5, 'P': 4}","{'C': 7, 'J': 5, 'Z': 5}","{'Q': 8, 'R': 5, 'S': 3, 'T': 3, 'H': 5, 'M': 3}","{'Y': 3, 'A': 3, 'B': 1, 'D': 1, 'E': 1, 'G': 3, 'I': 1, 'K': 3, 'L': 1, 'N': 1, 'O': 1, 'U': 3, 'V': 1, 'W': 1, 'X': 1}"
INV-ZZ-8331608,SCH-ZZ-2922736,ZZ,ZZ20240522BOMPNQ2977.0,2977.0,BAe 146,05/22/2024,2024-05-22 14:12:00,2024-05-22 16:17:00,BOM,PNQ,91.0,107,53,-38,54,9,18,27,36,10,5,4,5,21,10,8,11,31,15,12,16,41,20,16,21,"{'F': 5, 'P': 4}","{'C': 7, 'J': 5, 'Z': 5}","{'Q': 8, 'R': 5, 'S': 3, 'T': 3, 'H': 5, 'M': 3}","{'Y': 3, 'A': 3, 'B': 1, 'D': 1, 'E': 1, 'G': 3, 'I': 1, 'K': 3, 'L': 1, 'N': 1, 'O': 1, 'U': 3, 'V': 1, 'W': 1, 'X': 1}"
INV-ZZ-7328224,SCH-ZZ-2922736,ZZ,ZZ20240524BOMPNQ2977.0,2977.0,BAe 146,05/24/2024,2024-05-24 14:12:00,2024-05-24 16:17:00,BOM,PNQ,91.0,108,55,-36,53,9,18,27,36,11,6,3,5,20,10,8,10,31,16,11,15,43,22,14,21,"{'F': 5, 'P': 4}","{'C': 7, 'J': 5, 'Z': 5}","{'Q': 8, 'R': 5, 'S': 3, 'T': 3, 'H': 5, 'M': 3}","{'Y': 3, 'A': 3, 'B': 1, 'D': 1, 'E': 1, 'G': 3, 'I': 1, 'K': 3, 'L': 1, 'N': 1, 'O': 1, 'U': 3, 'V': 1, 'W': 1, 'X': 1}"
INV-ZZ-8407018,SCH-ZZ-2922736,ZZ,ZZ20240525BOMPNQ2977.0,2977.0,BAe 146,05/25/2024,2024-05-25 14:12:00,2024-05-25 16:17:00,BOM,PNQ,91.0,100,48,-43,52,9,18,27,36,11,5,4,6,20,10,8,10,30,14,13,16,43,21,15,22,"{'F': 5, 'P': 4}","{'C': 7, 'J': 5, 'Z': 5}","{'Q': 8, 'R': 5, 'S': 3, 'T': 3, 'H': 5, 'M': 3}","{'Y': 3, 'A': 3, 'B': 1, 'D': 1, 'E': 1, 'G': 3, 'I': 1, 'K': 3, 'L': 1, 'N': 1, 'O': 1, 'U': 3, 'V': 1, 'W': 1, 'X': 1}"
INV-ZZ-6399321,SCH-ZZ-2922736,ZZ,ZZ20240527BOMPNQ2977.0,2977.0,BAe 146,05/27/2024,2024-05-27 14:12:00,2024-05-27 16:17:00,BOM,PNQ,91.0,101,51,-40,50,9,18,27,36,11,6,3,5,20,10,8,10,31,16,11,15,40,20,16,20,"{'F': 5, 'P': 4}","{'C': 7, 'J': 5, 'Z': 5}","{'Q': 8, 'R': 5, 'S': 3, 'T': 3, 'H': 5, 'M': 3}","{'Y': 3, 'A': 3, 'B': 1, 'D': 1, 'E': 1, 'G': 3, 'I': 1, 'K': 3, 'L': 1, 'N': 1, 'O': 1, 'U': 3, 'V': 1, 'W': 1, 'X': 1}"
INV-ZZ-9385836,SCH-ZZ-2922736,ZZ,ZZ20240528BOMPNQ2977.0,2977.0,BAe 146,05/28/2024,2024-05-28 14:12:00,2024-05-28 16:17:00,BOM,PNQ,91.0,108,54,-37,54,9,18,27,36,10,5,4,5,21,10,8,11,30,15,12,15,41,20,16,21,"{'F': 5, 'P': 4}","{'C': 7, 'J': 5, 'Z': 5}","{'Q': 8, 'R': 5, 'S': 3, 'T': 3, 'H': 5, 'M': 3}","{'Y': 3, 'A': 3, 'B': 1, 'D': 1, 'E': 1, 'G': 3, 'I': 1, 'K': 3, 'L': 1, 'N': 1, 'O': 1, 'U': 3, 'V': 1, 'W': 1, 'X': 1}"
INV-ZZ-3092298,SCH-ZZ-2922736,ZZ,ZZ20240529BOMPNQ2977.0,2977.0,BAe 146,05/29/2024,2024-05-29 14:12:00,2024-05-29 16:17:00,BOM,PNQ,91.0,104,47,-44,57,9,18,27,36,10,4,5,6,21,9,9,12,31,14,13,17,40,18,18,22,"{'F': 5, 'P': 4}","{'C': 7, 'J': 5, 'Z': 5}","{'Q': 8, 'R': 5, 'S': 3, 'T': 3, 'H': 5, 'M': 3}","{'Y': 3, 'A': 3, 'B': 1, 'D': 1, 'E': 1, 'G': 3, 'I': 1, 'K': 3, 'L': 1, 'N': 1, 'O': 1, 'U': 3, 'V': 1, 'W': 1, 'X': 1}"
INV-ZZ-6008577,SCH-ZZ-2922736,ZZ,ZZ20240531BOMPNQ2977.0,2977.0,BAe 146,05/31/2024,2024-05-31 14:12:00,2024-05-31 16:17:00,BOM,PNQ,91.0,100,52,-39,48,9,18,27,36,10,5,4,5,21,11,7,10,31,16,11,15,41,21,15,20,"{'F': 5, 'P': 4}","{'C': 7, 'J': 5, 'Z': 5}","{'Q': 8, 'R': 5, 'S': 3, 'T': 3, 'H': 5, 'M': 3}","{'Y': 3, 'A': 3, 'B': 1, 'D': 1, 'E': 1, 'G': 3, 'I': 1, 'K': 3, 'L': 1, 'N': 1, 'O': 1, 'U': 3, 'V': 1, 'W': 1, 'X': 1}"
INV-ZZ-7107487,SCH-ZZ-2922736,ZZ,ZZ20240601BOMPNQ2977.0,2977.0,BAe 146,06/01/2024,2024-06-01 14:12:00,2024-06-01 16:17:00,BOM,PNQ,91.0,102,50,-41,52,9,18,27,36,11,5,4,6,21,10,8,11,31,15,12,16,40,19,17,21,"{'F': 5, 'P': 4}","{'C': 7, 'J': 5, 'Z': 5}","{'Q': 8, 'R': 5, 'S': 3, 'T': 3, 'H': 5, 'M': 3}","{'Y': 3, 'A': 3, 'B': 1, 'D': 1, 'E': 1, 'G': 3, 'I': 1, 'K': 3, 'L': 1, 'N': 1, 'O': 1, 'U': 3, 'V': 1, 'W': 1, 'X': 1}"
INV-ZZ-1432838,SCH-ZZ-2922736,ZZ,ZZ20240603BOMPNQ2977.0,2977.0,BAe 146,06/03/2024,2024-06-03 14:12:00,2024-06-03 16:17:00,BOM,PNQ,91.0,104,51,-40,53,9,18,27,36,10,5,4,5,22,11,7,11,30,15,12,15,43,21,15,22,"{'F': 5, 'P': 4}","{'C': 7, 'J': 5, 'Z': 5}","{'Q': 8, 'R': 5, 'S': 3, 'T': 3, 'H': 5, 'M': 3}","{'Y': 3, 'A': 3, 'B': 1, 'D': 1, 'E': 1, 'G': 3, 'I': 1, 'K': 3, 'L': 1, 'N': 1, 'O': 1, 'U': 3, 'V': 1, 'W': 1, 'X': 1}"
INV-ZZ-3851920,SCH-ZZ-2922736,ZZ,ZZ20240604BOMPNQ2977.0,2977.0,BAe 146,06/04/2024,2024-06-04 14:12:00,2024-06-04 16:17:00,BOM,PNQ,91.0,108,49,-42,59,9,18,27,36,10,5,4,5,20,9,9,11,31,14,13,17,41,19,17,22,"{'F': 5, 'P': 4}","{'C': 7, 'J': 5, 'Z': 5}","{'Q': 8, 'R': 5, 'S': 3, 'T': 3, 'H': 5, 'M': 3}","{'Y': 3, 'A': 3, 'B': 1, 'D': 1, 'E': 1, 'G': 3, 'I': 1, 'K': 3, 'L': 1, 'N': 1, 'O': 1, 'U': 3, 'V': 1, 'W': 1, 'X': 1}"
INV-ZZ-4072201,SCH-ZZ-2922736,ZZ,ZZ20240605BOMPNQ2977.0,2977.0,BAe 146,06/05/2024,2024-06-05 14:12:00,2024-06-05 16:17:00,BOM,PNQ,91.0,101,47,-44,54,9,18,27,36,10,5,4,5,22,10,8,12,31,15,12,16,41,19,17,22,"{'F': 5, 'P': 4}","{'C': 7, 'J': 5, 'Z': 5}","{'Q': 8, 'R': 5, 'S': 3, 'T': 3, 'H': 5, 'M': 3}","{'Y': 3, 'A': 3, 'B': 1, 'D': 1, 'E': 1, 'G': 3, 'I': 1, 'K': 3, 'L': 1, 'N': 1, 'O': 1, 'U': 3, 'V': 1, 'W': 1, 'X': 1}"
INV-ZZ-8944954,SCH-ZZ-2922736,ZZ,ZZ20240607BOMPNQ2977.0,2977.0,BAe 146,06/07/2024,2024-06-07 14:12:00,2024-06-07 16:17:00,BOM,PNQ,91.0,106,50,-41,56,9,18,27,36,11,5,4,6,21,10,8,11,30,14,13,16,43,20,16,23,"{'F': 5, 'P': 4}","{'C': 7, 'J': 5, 'Z': 5}","{'Q': 8, 'R': 5, 'S': 3, 'T': 3, 'H': 5, 'M': 3}","{'Y': 3, 'A': 3, 'B': 1, 'D': 1, 'E': 1, 'G': 3, 'I': 1, 'K': 3, 'L': 1, 'N': 1, 'O': 1, 'U': 3, 'V': 1, 'W': 1, 'X': 1}"
INV-ZZ-8411928,SCH-ZZ-2922736,ZZ,ZZ20240608BOMPNQ2977.0,2977.0,BAe 146,06/08/2024,2024-06-08 14:12:00,2024-06-08 16:17:00,BOM,PNQ,91.0,108,50,-41,58,9,18,27,36,10,5,4,5,20,9,9,11,30,14,13,16,41,19,17,22,"{'F': 5, 'P': 4}","{'C': 7, 'J': 5, 'Z': 5}","{'Q': 8, 'R': 5, 'S': 3, 'T': 3, 'H': 5, 'M': 3}","{'Y': 3, 'A': 3, 'B': 1, 'D': 1, 'E': 1, 'G': 3, 'I': 1, 'K': 3, 'L': 1, 'N': 1, 'O': 1, 'U': 3, 'V': 1, 'W': 1, 'X': 1}"
INV-ZZ-8613930,SCH-ZZ-2922736,ZZ,ZZ20240610BOMPNQ2977.0,2977.0,BAe 146,06/10/2024,2024-06-10 14:12:00,2024-06-10 16:17:00,BOM,PNQ,91.0,103,50,-40,52,9,18,27,36,10,5,4,5,21,10,8,11,31,15,12,16,42,21,15,21,"{'F': 5, 'P': 4}","{'C': 7, 'J': 5, 'Z': 5}","{'Q': 8, 'R': 5, 'S': 3, 'T': 3, 'H': 5, 'M': 3}","{'Y': 3, 'A': 3, 'B': 1, 'D': 1, 'E': 1, 'G': 3, 'I': 1, 'K': 3, 'L': 1, 'N': 1, 'O': 1, 'U': 3, 'V': 1, 'W': 1, 'X': 1}"
INV-ZZ-8444969,SCH-ZZ-2922736,ZZ,ZZ20240611BOMPNQ2977.0,2977.0,BAe 146,06/11/2024,2024-06-11 14:12:00,2024-06-11 16:17:00,BOM,PNQ,91.0,107,49,-42,58,9,18,27,36,11,5,4,6,21,10,8,11,30,14,13,16,43,20,16,23,"{'F': 5, 'P': 4}","{'C': 7, 'J': 5, 'Z': 5}","{'Q': 8, 'R': 5, 'S': 3, 'T': 3, 'H': 5, 'M': 3}","{'Y': 3, 'A': 3, 'B': 1, 'D': 1, 'E': 1, 'G': 3, 'I': 1, 'K': 3, 'L': 1, 'N': 1, 'O': 1, 'U': 3, 'V': 1, 'W': 1, 'X': 1}"
INV-ZZ-9071939,SCH-ZZ-2922736,ZZ,ZZ20240612BOMPNQ2977.0,2977.0,BAe 146,06/12/2024,2024-06-12 14:12:00,2024-06-12 16:17:00,BOM,PNQ,91.0,102,49,-42,53,9,18,27,36,10,5,4,5,21,10,8,11,32,15,12,17,40,19,17,21,"{'F': 5, 'P': 4}","{'C': 7, 'J': 5, 'Z': 5}","{'Q': 8, 'R': 5, 'S': 3, 'T': 3, 'H': 5, 'M': 3}","{'Y': 3, 'A': 3, 'B': 1, 'D': 1, 'E': 1, 'G': 3, 'I': 1, 'K': 3, 'L': 1, 'N': 1, 'O': 1, 'U': 3, 'V': 1, 'W': 1, 'X': 1}"
INV-ZZ-2638958,SCH-ZZ-2922736,ZZ,ZZ20240614BOMPNQ2977.0,2977.0,BAe 146,06/14/2024,2024-06-14 14:12:00,2024-06-14 16:17:00,BOM,PNQ,91.0,102,48,-43,54,9,18,27,36,10,5,4,5,21,10,8,11,32,15,12,17,40,19,17,21,"{'F': 5, 'P': 4}","{'C': 7, 'J': 5, 'Z': 5}","{'Q': 8, 'R': 5, 'S': 3, 'T': 3, 'H': 5, 'M': 3}","{'Y': 3, 'A': 3, 'B': 1, 'D': 1, 'E': 1, 'G': 3, 'I': 1, 'K': 3, 'L': 1, 'N': 1, 'O': 1, 'U': 3, 'V': 1, 'W': 1, 'X': 1}"
INV-ZZ-3944163,SCH-ZZ-2922736,ZZ,ZZ20240615BOMPNQ2977.0,2977.0,BAe 146,06/15/2024,2024-06-15 14:12:00,2024-06-15 16:17:00,BOM,PNQ,91.0,101,47,-44,54,9,18,27,36,11,5,4,6,21,10,8,11,32,15,12,17,43,20,16,23,"{'F': 5, 'P': 4}","{'C': 7, 'J': 5, 'Z': 5}","{'Q': 8, 'R': 5, 'S': 3, 'T': 3, 'H': 5, 'M': 3}","{'Y': 3, 'A': 3, 'B': 1, 'D': 1, 'E': 1, 'G': 3, 'I': 1, 'K': 3, 'L': 1, 'N': 1, 'O': 1, 'U': 3, 'V': 1, 'W': 1, 'X': 1}"
INV-ZZ-9712519,SCH-ZZ-2922736,ZZ,ZZ20240617BOMPNQ2977.0,2977.0,BAe 146,06/17/2024,2024-06-17 14:12:00,2024-06-17 16:17:00,BOM,PNQ,91.0,101,48,-43,53,9,18,27,36,11,5,4,6,21,10,8,11,31,15,12,16,41,19,17,22,"{'F': 5, 'P': 4}","{'C': 7, 'J': 5, 'Z': 5}","{'Q': 8, 'R': 5, 'S': 3, 'T': 3, 'H': 5, 'M': 3}","{'Y': 3, 'A': 3, 'B': 1, 'D': 1, 'E': 1, 'G': 3, 'I': 1, 'K': 3, 'L': 1, 'N': 1, 'O': 1, 'U': 3, 'V': 1, 'W': 1, 'X': 1}"
INV-ZZ-5726645,SCH-ZZ-2922736,ZZ,ZZ20240618BOMPNQ2977.0,2977.0,BAe 146,06/18/2024,2024-06-18 14:12:00,2024-06-18 16:17:00,BOM,PNQ,91.0,106,47,-44,59,9,18,27,36,10,4,5,6,21,9,9,12,32,14,13,18,41,18,18,23,"{'F': 5, 'P': 4}","{'C': 7, 'J': 5, 'Z': 5}","{'Q': 8, 'R': 5, 'S': 3, 'T': 3, 'H': 5, 'M': 3}","{'Y': 3, 'A': 3, 'B': 1, 'D': 1, 'E': 1, 'G': 3, 'I': 1, 'K': 3, 'L': 1, 'N': 1, 'O': 1, 'U': 3, 'V': 1, 'W': 1, 'X': 1}"
INV-ZZ-7470566,SCH-ZZ-2922736,ZZ,ZZ20240619BOMPNQ2977.0,2977.0,BAe 146,06/19/2024,2024-06-19 14:12:00,2024-06-19 16:17:00,BOM,PNQ,91.0,103,43,-48,60,9,18,27,36,10,4,5,6,21,9,9,12,31,13,14,18,42,18,18,24,"{'F': 5, 'P': 4}","{'C': 7, 'J': 5, 'Z': 5}","{'Q': 8, 'R': 5, 'S': 3, 'T': 3, 'H': 5, 'M': 3}","{'Y': 3, 'A': 3, 'B': 1, 'D': 1, 'E': 1, 'G': 3, 'I': 1, 'K': 3, 'L': 1, 'N': 1, 'O': 1, 'U': 3, 'V': 1, 'W': 1, 'X': 1}"
INV-ZZ-5729937,SCH-ZZ-4701131,ZZ,ZZ20240421HYDIDR4122.0,4122.0,Airbus A320 Neo,04/21/2024,2024-04-21 06:08:00,2024-04-21 10:32:00,HYD,IDR,180.0,201,126,-54,75,18,36,54,72,21,13,5,8,42,26,10,16,61,38,16,23,85,53,19,32,"{'F': 11, 'P': 7}","{'C': 14, 'J': 11, 'Z': 11}","{'Q': 16, 'R': 11, 'S': 5, 'T': 5, 'H': 11, 'M': 5}","{'Y': 5, 'A': 5, 'B': 3, 'D': 3, 'E': 3, 'G': 5, 'I': 3, 'K': 5, 'L': 3, 'N': 3, 'O': 3, 'U': 5, 'V': 3, 'W': 3, 'X': 3}"
INV-ZZ-8797786,SCH-ZZ-4701131,ZZ,ZZ20240422HYDIDR4122.0,4122.0,Airbus A320 Neo,04/22/2024,2024-04-22 06:08:00,2024-04-22 10:32:00,HYD,IDR,180.0,199,109,-71,90,18,36,54,72,20,11,7,9,40,22,14,18,60,33,21,27,83,45,27,38,"{'F': 11, 'P': 7}","{'C': 14, 'J': 11, 'Z': 11}","{'Q': 16, 'R': 11, 'S': 5, 'T': 5, 'H': 11, 'M': 5}","{'Y': 5, 'A': 5, 'B': 3, 'D': 3, 'E': 3, 'G': 5, 'I': 3, 'K': 5, 'L': 3, 'N': 3, 'O': 3, 'U': 5, 'V': 3, 'W': 3, 'X': 3}"
INV-ZZ-4490283,SCH-ZZ-4701131,ZZ,ZZ20240427HYDIDR4122.0,4122.0,Airbus A320 Neo,04/27/2024,2024-04-27 06:08:00,2024-04-27 10:32:00,HYD,IDR,180.0,209,119,-61,90,18,36,54,72,21,12,6,9,43,24,12,19,63,36,18,27,80,45,27,35,"{'F': 11, 'P': 7}","{'C': 14, 'J': 11, 'Z': 11}","{'Q': 16, 'R': 11, 'S': 5, 'T': 5, 'H': 11, 'M': 5}","{'Y': 5, 'A': 5, 'B': 3, 'D': 3, 'E': 3, 'G': 5, 'I': 3, 'K': 5, 'L': 3, 'N': 3, 'O': 3, 'U': 5, 'V': 3, 'W': 3, 'X': 3}"
INV-ZZ-4967971,SCH-ZZ-4701131,ZZ,ZZ20240428HYDIDR4122.0,4122.0,Airbus A320 Neo,04/28/2024,2024-04-28 06:08:00,2024-04-28 10:32:00,HYD,IDR,180.0,213,113,-67,100,18,36,54,72,21,11,7,10,42,22,14,20,60,32,22,28,80,42,30,38,"{'F': 11, 'P': 7}","{'C': 14, 'J': 11, 'Z': 11}","{'Q': 16, 'R': 11, 'S': 5, 'T': 5, 'H': 11, 'M': 5}","{'Y': 5, 'A': 5, 'B': 3, 'D': 3, 'E': 3, 'G': 5, 'I': 3, 'K': 5, 'L': 3, 'N': 3, 'O': 3, 'U': 5, 'V': 3, 'W': 3, 'X': 3}"
INV-ZZ-3510955,SCH-ZZ-4701131,ZZ,ZZ20240429HYDIDR4122.0,4122.0,Airbus A320 Neo,04/29/2024,2024-04-29 06:08:00,2024-04-29 10:32:00,HYD,IDR,180.0,215,126,-54,89,18,36,54,72,21,12,6,9,41,24,12,17,60,35,19,25,86,50,22,36,"{'F': 11, 'P': 7}","{'C': 14, 'J': 11, 'Z': 11}","{'Q': 16, 'R': 11, 'S': 5, 'T': 5, 'H': 11, 'M': 5}","{'Y': 5, 'A': 5, 'B': 3, 'D': 3, 'E': 3, 'G': 5, 'I': 3, 'K': 5, 'L': 3, 'N': 3, 'O': 3, 'U': 5, 'V': 3, 'W': 3, 'X': 3}"
INV-ZZ-3254945,SCH-ZZ-4701131,ZZ,ZZ20240504HYDIDR4122.0,4122.0,Airbus A320 Neo,05/04/2024,2024-05-04 06:08:00,2024-05-04 10:32:00,HYD,IDR,180.0,213,113,-67,100,18,36,54,72,20,11,7,9,42,22,14,20,65,35,19,30,84,45,27,39,"{'F': 11, 'P': 7}","{'C': 14, 'J': 11, 'Z': 11}","{'Q': 16, 'R': 11, 'S': 5, 'T': 5, 'H': 11, 'M': 5}","{'Y': 5, 'A': 5, 'B': 3, 'D': 3, 'E': 3, 'G': 5, 'I': 3, 'K': 5, 'L': 3, 'N': 3, 'O': 3, 'U': 5, 'V': 3, 'W': 3, 'X': 3}"
INV-ZZ-7836617,SCH-ZZ-4701131,ZZ,ZZ20240505HYDIDR4122.0,4122.0,Airbus A320 Neo,05/05/2024,2024-05-05 06:08:00,2024-05-05 10:32:00,HYD,IDR,180.0,200,114,-66,86,18,36,54,72,21,12,6,9,42,24,12,18,64,36,18,28,85,48,24,37,"{'F': 11, 'P': 7}","{'C': 14, 'J': 11, 'Z': 11}","{'Q': 16, 'R': 11, 'S': 5, 'T': 5, 'H': 11, 'M': 5}","{'Y': 5, 'A': 5, 'B': 3, 'D': 3, 'E': 3, 'G': 5, 'I': 3, 'K': 5, 'L': 3, 'N': 3, 'O': 3, 'U': 5, 'V': 3, 'W': 3, 'X': 3}"
INV-ZZ-5081664,SCH-ZZ-4701131,ZZ,ZZ20240506HYDIDR4122.0,4122.0,Airbus A320 Neo,05/06/2024,2024-05-06 06:08:00,2024-05-06 10:32:00,HYD,IDR,180.0,200,114,-66,86,18,36,54,72,20,11,7,9,40,23,13,17,62,35,19,27,86,49,23,37,"{'F': 11, 'P': 7}","{'C': 14, 'J': 11, 'Z': 11}","{'Q': 16, 'R': 11, 'S': 5, 'T': 5, 'H': 11, 'M': 5}","{'Y': 5, 'A': 5, 'B': 3, 'D': 3, 'E': 3, 'G': 5, 'I': 3, 'K': 5, 'L': 3, 'N': 3, 'O': 3, 'U': 5, 'V': 3, 'W': 3, 'X': 3}"
INV-ZZ-4085840,SCH-ZZ-4701131,ZZ,ZZ20240511HYDIDR4122.0,4122.0,Airbus A320 Neo,05/11/2024,2024-05-11 06:08:00,2024-05-11 10:32:00,HYD,IDR,180.0,212,106,-74,106,18,36,54,72,21,11,7,10,41,21,15,20,61,31,23,30,81,41,31,40,"{'F': 11, 'P': 7}","{'C': 14, 'J': 11, 'Z': 11}","{'Q': 16, 'R': 11, 'S': 5, 'T': 5, 'H': 11, 'M': 5}","{'Y': 5, 'A': 5, 'B': 3, 'D': 3, 'E': 3, 'G': 5, 'I': 3, 'K': 5, 'L': 3, 'N': 3, 'O': 3, 'U': 5, 'V': 3, 'W': 3, 'X': 3}"
INV-ZZ-7718784,SCH-ZZ-4701131,ZZ,ZZ20240512HYDIDR4122.0,4122.0,Airbus A320 Neo,05/12/2024,2024-05-12 06:08:00,2024-05-12 10:32:00,HYD,IDR,180.0,205,114,-66,91,18,36,54,72,21,12,6,9,40,22,14,18,62,35,19,27,80,45,27,35,"{'F': 11, 'P': 7}","{'C': 14, 'J': 11, 'Z': 11}","{'Q': 16, 'R': 11, 'S': 5, 'T': 5, 'H': 11, 'M': 5}","{'Y': 5, 'A': 5, 'B': 3, 'D': 3, 'E': 3, 'G': 5, 'I': 3, 'K': 5, 'L': 3, 'N': 3, 'O': 3, 'U': 5, 'V': 3, 'W': 3, 'X': 3}"
INV-ZZ-1740527,SCH-ZZ-4701131,ZZ,ZZ20240513HYDIDR4122.0,4122.0,Airbus A320 Neo,05/13/2024,2024-05-13 06:08:00,2024-05-13 10:32:00,HYD,IDR,180.0,213,118,-62,95,18,36,54,72,21,12,6,9,41,23,13,18,63,35,19,28,84,47,25,37,"{'F': 11, 'P': 7}","{'C': 14, 'J': 11, 'Z': 11}","{'Q': 16, 'R': 11, 'S': 5, 'T': 5, 'H': 11, 'M': 5}","{'Y': 5, 'A': 5, 'B': 3, 'D': 3, 'E': 3, 'G': 5, 'I': 3, 'K': 5, 'L': 3, 'N': 3, 'O': 3, 'U': 5, 'V': 3, 'W': 3, 'X': 3}"
INV-ZZ-2705136,SCH-ZZ-4701131,ZZ,ZZ20240518HYDIDR4122.0,4122.0,Airbus A320 Neo,05/18/2024,2024-05-18 06:08:00,2024-05-18 10:32:00,HYD,IDR,180.0,208,103,-77,105,18,36,54,72,22,11,7,11,41,20,16,21,61,30,24,31,85,42,30,43,"{'F': 11, 'P': 7}","{'C': 14, 'J': 11, 'Z': 11}","{'Q': 16, 'R': 11, 'S': 5, 'T': 5, 'H': 11, 'M': 5}","{'Y': 5, 'A': 5, 'B': 3, 'D': 3, 'E': 3, 'G': 5, 'I': 3, 'K': 5, 'L': 3, 'N': 3, 'O': 3, 'U': 5, 'V': 3, 'W': 3, 'X': 3}"
INV-ZZ-8789299,SCH-ZZ-4701131,ZZ,ZZ20240519HYDIDR4122.0,4122.0,Airbus A320 Neo,05/19/2024,2024-05-19 06:08:00,2024-05-19 10:32:00,HYD,IDR,180.0,202,104,-76,98,18,36,54,72,21,11,7,10,42,22,14,20,63,32,22,31,85,44,28,41,"{'F': 11, 'P': 7}","{'C': 14, 'J': 11, 'Z': 11}","{'Q': 16, 'R': 11, 'S': 5, 'T': 5, 'H': 11, 'M': 5}","{'Y': 5, 'A': 5, 'B': 3, 'D': 3, 'E': 3, 'G': 5, 'I': 3, 'K': 5, 'L': 3, 'N': 3, 'O': 3, 'U': 5, 'V': 3, 'W': 3, 'X': 3}"
INV-ZZ-5543460,SCH-ZZ-4701131,ZZ,ZZ20240520HYDIDR4122.0,4122.0,Airbus A320 Neo,05/20/2024,2024-05-20 06:08:00,2024-05-20 10:32:00,HYD,IDR,180.0,206,102,-78,104,18,36,54,72,20,10,8,10,40,20,16,20,63,31,23,32,83,41,31,42,"{'F': 11, 'P': 7}","{'C': 14, 'J': 11, 'Z': 11}","{'Q': 16, 'R': 11, 'S': 5, 'T': 5, 'H': 11, 'M': 5}","{'Y': 5, 'A': 5, 'B': 3, 'D': 3, 'E': 3, 'G': 5, 'I': 3, 'K': 5, 'L': 3, 'N': 3, 'O': 3, 'U': 5, 'V': 3, 'W': 3, 'X': 3}"
INV-ZZ-8225225,SCH-ZZ-4701131,ZZ,ZZ20240525HYDIDR4122.0,4122.0,Airbus A320 Neo,05/25/2024,2024-05-25 06:08:00,2024-05-25 10:32:00,HYD,IDR,180.0,199,95,-85,104,18,36,54,72,21,10,8,11,40,19,17,21,60,29,25,31,86,41,31,45,"{'F': 11, 'P': 7}","{'C': 14, 'J': 11, 'Z': 11}","{'Q': 16, 'R': 11, 'S': 5, 'T': 5, 'H': 11, 'M': 5}","{'Y': 5, 'A': 5, 'B': 3, 'D': 3, 'E': 3, 'G': 5, 'I': 3, 'K': 5, 'L': 3, 'N': 3, 'O': 3, 'U': 5, 'V': 3, 'W': 3, 'X': 3}"
INV-ZZ-2587593,SCH-ZZ-4701131,ZZ,ZZ20240526HYDIDR4122.0,4122.0,Airbus A320 Neo,05/26/2024,2024-05-26 06:08:00,2024-05-26 10:32:00,HYD,IDR,180.0,206,110,-70,96,18,36,54,72,21,11,7,10,40,21,15,19,61,33,21,28,85,45,27,40,"{'F': 11, 'P': 7}","{'C': 14, 'J': 11, 'Z': 11}","{'Q': 16, 'R': 11, 'S': 5, 'T': 5, 'H': 11, 'M': 5}","{'Y': 5, 'A': 5, 'B': 3, 'D': 3, 'E': 3, 'G': 5, 'I': 3, 'K': 5, 'L': 3, 'N': 3, 'O': 3, 'U': 5, 'V': 3, 'W': 3, 'X': 3}"
INV-ZZ-9134957,SCH-ZZ-4701131,ZZ,ZZ20240527HYDIDR4122.0,4122.0,Airbus A320 Neo,05/27/2024,2024-05-27 06:08:00,2024-05-27 10:32:00,HYD,IDR,180.0,212,110,-70,102,18,36,54,72,22,11,7,11,41,21,15,20,60,31,23,29,81,42,30,39,"{'F': 11, 'P': 7}","{'C': 14, 'J': 11, 'Z': 11}","{'Q': 16, 'R': 11, 'S': 5, 'T': 5, 'H': 11, 'M': 5}","{'Y': 5, 'A': 5, 'B': 3, 'D': 3, 'E': 3, 'G': 5, 'I': 3, 'K': 5, 'L': 3, 'N': 3, 'O': 3, 'U': 5, 'V': 3, 'W': 3, 'X': 3}"
INV-ZZ-8515812,SCH-ZZ-4701131,ZZ,ZZ20240601HYDIDR4122.0,4122.0,Airbus A320 Neo,06/01/2024,2024-06-01 06:08:00,2024-06-01 10:32:00,HYD,IDR,180.0,204,90,-90,114,18,36,54,72,21,9,9,12,42,19,17,23,64,28,26,36,81,36,36,45,"{'F': 11, 'P': 7}","{'C': 14, 'J': 11, 'Z': 11}","{'Q': 16, 'R': 11, 'S': 5, 'T': 5, 'H': 11, 'M': 5}","{'Y': 5, 'A': 5, 'B': 3, 'D': 3, 'E': 3, 'G': 5, 'I': 3, 'K': 5, 'L': 3, 'N': 3, 'O': 3, 'U': 5, 'V': 3, 'W': 3, 'X': 3}"
INV-ZZ-7314318,SCH-ZZ-4701131,ZZ,ZZ20240602HYDIDR4122.0,4122.0,Airbus A320 Neo,06/02/2024,2024-06-02 06:08:00,2024-06-02 10:32:00,HYD,IDR,180.0,214,105,-75,109,18,36,54,72,20,10,8,10,41,20,16,21,61,30,24,31,85,42,30,43,"{'F': 11, 'P': 7}","{'C': 14, 'J': 11, 'Z': 11}","{'Q': 16, 'R': 11, 'S': 5, 'T': 5, 'H': 11, 'M': 5}","{'Y': 5, 'A': 5, 'B': 3, 'D': 3, 'E': 3, 'G': 5, 'I': 3, 'K': 5, 'L': 3, 'N': 3, 'O': 3, 'U': 5, 'V': 3, 'W': 3, 'X': 3}"
INV-ZZ-5836482,SCH-ZZ-4701131,ZZ,ZZ20240603HYDIDR4122.0,4122.0,Airbus A320 Neo,06/03/2024,2024-06-03 06:08:00,2024-06-03 10:32:00,HYD,IDR,180.0,210,97,-83,113,18,36,54,72,21,10,8,11,40,18,18,22,60,28,26,32,83,38,34,45,"{'F': 11, 'P': 7}","{'C': 14, 'J': 11, 'Z': 11}","{'Q': 16, 'R': 11, 'S': 5, 'T': 5, 'H': 11, 'M': 5}","{'Y': 5, 'A': 5, 'B': 3, 'D': 3, 'E': 3, 'G': 5, 'I': 3, 'K': 5, 'L': 3, 'N': 3, 'O': 3, 'U': 5, 'V': 3, 'W': 3, 'X': 3}"
INV-ZZ-8547709,SCH-ZZ-8577412,ZZ,ZZ20240420GOIBOM4529.0,4529.0,Boeing 777-300,04/20/2024,2024-04-20 17:42:00,2024-04-20 19:44:00,GOI,BOM,360.0,417,248,-112,169,36,72,108,144,43,26,10,17,86,51,21,35,120,71,37,49,169,101,43,68,"{'F': 22, 'P': 14}","{'C': 29, 'J': 22, 'Z': 22}","{'Q': 32, 'R': 22, 'S': 11, 'T': 11, 'H': 22, 'M': 11}","{'Y': 11, 'A': 11, 'B': 5, 'D': 5, 'E': 5, 'G': 11, 'I': 5, 'K': 11, 'L': 5, 'N': 5, 'O': 5, 'U': 11, 'V': 5, 'W': 5, 'X': 5}"
INV-ZZ-2394886,SCH-ZZ-8577412,ZZ,ZZ20240422GOIBOM4529.0,4529.0,Boeing 777-300,04/22/2024,2024-04-22 17:42:00,2024-04-22 19:44:00,GOI,BOM,360.0,397,243,-117,154,36,72,108,144,43,26,10,17,81,50,22,31,129,79,29,50,168,103,41,65,"{'F': 22, 'P': 14}","{'C': 29, 'J': 22, 'Z': 22}","{'Q': 32, 'R': 22, 'S': 11, 'T': 11, 'H': 22, 'M': 11}","{'Y': 11, 'A': 11, 'B': 5, 'D': 5, 'E': 5, 'G': 11, 'I': 5, 'K': 11, 'L': 5, 'N': 5, 'O': 5, 'U': 11, 'V': 5, 'W': 5, 'X': 5}"
INV-ZZ-2276217,SCH-ZZ-8577412,ZZ,ZZ20240427GOIBOM4529.0,4529.0,Boeing 777-300,04/27/2024,2024-04-27 17:42:00,2024-04-27 19:44:00,GOI,BOM,360.0,423,238,-122,185,36,72,108,144,43,24,12,19,84,47,25,37,129,73,35,56,162,91,53,71,"{'F': 22, 'P': 14}","{'C': 29, 'J': 22, 'Z': 22}","{'Q': 32, 'R': 22, 'S': 11, 'T': 11, 'H': 22, 'M': 11}","{'Y': 11, 'A': 11, 'B': 5, 'D': 5, 'E': 5, 'G': 11, 'I': 5, 'K': 11, 'L': 5, 'N': 5, 'O': 5, 'U': 11, 'V': 5, 'W': 5, 'X': 5}"
INV-ZZ-6616598,SCH-ZZ-8577412,ZZ,ZZ20240429GOIBOM4529.0,4529.0,Boeing 777-300,04/29/2024,2024-04-29 17:42:00,2024-04-29 19:44:00,GOI,BOM,360.0,419,236,-124,183,36,72,108,144,42,24,12,18,81,46,26,35,121,68,40,53,170,96,48,74,"{'F': 22, 'P': 14}","{'C': 29, 'J': 22, 'Z': 22}","{'Q': 32, 'R': 22, 'S': 11, 'T': 11, 'H': 22, 'M': 11}","{'Y': 11, 'A': 11, 'B': 5, 'D': 5, 'E': 5, 'G': 11, 'I': 5, 'K': 11, 'L': 5, 'N': 5, 'O': 5, 'U': 11, 'V': 5, 'W': 5, 'X': 5}"
INV-ZZ-8272529,SCH-ZZ-8577412,ZZ,ZZ20240504GOIBOM4529.0,4529.0,Boeing 777-300,05/04/2024,2024-05-04 17:42:00,2024-05-04 19:44:00,GOI,BOM,360.0,424,231,-129,193,36,72,108,144,41,22,14,19,85,46,26,39,125,68,40,57,160,87,57,73,"{'F': 22, 'P': 14}","{'C': 29, 'J': 22, 'Z': 22}","{'Q': 32, 'R': 22, 'S': 11, 'T': 11, 'H': 22, 'M': 11}","{'Y': 11, 'A': 11, 'B': 5, 'D': 5, 'E': 5, 'G': 11, 'I': 5, 'K': 11, 'L': 5, 'N': 5, 'O': 5, 'U': 11, 'V': 5, 'W': 5, 'X': 5}"
INV-ZZ-2459974,SCH-ZZ-8577412,ZZ,ZZ20240506GOIBOM4529.0,4529.0,Boeing 777-300,05/06/2024,2024-05-06 17:42:00,2024-05-06 19:44:00,GOI,BOM,360.0,422,242,-118,180,36,72,108,144,41,23,13,18,83,48,24,35,119,68,40,51,169,97,47,72,"{'F': 22, 'P': 14}","{'C': 29, 'J': 22, 'Z': 22}","{'Q': 32, 'R': 22, 'S': 11, 'T': 11, 'H': 22, 'M': 11}","{'Y': 11, 'A': 11, 'B': 5, 'D': 5, 'E': 5, 'G': 11, 'I': 5, 'K': 11, 'L': 5, 'N': 5, 'O': 5, 'U': 11, 'V': 5, 'W': 5, 'X': 5}"
INV-ZZ-4959461,SCH-ZZ-8577412,ZZ,ZZ20240511GOIBOM4529.0,4529.0,Boeing 777-300,05/11/2024,2024-05-11 17:42:00,2024-05-11 19:44:00,GOI,BOM,360.0,402,209,-151,193,36,72,108,144,40,21,15,19,81,42,30,39,119,62,46,57,163,85,59,78,"{'F': 22, 'P': 14}","{'C': 29, 'J': 22, 'Z': 22}","{'Q': 32, 'R': 22, 'S': 11, 'T': 11, 'H': 22, 'M': 11}","{'Y': 11, 'A': 11, 'B': 5, 'D': 5, 'E': 5, 'G': 11, 'I': 5, 'K': 11, 'L': 5, 'N': 5, 'O': 5, 'U': 11, 'V': 5, 'W': 5, 'X': 5}"
INV-ZZ-4055983,SCH-ZZ-8577412,ZZ,ZZ20240513GOIBOM4529.0,4529.0,Boeing 777-300,05/13/2024,2024-05-13 17:42:00,2024-05-13 19:44:00,GOI,BOM,360.0,411,220,-140,191,36,72,108,144,40,21,15,19,85,46,26,39,120,64,44,56,162,87,57,75,"{'F': 22, 'P': 14}","{'C': 29, 'J': 22, 'Z': 22}","{'Q': 32, 'R': 22, 'S': 11, 'T': 11, 'H': 22, 'M': 11}","{'Y': 11, 'A': 11, 'B': 5, 'D': 5, 'E': 5, 'G': 11, 'I': 5, 'K': 11, 'L': 5, 'N': 5, 'O': 5, 'U': 11, 'V': 5, 'W': 5, 'X': 5}"
INV-ZZ-5841030,SCH-ZZ-8577412,ZZ,ZZ20240518GOIBOM4529.0,4529.0,Boeing 777-300,05/18/2024,2024-05-18 17:42:00,2024-05-18 19:44:00,GOI,BOM,360.0,425,212,-148,213,36,72,108,144,43,21,15,22,83,41,31,42,128,64,44,64,167,83,61,84,"{'F': 22, 'P': 14}","{'C': 29, 'J': 22, 'Z': 22}","{'Q': 32, 'R': 22, 'S': 11, 'T': 11, 'H': 22, 'M': 11}","{'Y': 11, 'A': 11, 'B': 5, 'D': 5, 'E': 5, 'G': 11, 'I': 5, 'K': 11, 'L': 5, 'N': 5, 'O': 5, 'U': 11, 'V': 5, 'W': 5, 'X': 5}"
INV-ZZ-8447913,SCH-ZZ-8577412,ZZ,ZZ20240520GOIBOM4529.0,4529.0,Boeing 777-300,05/20/2024,2024-05-20 17:42:00,2024-05-20 19:44:00,GOI,BOM,360.0,407,215,-145,192,36,72,108,144,40,21,15,19,85,45,27,40,121,64,44,57,159,84,60,75,"{'F': 22, 'P': 14}","{'C': 29, 'J': 22, 'Z': 22}","{'Q': 32, 'R': 22, 'S': 11, 'T': 11, 'H': 22, 'M': 11}","{'Y': 11, 'A': 11, 'B': 5, 'D': 5, 'E': 5, 'G': 11, 'I': 5, 'K': 11, 'L': 5, 'N': 5, 'O': 5, 'U': 11, 'V': 5, 'W': 5, 'X': 5}"
INV-ZZ-9025476,SCH-ZZ-8577412,ZZ,ZZ20240525GOIBOM4529.0,4529.0,Boeing 777-300,05/25/2024,2024-05-25 17:42:00,2024-05-25 19:44:00,GOI,BOM,360.0,423,208,-152,215,36,72,108,144,40,20,16,20,81,40,32,41,127,62,46,65,162,80,64,82,"{'F': 22, 'P': 14}","{'C': 29, 'J': 22, 'Z': 22}","{'Q': 32, 'R': 22, 'S': 11, 'T': 11, 'H': 22, 'M': 11}","{'Y': 11, 'A': 11, 'B': 5, 'D': 5, 'E': 5, 'G': 11, 'I': 5, 'K': 11, 'L': 5, 'N': 5, 'O': 5, 'U': 11, 'V': 5, 'W': 5, 'X': 5}"
INV-ZZ-9177284,SCH-ZZ-8577412,ZZ,ZZ20240527GOIBOM4529.0,4529.0,Boeing 777-300,05/27/2024,2024-05-27 17:42:00,2024-05-27 19:44:00,GOI,BOM,360.0,399,205,-155,194,36,72,108,144,42,22,14,20,81,42,30,39,122,63,45,59,160,82,62,78,"{'F': 22, 'P': 14}","{'C': 29, 'J': 22, 'Z': 22}","{'Q': 32, 'R': 22, 'S': 11, 'T': 11, 'H': 22, 'M': 11}","{'Y': 11, 'A': 11, 'B': 5, 'D': 5, 'E': 5, 'G': 11, 'I': 5, 'K': 11, 'L': 5, 'N': 5, 'O': 5, 'U': 11, 'V': 5, 'W': 5, 'X': 5}"
INV-ZZ-9183493,SCH-ZZ-8577412,ZZ,ZZ20240601GOIBOM4529.0,4529.0,Boeing 777-300,06/01/2024,2024-06-01 17:42:00,2024-06-01 19:44:00,GOI,BOM,360.0,397,177,-183,220,36,72,108,144,41,18,18,23,79,35,37,44,121,54,54,67,169,75,69,94,"{'F': 22, 'P': 14}","{'C': 29, 'J': 22, 'Z': 22}","{'Q': 32, 'R': 22, 'S': 11, 'T': 11, 'H': 22, 'M': 11}","{'Y': 11, 'A': 11, 'B': 5, 'D': 5, 'E': 5, 'G': 11, 'I': 5, 'K': 11, 'L': 5, 'N': 5, 'O': 5, 'U': 11, 'V': 5, 'W': 5, 'X': 5}"
INV-ZZ-3641383,SCH-ZZ-8577412,ZZ,ZZ20240603GOIBOM4529.0,4529.0,Boeing 777-300,06/03/2024,2024-06-03 17:42:00,2024-06-03 19:44:00,GOI,BOM,360.0,408,194,-166,214,36,72,108,144,43,20,16,23,83,39,33,44,124,59,49,65,169,80,64,89,"{'F': 22, 'P': 14}","{'C': 29, 'J': 22, 'Z': 22}","{'Q': 32, 'R': 22, 'S': 11, 'T': 11, 'H': 22, 'M': 11}","{'Y': 11, 'A': 11, 'B': 5, 'D': 5, 'E': 5, 'G': 11, 'I': 5, 'K': 11, 'L': 5, 'N': 5, 'O': 5, 'U': 11, 'V': 5, 'W': 5, 'X': 5}"
INV-ZZ-2511213,SCH-ZZ-7792093,ZZ,ZZ20240505MAACJB2120.0,2120.0,Boeing 757,05/05/2024,2024-05-05 02:51:00,2024-05-05 08:04:00,MAA,CJB,209.0,235,124,-85,111,20,41,62,83,23,12,8,11,48,25,16,23,70,37,25,33,94,50,33,44,"{'F': 12, 'P': 8}","{'C': 16, 'J': 12, 'Z': 12}","{'Q': 19, 'R': 12, 'S': 6, 'T': 6, 'H': 12, 'M': 6}","{'Y': 6, 'A': 6, 'B': 3, 'D': 3, 'E': 3, 'G': 6, 'I': 3, 'K': 6, 'L': 3, 'N': 3, 'O': 3, 'U': 6, 'V': 3, 'W': 3, 'X': 3}"
INV-ZZ-9428054,SCH-ZZ-7792093,ZZ,ZZ20240509MAACJB2120.0,2120.0,Boeing 757,05/09/2024,2024-05-09 02:51:00,2024-05-09 08:04:00,MAA,CJB,209.0,239,130,-79,109,20,41,62,83,23,13,7,10,46,25,16,21,70,38,24,32,93,51,32,42,"{'F': 12, 'P': 8}","{'C': 16, 'J': 12, 'Z': 12}","{'Q': 19, 'R': 12, 'S': 6, 'T': 6, 'H': 12, 'M': 6}","{'Y': 6, 'A': 6, 'B': 3, 'D': 3, 'E': 3, 'G': 6, 'I': 3, 'K': 6, 'L': 3, 'N': 3, 'O': 3, 'U': 6, 'V': 3, 'W': 3, 'X': 3}"
INV-ZZ-5340091,SCH-ZZ-7792093,ZZ,ZZ20240510MAACJB2120.0,2120.0,Boeing 757,05/10/2024,2024-05-10 02:51:00,2024-05-10 08:04:00,MAA,CJB,209.0,237,122,-87,115,20,41,62,83,24,12,8,12,45,23,18,22,74,38,24,36,97,50,33,47,"{'F': 12, 'P': 8}","{'C': 16, 'J': 12, 'Z': 12}","{'Q': 19, 'R': 12, 'S': 6, 'T': 6, 'H': 12, 'M': 6}","{'Y': 6, 'A': 6, 'B': 3, 'D': 3, 'E': 3, 'G': 6, 'I': 3, 'K': 6, 'L': 3, 'N': 3, 'O': 3, 'U': 6, 'V': 3, 'W': 3, 'X': 3}"
INV-ZZ-5226968,SCH-ZZ-7792093,ZZ,ZZ20240512MAACJB2120.0,2120.0,Boeing 757,05/12/2024,2024-05-12 02:51:00,2024-05-12 08:04:00,MAA,CJB,209.0,235,130,-79,105,20,41,62,83,23,13,7,10,47,26,15,21,69,38,24,31,94,52,31,42,"{'F': 12, 'P': 8}","{'C': 16, 'J': 12, 'Z': 12}","{'Q': 19, 'R': 12, 'S': 6, 'T': 6, 'H': 12, 'M': 6}","{'Y': 6, 'A': 6, 'B': 3, 'D': 3, 'E': 3, 'G': 6, 'I': 3, 'K': 6, 'L': 3, 'N': 3, 'O': 3, 'U': 6, 'V': 3, 'W': 3, 'X': 3}"
INV-ZZ-1956993,SCH-ZZ-7792093,ZZ,ZZ20240516MAACJB2120.0,2120.0,Boeing 757,05/16/2024,2024-05-16 02:51:00,2024-05-16 08:04:00,MAA,CJB,209.0,247,127,-82,120,20,41,62,83,22,11,9,11,46,24,17,22,70,36,26,34,97,50,33,47,"{'F': 12, 'P': 8}","{'C': 16, 'J': 12, 'Z': 12}","{'Q': 19, 'R': 12, 'S': 6, 'T': 6, 'H': 12, 'M': 6}","{'Y': 6, 'A': 6, 'B': 3, 'D': 3, 'E': 3, 'G': 6, 'I': 3, 'K': 6, 'L': 3, 'N': 3, 'O': 3, 'U': 6, 'V': 3, 'W': 3, 'X': 3}"
INV-ZZ-8512334,SCH-ZZ-7792093,ZZ,ZZ20240517MAACJB2120.0,2120.0,Boeing 757,05/17/2024,2024-05-17 02:51:00,2024-05-17 08:04:00,MAA,CJB,209.0,250,124,-85,126,20,41,62,83,23,11,9,12,47,23,18,24,72,36,26,36,96,48,35,48,"{'F': 12, 'P': 8}","{'C': 16, 'J': 12, 'Z': 12}","{'Q': 19, 'R': 12, 'S': 6, 'T': 6, 'H': 12, 'M': 6}","{'Y': 6, 'A': 6, 'B': 3, 'D': 3, 'E': 3, 'G': 6, 'I': 3, 'K': 6, 'L': 3, 'N': 3, 'O': 3, 'U': 6, 'V': 3, 'W': 3, 'X': 3}"
INV-ZZ-6461120,SCH-ZZ-7792093,ZZ,ZZ20240519MAACJB2120.0,2120.0,Boeing 757,05/19/2024,2024-05-19 02:51:00,2024-05-19 08:04:00,MAA,CJB,209.0,231,125,-84,106,20,41,62,83,23,12,8,11,49,27,14,22,72,39,23,33,93,50,33,43,"{'F': 12, 'P': 8}","{'C': 16, 'J': 12, 'Z': 12}","{'Q': 19, 'R': 12, 'S': 6, 'T': 6, 'H': 12, 'M': 6}","{'Y': 6, 'A': 6, 'B': 3, 'D': 3, 'E': 3, 'G': 6, 'I': 3, 'K': 6, 'L': 3, 'N': 3, 'O': 3, 'U': 6, 'V': 3, 'W': 3, 'X': 3}"
INV-ZZ-3933489,SCH-ZZ-7792093,ZZ,ZZ20240523MAACJB2120.0,2120.0,Boeing 757,05/23/2024,2024-05-23 02:51:00,2024-05-23 08:04:00,MAA,CJB,209.0,243,122,-87,121,20,41,62,83,24,12,8,12,47,24,17,23,74,37,25,37,95,48,35,47,"{'F': 12, 'P': 8}","{'C': 16, 'J': 12, 'Z': 12}","{'Q': 19, 'R': 12, 'S': 6, 'T': 6, 'H': 12, 'M': 6}","{'Y': 6, 'A': 6, 'B': 3, 'D': 3, 'E': 3, 'G': 6, 'I': 3, 'K': 6, 'L': 3, 'N': 3, 'O': 3, 'U': 6, 'V': 3, 'W': 3, 'X': 3}"
INV-ZZ-3252840,SCH-ZZ-7792093,ZZ,ZZ20240524MAACJB2120.0,2120.0,Boeing 757,05/24/2024,2024-05-24 02:51:00,2024-05-24 08:04:00,MAA,CJB,209.0,242,125,-84,117,20,41,62,83,23,12,8,11,49,25,16,24,70,36,26,34,98,51,32,47,"{'F': 12, 'P': 8}","{'C': 16, 'J': 12, 'Z': 12}","{'Q': 19, 'R': 12, 'S': 6, 'T': 6, 'H': 12, 'M': 6}","{'Y': 6, 'A': 6, 'B': 3, 'D': 3, 'E': 3, 'G': 6, 'I': 3, 'K': 6, 'L': 3, 'N': 3, 'O': 3, 'U': 6, 'V': 3, 'W': 3, 'X': 3}"
INV-ZZ-5678964,SCH-ZZ-7792093,ZZ,ZZ20240526MAACJB2120.0,2120.0,Boeing 757,05/26/2024,2024-05-26 02:51:00,2024-05-26 08:04:00,MAA,CJB,209.0,250,130,-79,120,20,41,62,83,22,11,9,11,46,24,17,22,72,38,24,34,94,49,34,45,"{'F': 12, 'P': 8}","{'C': 16, 'J': 12, 'Z': 12}","{'Q': 19, 'R': 12, 'S': 6, 'T': 6, 'H': 12, 'M': 6}","{'Y': 6, 'A': 6, 'B': 3, 'D': 3, 'E': 3, 'G': 6, 'I': 3, 'K': 6, 'L': 3, 'N': 3, 'O': 3, 'U': 6, 'V': 3, 'W': 3, 'X': 3}"
INV-ZZ-5671615,SCH-ZZ-7792093,ZZ,ZZ20240530MAACJB2120.0,2120.0,Boeing 757,05/30/2024,2024-05-30 02:51:00,2024-05-30 08:04:00,MAA,CJB,209.0,230,114,-95,116,20,41,62,83,22,11,9,11,46,23,18,23,72,36,26,36,93,46,37,47,"{'F': 12, 'P': 8}","{'C': 16, 'J': 12, 'Z': 12}","{'Q': 19, 'R': 12, 'S': 6, 'T': 6, 'H': 12, 'M': 6}","{'Y': 6, 'A': 6, 'B': 3, 'D': 3, 'E': 3, 'G': 6, 'I': 3, 'K': 6, 'L': 3, 'N': 3, 'O': 3, 'U': 6, 'V': 3, 'W': 3, 'X': 3}"
INV-ZZ-6558181,SCH-ZZ-7792093,ZZ,ZZ20240531MAACJB2120.0,2120.0,Boeing 757,05/31/2024,2024-05-31 02:51:00,2024-05-31 08:04:00,MAA,CJB,209.0,244,111,-98,133,20,41,62,83,24,11,9,13,46,21,20,25,70,32,30,38,96,44,39,52,"{'F': 12, 'P': 8}","{'C': 16, 'J': 12, 'Z': 12}","{'Q': 19, 'R': 12, 'S': 6, 'T': 6, 'H': 12, 'M': 6}","{'Y': 6, 'A': 6, 'B': 3, 'D': 3, 'E': 3, 'G': 6, 'I': 3, 'K': 6, 'L': 3, 'N': 3, 'O': 3, 'U': 6, 'V': 3, 'W': 3, 'X': 3}"
INV-ZZ-2700199,SCH-ZZ-7792093,ZZ,ZZ20240602MAACJB2120.0,2120.0,Boeing 757,06/02/2024,2024-06-02 02:51:00,2024-06-02 08:04:00,MAA,CJB,209.0,248,114,-95,134,20,41,62,83,23,11,9,12,47,22,19,25,69,32,30,37,98,45,38,53,"{'F': 12, 'P': 8}","{'C': 16, 'J': 12, 'Z': 12}","{'Q': 19, 'R': 12, 'S': 6, 'T': 6, 'H': 12, 'M': 6}","{'Y': 6, 'A': 6, 'B': 3, 'D': 3, 'E': 3, 'G': 6, 'I': 3, 'K': 6, 'L': 3, 'N': 3, 'O': 3, 'U': 6, 'V': 3, 'W': 3, 'X': 3}"
INV-ZZ-9382367,SCH-ZZ-7792093,ZZ,ZZ20240606MAACJB2120.0,2120.0,Boeing 757,06/06/2024,2024-06-06 02:51:00,2024-06-06 08:04:00,MAA,CJB,209.0,238,113,-96,125,20,41,62,83,23,11,9,12,46,22,19,24,71,34,28,37,97,46,37,51,"{'F': 12, 'P': 8}","{'C': 16, 'J': 12, 'Z': 12}","{'Q': 19, 'R': 12, 'S': 6, 'T': 6, 'H': 12, 'M': 6}","{'Y': 6, 'A': 6, 'B': 3, 'D': 3, 'E': 3, 'G': 6, 'I': 3, 'K': 6, 'L': 3, 'N': 3, 'O': 3, 'U': 6, 'V': 3, 'W': 3, 'X': 3}"
INV-ZZ-7690665,SCH-ZZ-7792093,ZZ,ZZ20240607MAACJB2120.0,2120.0,Boeing 757,06/07/2024,2024-06-07 02:51:00,2024-06-07 08:04:00,MAA,CJB,209.0,240,115,-94,125,20,41,62,83,23,11,9,12,48,23,18,25,69,33,29,36,92,44,39,48,"{'F': 12, 'P': 8}","{'C': 16, 'J': 12, 'Z': 12}","{'Q': 19, 'R': 12, 'S': 6, 'T': 6, 'H': 12, 'M': 6}","{'Y': 6, 'A': 6, 'B': 3, 'D': 3, 'E': 3, 'G': 6, 'I': 3, 'K': 6, 'L': 3, 'N': 3, 'O': 3, 'U': 6, 'V': 3, 'W': 3, 'X': 3}"
INV-ZZ-5109624,SCH-ZZ-7792093,ZZ,ZZ20240609MAACJB2120.0,2120.0,Boeing 757,06/09/2024,2024-06-09 02:51:00,2024-06-09 08:04:00,MAA,CJB,209.0,240,118,-91,122,20,41,62,83,23,11,9,12,46,23,18,23,71,35,27,36,92,45,38,47,"{'F': 12, 'P': 8}","{'C': 16, 'J': 12, 'Z': 12}","{'Q': 19, 'R': 12, 'S': 6, 'T': 6, 'H': 12, 'M': 6}","{'Y': 6, 'A': 6, 'B': 3, 'D': 3, 'E': 3, 'G': 6, 'I': 3, 'K': 6, 'L': 3, 'N': 3, 'O': 3, 'U': 6, 'V': 3, 'W': 3, 'X': 3}"
INV-ZZ-4462514,SCH-ZZ-7792093,ZZ,ZZ20240613MAACJB2120.0,2120.0,Boeing 757,06/13/2024,2024-06-13 02:51:00,2024-06-13 08:04:00,MAA,CJB,209.0,248,103,-106,145,20,41,62,83,22,9,11,13,46,19,22,27,74,31,31,43,94,39,44,55,"{'F': 12, 'P': 8}","{'C': 16, 'J': 12, 'Z': 12}","{'Q': 19, 'R': 12, 'S': 6, 'T': 6, 'H': 12, 'M': 6}","{'Y': 6, 'A': 6, 'B': 3, 'D': 3, 'E': 3, 'G': 6, 'I': 3, 'K': 6, 'L': 3, 'N': 3, 'O': 3, 'U': 6, 'V': 3, 'W': 3, 'X': 3}"
INV-ZZ-6208157,SCH-ZZ-7792093,ZZ,ZZ20240614MAACJB2120.0,2120.0,Boeing 757,06/14/2024,2024-06-14 02:51:00,2024-06-14 08:04:00,MAA,CJB,209.0,248,104,-105,144,20,41,62,83,22,9,11,13,48,20,21,28,74,31,31,43,94,39,44,55,"{'F': 12, 'P': 8}","{'C': 16, 'J': 12, 'Z': 12}","{'Q': 19, 'R': 12, 'S': 6, 'T': 6, 'H': 12, 'M': 6}","{'Y': 6, 'A': 6, 'B': 3, 'D': 3, 'E': 3, 'G': 6, 'I': 3, 'K': 6, 'L': 3, 'N': 3, 'O': 3, 'U': 6, 'V': 3, 'W': 3, 'X': 3}"
INV-ZZ-5293389,SCH-ZZ-7792093,ZZ,ZZ20240616MAACJB2120.0,2120.0,Boeing 757,06/16/2024,2024-06-16 02:51:00,2024-06-16 08:04:00,MAA,CJB,209.0,237,104,-105,133,20,41,62,83,22,10,10,12,46,20,21,26,69,30,32,39,98,43,40,55,"{'F': 12, 'P': 8}","{'C': 16, 'J': 12, 'Z': 12}","{'Q': 19, 'R': 12, 'S': 6, 'T': 6, 'H': 12, 'M': 6}","{'Y': 6, 'A': 6, 'B': 3, 'D': 3, 'E': 3, 'G': 6, 'I': 3, 'K': 6, 'L': 3, 'N': 3, 'O': 3, 'U': 6, 'V': 3, 'W': 3, 'X': 3}"
INV-ZZ-5846355,SCH-ZZ-2098565,ZZ,ZZ20240510IDRHYD2792.0,2792.0,BAe 146,05/10/2024,2024-05-10 12:22:00,2024-05-10 14:12:00,IDR,HYD,91.0,101,52,-39,49,9,18,27,36,10,5,4,5,20,10,8,10,31,16,11,15,42,21,15,21,"{'F': 5, 'P': 4}","{'C': 7, 'J': 5, 'Z': 5}","{'Q': 8, 'R': 5, 'S': 3, 'T': 3, 'H': 5, 'M': 3}","{'Y': 3, 'A': 3, 'B': 1, 'D': 1, 'E': 1, 'G': 3, 'I': 1, 'K': 3, 'L': 1, 'N': 1, 'O': 1, 'U': 3, 'V': 1, 'W': 1, 'X': 1}"
INV-ZZ-5004957,SCH-ZZ-2098565,ZZ,ZZ20240512IDRHYD2792.0,2792.0,BAe 146,05/12/2024,2024-05-12 12:22:00,2024-05-12 14:12:00,IDR,HYD,91.0,106,54,-37,52,9,18,27,36,11,6,3,5,22,11,7,11,32,16,11,16,40,20,16,20,"{'F': 5, 'P': 4}","{'C': 7, 'J': 5, 'Z': 5}","{'Q': 8, 'R': 5, 'S': 3, 'T': 3, 'H': 5, 'M': 3}","{'Y': 3, 'A': 3, 'B': 1, 'D': 1, 'E': 1, 'G': 3, 'I': 1, 'K': 3, 'L': 1, 'N': 1, 'O': 1, 'U': 3, 'V': 1, 'W': 1, 'X': 1}"
INV-ZZ-4205419,SCH-ZZ-2098565,ZZ,ZZ20240517IDRHYD2792.0,2792.0,BAe 146,05/17/2024,2024-05-17 12:22:00,2024-05-17 14:12:00,IDR,HYD,91.0,100,51,-40,49,9,18,27,36,11,6,3,5,20,10,8,10,30,15,12,15,43,22,14,21,"{'F': 5, 'P': 4}","{'C': 7, 'J': 5, 'Z': 5}","{'Q': 8, 'R': 5, 'S': 3, 'T': 3, 'H': 5, 'M': 3}","{'Y': 3, 'A': 3, 'B': 1, 'D': 1, 'E': 1, 'G': 3, 'I': 1, 'K': 3, 'L': 1, 'N': 1, 'O': 1, 'U': 3, 'V': 1, 'W': 1, 'X': 1}"
INV-ZZ-2189780,SCH-ZZ-2098565,ZZ,ZZ20240519IDRHYD2792.0,2792.0,BAe 146,05/19/2024,2024-05-19 12:22:00,2024-05-19 14:12:00,IDR,HYD,91.0,102,51,-40,51,9,18,27,36,11,5,4,6,21,10,8,11,32,16,11,16,41,20,16,21,"{'F': 5, 'P': 4}","{'C': 7, 'J': 5, 'Z': 5}","{'Q': 8, 'R': 5, 'S': 3, 'T': 3, 'H': 5, 'M': 3}","{'Y': 3, 'A': 3, 'B': 1, 'D': 1, 'E': 1, 'G': 3, 'I': 1, 'K': 3, 'L': 1, 'N': 1, 'O': 1, 'U': 3, 'V': 1, 'W': 1, 'X': 1}"
INV-ZZ-9318196,SCH-ZZ-2098565,ZZ,ZZ20240524IDRHYD2792.0,2792.0,BAe 146,05/24/2024,2024-05-24 12:22:00,2024-05-24 14:12:00,IDR,HYD,91.0,101,53,-38,48,9,18,27,36,11,6,3,5,21,11,7,10,30,16,11,14,43,23,13,20,"{'F': 5, 'P': 4}","{'C': 7, 'J': 5, 'Z': 5}","{'Q': 8, 'R': 5, 'S': 3, 'T': 3, 'H': 5, 'M': 3}","{'Y': 3, 'A': 3, 'B': 1, 'D': 1, 'E': 1, 'G': 3, 'I': 1, 'K': 3, 'L': 1, 'N': 1, 'O': 1, 'U': 3, 'V': 1, 'W': 1, 'X': 1}"
INV-ZZ-5287234,SCH-ZZ-2098565,ZZ,ZZ20240526IDRHYD2792.0,2792.0,BAe 146,05/26/2024,2024-05-26 12:22:00,2024-05-26 14:12:00,IDR,HYD,91.0,100,51,-40,49,9,18,27,36,10,5,4,5,20,10,8,10,30,15,12,15,42,21,15,21,"{'F': 5, 'P': 4}","{'C': 7, 'J': 5, 'Z': 5}","{'Q': 8, 'R': 5, 'S': 3, 'T': 3, 'H': 5, 'M': 3}","{'Y': 3, 'A': 3, 'B': 1, 'D': 1, 'E': 1, 'G': 3, 'I': 1, 'K': 3, 'L': 1, 'N': 1, 'O': 1, 'U': 3, 'V': 1, 'W': 1, 'X': 1}"
INV-ZZ-5825213,SCH-ZZ-2098565,ZZ,ZZ20240531IDRHYD2792.0,2792.0,BAe 146,05/31/2024,2024-05-31 12:22:00,2024-05-31 14:12:00,IDR,HYD,91.0,102,46,-45,56,9,18,27,36,10,4,5,6,21,9,9,12,30,13,14,17,43,19,17,24,"{'F': 5, 'P': 4}","{'C': 7, 'J': 5, 'Z': 5}","{'Q': 8, 'R': 5, 'S': 3, 'T': 3, 'H': 5, 'M': 3}","{'Y': 3, 'A': 3, 'B': 1, 'D': 1, 'E': 1, 'G': 3, 'I': 1, 'K': 3, 'L': 1, 'N': 1, 'O': 1, 'U': 3, 'V': 1, 'W': 1, 'X': 1}"
INV-ZZ-1357936,SCH-ZZ-2098565,ZZ,ZZ20240602IDRHYD2792.0,2792.0,BAe 146,06/02/2024,2024-06-02 12:22:00,2024-06-02 14:12:00,IDR,HYD,91.0,105,48,-43,57,9,18,27,36,10,5,4,5,21,10,8,11,32,15,12,17,43,20,16,23,"{'F': 5, 'P': 4}","{'C': 7, 'J': 5, 'Z': 5}","{'Q': 8, 'R': 5, 'S': 3, 'T': 3, 'H': 5, 'M': 3}","{'Y': 3, 'A': 3, 'B': 1, 'D': 1, 'E': 1, 'G': 3, 'I': 1, 'K': 3, 'L': 1, 'N': 1, 'O': 1, 'U': 3, 'V': 1, 'W': 1, 'X': 1}"
INV-ZZ-5638757,SCH-ZZ-2098565,ZZ,ZZ20240607IDRHYD2792.0,2792.0,BAe 146,06/07/2024,2024-06-07 12:22:00,2024-06-07 14:12:00,IDR,HYD,91.0,108,47,-44,61,9,18,27,36,11,5,4,6,21,9,9,12,32,14,13,18,41,18,18,23,"{'F': 5, 'P': 4}","{'C': 7, 'J': 5, 'Z': 5}","{'Q': 8, 'R': 5, 'S': 3, 'T': 3, 'H': 5, 'M': 3}","{'Y': 3, 'A': 3, 'B': 1, 'D': 1, 'E': 1, 'G': 3, 'I': 1, 'K': 3, 'L': 1, 'N': 1, 'O': 1, 'U': 3, 'V': 1, 'W': 1, 'X': 1}"
INV-ZZ-8871420,SCH-ZZ-2098565,ZZ,ZZ20240609IDRHYD2792.0,2792.0,BAe 146,06/09/2024,2024-06-09 12:22:00,2024-06-09 14:12:00,IDR,HYD,91.0,100,45,-46,55,9,18,27,36,11,5,4,6,21,10,8,11,32,15,12,17,41,19,17,22,"{'F': 5, 'P': 4}","{'C': 7, 'J': 5, 'Z': 5}","{'Q': 8, 'R': 5, 'S': 3, 'T': 3, 'H': 5, 'M': 3}","{'Y': 3, 'A': 3, 'B': 1, 'D': 1, 'E': 1, 'G': 3, 'I': 1, 'K': 3, 'L': 1, 'N': 1, 'O': 1, 'U': 3, 'V': 1, 'W': 1, 'X': 1}"
INV-ZZ-9163644,SCH-ZZ-2098565,ZZ,ZZ20240614IDRHYD2792.0,2792.0,BAe 146,06/14/2024,2024-06-14 12:22:00,2024-06-14 14:12:00,IDR,HYD,91.0,108,52,-39,56,9,18,27,36,10,5,4,5,20,10,8,10,32,15,12,17,40,19,17,21,"{'F': 5, 'P': 4}","{'C': 7, 'J': 5, 'Z': 5}","{'Q': 8, 'R': 5, 'S': 3, 'T': 3, 'H': 5, 'M': 3}","{'Y': 3, 'A': 3, 'B': 1, 'D': 1, 'E': 1, 'G': 3, 'I': 1, 'K': 3, 'L': 1, 'N': 1, 'O': 1, 'U': 3, 'V': 1, 'W': 1, 'X': 1}"
INV-ZZ-8213769,SCH-ZZ-2098565,ZZ,ZZ20240616IDRHYD2792.0,2792.0,BAe 146,06/16/2024,2024-06-16 12:22:00,2024-06-16 14:12:00,IDR,HYD,91.0,108,50,-41,58,9,18,27,36,10,5,4,5,21,10,8,11,30,14,13,16,42,20,16,22,"{'F': 5, 'P': 4}","{'C': 7, 'J': 5, 'Z': 5}","{'Q': 8, 'R': 5, 'S': 3, 'T': 3, 'H': 5, 'M': 3}","{'Y': 3, 'A': 3, 'B': 1, 'D': 1, 'E': 1, 'G': 3, 'I': 1, 'K': 3, 'L': 1, 'N': 1, 'O': 1, 'U': 3, 'V': 1, 'W': 1, 'X': 1}"
INV-ZZ-2717485,SCH-ZZ-2098565,ZZ,ZZ20240621IDRHYD2792.0,2792.0,BAe 146,06/21/2024,2024-06-21 12:22:00,2024-06-21 14:12:00,IDR,HYD,91.0,101,46,-45,55,9,18,27,36,10,5,4,5,21,10,8,11,32,15,12,17,43,20,16,23,"{'F': 5, 'P': 4}","{'C': 7, 'J': 5, 'Z': 5}","{'Q': 8, 'R': 5, 'S': 3, 'T': 3, 'H': 5, 'M': 3}","{'Y': 3, 'A': 3, 'B': 1, 'D': 1, 'E': 1, 'G': 3, 'I': 1, 'K': 3, 'L': 1, 'N': 1, 'O': 1, 'U': 3, 'V': 1, 'W': 1, 'X': 1}"
INV-ZZ-9789988,SCH-ZZ-2098565,ZZ,ZZ20240623IDRHYD2792.0,2792.0,BAe 146,06/23/2024,2024-06-23 12:22:00,2024-06-23 14:12:00,IDR,HYD,91.0,101,43,-48,58,9,18,27,36,10,4,5,6,21,9,9,12,30,13,14,17,41,18,18,23,"{'F': 5, 'P': 4}","{'C': 7, 'J': 5, 'Z': 5}","{'Q': 8, 'R': 5, 'S': 3, 'T': 3, 'H': 5, 'M': 3}","{'Y': 3, 'A': 3, 'B': 1, 'D': 1, 'E': 1, 'G': 3, 'I': 1, 'K': 3, 'L': 1, 'N': 1, 'O': 1, 'U': 3, 'V': 1, 'W': 1, 'X': 1}"
INV-ZZ-3646937,SCH-ZZ-5381276,ZZ,ZZ20240421JAIDEL3278.0,3278.0,Boeing 757,04/21/2024,2024-04-21 06:41:00,2024-04-22 02:14:00,JAI,DEL,209.0,239,149,-60,90,20,41,62,83,23,14,6,9,46,29,12,17,74,46,16,28,92,57,26,35,"{'F': 12, 'P': 8}","{'C': 16, 'J': 12, 'Z': 12}","{'Q': 19, 'R': 12, 'S': 6, 'T': 6, 'H': 12, 'M': 6}","{'Y': 6, 'A': 6, 'B': 3, 'D': 3, 'E': 3, 'G': 6, 'I': 3, 'K': 6, 'L': 3, 'N': 3, 'O': 3, 'U': 6, 'V': 3, 'W': 3, 'X': 3}"
INV-ZZ-9379786,SCH-ZZ-5381276,ZZ,ZZ20240422JAIDEL3278.0,3278.0,Boeing 757,04/22/2024,2024-04-22 06:41:00,2024-04-23 02:14:00,JAI,DEL,209.0,233,127,-82,106,20,41,62,83,24,13,7,11,47,26,15,21,74,40,22,34,92,50,33,42,"{'F': 12, 'P': 8}","{'C': 16, 'J': 12, 'Z': 12}","{'Q': 19, 'R': 12, 'S': 6, 'T': 6, 'H': 12, 'M': 6}","{'Y': 6, 'A': 6, 'B': 3, 'D': 3, 'E': 3, 'G': 6, 'I': 3, 'K': 6, 'L': 3, 'N': 3, 'O': 3, 'U': 6, 'V': 3, 'W': 3, 'X': 3}"
INV-ZZ-7958612,SCH-ZZ-5381276,ZZ,ZZ20240423JAIDEL3278.0,3278.0,Boeing 757,04/23/2024,2024-04-23 06:41:00,2024-04-24 02:14:00,JAI,DEL,209.0,242,138,-71,104,20,41,62,83,24,14,6,10,49,28,13,21,68,39,23,29,91,52,31,39,"{'F': 12, 'P': 8}","{'C': 16, 'J': 12, 'Z': 12}","{'Q': 19, 'R': 12, 'S': 6, 'T': 6, 'H': 12, 'M': 6}","{'Y': 6, 'A': 6, 'B': 3, 'D': 3, 'E': 3, 'G': 6, 'I': 3, 'K': 6, 'L': 3, 'N': 3, 'O': 3, 'U': 6, 'V': 3, 'W': 3, 'X': 3}"
INV-ZZ-8003912,SCH-ZZ-5381276,ZZ,ZZ20240424JAIDEL3278.0,3278.0,Boeing 757,04/24/2024,2024-04-24 06:41:00,2024-04-25 02:14:00,JAI,DEL,209.0,239,136,-73,103,20,41,62,83,24,14,6,10,46,26,15,20,74,42,20,32,93,53,30,40,"{'F': 12, 'P': 8}","{'C': 16, 'J': 12, 'Z': 12}","{'Q': 19, 'R': 12, 'S': 6, 'T': 6, 'H': 12, 'M': 6}","{'Y': 6, 'A': 6, 'B': 3, 'D': 3, 'E': 3, 'G': 6, 'I': 3, 'K': 6, 'L': 3, 'N': 3, 'O': 3, 'U': 6, 'V': 3, 'W': 3, 'X': 3}"
INV-ZZ-2203206,SCH-ZZ-5381276,ZZ,ZZ20240426JAIDEL3278.0,3278.0,Boeing 757,04/26/2024,2024-04-26 06:41:00,2024-04-27 02:14:00,JAI,DEL,209.0,234,125,-84,109,20,41,62,83,23,12,8,11,48,26,15,22,73,39,23,34,92,49,34,43,"{'F': 12, 'P': 8}","{'C': 16, 'J': 12, 'Z': 12}","{'Q': 19, 'R': 12, 'S': 6, 'T': 6, 'H': 12, 'M': 6}","{'Y': 6, 'A': 6, 'B': 3, 'D': 3, 'E': 3, 'G': 6, 'I': 3, 'K': 6, 'L': 3, 'N': 3, 'O': 3, 'U': 6, 'V': 3, 'W': 3, 'X': 3}"
INV-ZZ-1158151,SCH-ZZ-5381276,ZZ,ZZ20240428JAIDEL3278.0,3278.0,Boeing 757,04/28/2024,2024-04-28 06:41:00,2024-04-29 02:14:00,JAI,DEL,209.0,237,134,-75,103,20,41,62,83,23,13,7,10,45,25,16,20,72,41,21,31,95,54,29,41,"{'F': 12, 'P': 8}","{'C': 16, 'J': 12, 'Z': 12}","{'Q': 19, 'R': 12, 'S': 6, 'T': 6, 'H': 12, 'M': 6}","{'Y': 6, 'A': 6, 'B': 3, 'D': 3, 'E': 3, 'G': 6, 'I': 3, 'K': 6, 'L': 3, 'N': 3, 'O': 3, 'U': 6, 'V': 3, 'W': 3, 'X': 3}"
INV-ZZ-3956858,SCH-ZZ-5381276,ZZ,ZZ20240429JAIDEL3278.0,3278.0,Boeing 757,04/29/2024,2024-04-29 06:41:00,2024-04-30 02:14:00,JAI,DEL,209.0,233,135,-74,98,20,41,62,83,24,14,6,10,49,28,13,21,72,42,20,30,100,58,25,42,"{'F': 12, 'P': 8}","{'C': 16, 'J': 12, 'Z': 12}","{'Q': 19, 'R': 12, 'S': 6, 'T': 6, 'H': 12, 'M': 6}","{'Y': 6, 'A': 6, 'B': 3, 'D': 3, 'E': 3, 'G': 6, 'I': 3, 'K': 6, 'L': 3, 'N': 3, 'O': 3, 'U': 6, 'V': 3, 'W': 3, 'X': 3}"
INV-ZZ-3992506,SCH-ZZ-5381276,ZZ,ZZ20240430JAIDEL3278.0,3278.0,Boeing 757,04/30/2024,2024-04-30 06:41:00,2024-05-01 02:14:00,JAI,DEL,209.0,240,125,-84,115,20,41,62,83,24,13,7,11,46,24,17,22,70,37,25,33,91,48,35,43,"{'F': 12, 'P': 8}","{'C': 16, 'J': 12, 'Z': 12}","{'Q': 19, 'R': 12, 'S': 6, 'T': 6, 'H': 12, 'M': 6}","{'Y': 6, 'A': 6, 'B': 3, 'D': 3, 'E': 3, 'G': 6, 'I': 3, 'K': 6, 'L': 3, 'N': 3, 'O': 3, 'U': 6, 'V': 3, 'W': 3, 'X': 3}"
INV-ZZ-7636333,SCH-ZZ-5381276,ZZ,ZZ20240501JAIDEL3278.0,3278.0,Boeing 757,05/01/2024,2024-05-01 06:41:00,2024-05-02 02:14:00,JAI,DEL,209.0,243,143,-66,100,20,41,62,83,22,13,7,9,46,27,14,19,72,42,20,30,94,55,28,39,"{'F': 12, 'P': 8}","{'C': 16, 'J': 12, 'Z': 12}","{'Q': 19, 'R': 12, 'S': 6, 'T': 6, 'H': 12, 'M': 6}","{'Y': 6, 'A': 6, 'B': 3, 'D': 3, 'E': 3, 'G': 6, 'I': 3, 'K': 6, 'L': 3, 'N': 3, 'O': 3, 'U': 6, 'V': 3, 'W': 3, 'X': 3}"
INV-ZZ-8996828,SCH-ZZ-5381276,ZZ,ZZ20240503JAIDEL3278.0,3278.0,Boeing 757,05/03/2024,2024-05-03 06:41:00,2024-05-04 02:14:00,JAI,DEL,209.0,242,142,-67,100,20,41,62,83,24,14,6,10,46,27,14,19,69,41,21,28,92,54,29,38,"{'F': 12, 'P': 8}","{'C': 16, 'J': 12, 'Z': 12}","{'Q': 19, 'R': 12, 'S': 6, 'T': 6, 'H': 12, 'M': 6}","{'Y': 6, 'A': 6, 'B': 3, 'D': 3, 'E': 3, 'G': 6, 'I': 3, 'K': 6, 'L': 3, 'N': 3, 'O': 3, 'U': 6, 'V': 3, 'W': 3, 'X': 3}"
INV-ZZ-2840984,SCH-ZZ-5381276,ZZ,ZZ20240505JAIDEL3278.0,3278.0,Boeing 757,05/05/2024,2024-05-05 06:41:00,2024-05-06 02:14:00,JAI,DEL,209.0,234,132,-77,102,20,41,62,83,24,14,6,10,49,28,13,21,70,39,23,31,92,52,31,40,"{'F': 12, 'P': 8}","{'C': 16, 'J': 12, 'Z': 12}","{'Q': 19, 'R': 12, 'S': 6, 'T': 6, 'H': 12, 'M': 6}","{'Y': 6, 'A': 6, 'B': 3, 'D': 3, 'E': 3, 'G': 6, 'I': 3, 'K': 6, 'L': 3, 'N': 3, 'O': 3, 'U': 6, 'V': 3, 'W': 3, 'X': 3}"
INV-ZZ-3420298,SCH-ZZ-5381276,ZZ,ZZ20240506JAIDEL3278.0,3278.0,Boeing 757,05/06/2024,2024-05-06 06:41:00,2024-05-07 02:14:00,JAI,DEL,209.0,238,121,-88,117,20,41,62,83,24,12,8,12,48,24,17,24,74,38,24,36,93,47,36,46,"{'F': 12, 'P': 8}","{'C': 16, 'J': 12, 'Z': 12}","{'Q': 19, 'R': 12, 'S': 6, 'T': 6, 'H': 12, 'M': 6}","{'Y': 6, 'A': 6, 'B': 3, 'D': 3, 'E': 3, 'G': 6, 'I': 3, 'K': 6, 'L': 3, 'N': 3, 'O': 3, 'U': 6, 'V': 3, 'W': 3, 'X': 3}"
INV-ZZ-6963110,SCH-ZZ-5381276,ZZ,ZZ20240507JAIDEL3278.0,3278.0,Boeing 757,05/07/2024,2024-05-07 06:41:00,2024-05-08 02:14:00,JAI,DEL,209.0,235,119,-90,116,20,41,62,83,23,12,8,11,48,24,17,24,73,37,25,36,96,49,34,47,"{'F': 12, 'P': 8}","{'C': 16, 'J': 12, 'Z': 12}","{'Q': 19, 'R': 12, 'S': 6, 'T': 6, 'H': 12, 'M': 6}","{'Y': 6, 'A': 6, 'B': 3, 'D': 3, 'E': 3, 'G': 6, 'I': 3, 'K': 6, 'L': 3, 'N': 3, 'O': 3, 'U': 6, 'V': 3, 'W': 3, 'X': 3}"
INV-ZZ-7900172,SCH-ZZ-5381276,ZZ,ZZ20240508JAIDEL3278.0,3278.0,Boeing 757,05/08/2024,2024-05-08 06:41:00,2024-05-09 02:14:00,JAI,DEL,209.0,243,137,-72,106,20,41,62,83,22,12,8,10,46,26,15,20,72,41,21,31,94,53,30,41,"{'F': 12, 'P': 8}","{'C': 16, 'J': 12, 'Z': 12}","{'Q': 19, 'R': 12, 'S': 6, 'T': 6, 'H': 12, 'M': 6}","{'Y': 6, 'A': 6, 'B': 3, 'D': 3, 'E': 3, 'G': 6, 'I': 3, 'K': 6, 'L': 3, 'N': 3, 'O': 3, 'U': 6, 'V': 3, 'W': 3, 'X': 3}"
INV-ZZ-6988762,SCH-ZZ-5381276,ZZ,ZZ20240510JAIDEL3278.0,3278.0,Boeing 757,05/10/2024,2024-05-10 06:41:00,2024-05-11 02:14:00,JAI,DEL,209.0,248,124,-85,124,20,41,62,83,22,11,9,11,49,25,16,24,68,34,28,34,93,47,36,46,"{'F': 12, 'P': 8}","{'C': 16, 'J': 12, 'Z': 12}","{'Q': 19, 'R': 12, 'S': 6, 'T': 6, 'H': 12, 'M': 6}","{'Y': 6, 'A': 6, 'B': 3, 'D': 3, 'E': 3, 'G': 6, 'I': 3, 'K': 6, 'L': 3, 'N': 3, 'O': 3, 'U': 6, 'V': 3, 'W': 3, 'X': 3}"
INV-ZZ-4129385,SCH-ZZ-5381276,ZZ,ZZ20240512JAIDEL3278.0,3278.0,Boeing 757,05/12/2024,2024-05-12 06:41:00,2024-05-13 02:14:00,JAI,DEL,209.0,236,126,-83,110,20,41,62,83,23,12,8,11,47,25,16,22,71,38,24,33,94,50,33,44,"{'F': 12, 'P': 8}","{'C': 16, 'J': 12, 'Z': 12}","{'Q': 19, 'R': 12, 'S': 6, 'T': 6, 'H': 12, 'M': 6}","{'Y': 6, 'A': 6, 'B': 3, 'D': 3, 'E': 3, 'G': 6, 'I': 3, 'K': 6, 'L': 3, 'N': 3, 'O': 3, 'U': 6, 'V': 3, 'W': 3, 'X': 3}"
INV-ZZ-9370542,SCH-ZZ-5381276,ZZ,ZZ20240513JAIDEL3278.0,3278.0,Boeing 757,05/13/2024,2024-05-13 06:41:00,2024-05-14 02:14:00,JAI,DEL,209.0,239,116,-93,123,20,41,62,83,22,11,9,11,49,24,17,25,71,35,27,36,94,46,37,48,"{'F': 12, 'P': 8}","{'C': 16, 'J': 12, 'Z': 12}","{'Q': 19, 'R': 12, 'S': 6, 'T': 6, 'H': 12, 'M': 6}","{'Y': 6, 'A': 6, 'B': 3, 'D': 3, 'E': 3, 'G': 6, 'I': 3, 'K': 6, 'L': 3, 'N': 3, 'O': 3, 'U': 6, 'V': 3, 'W': 3, 'X': 3}"
INV-ZZ-8173952,SCH-ZZ-5381276,ZZ,ZZ20240514JAIDEL3278.0,3278.0,Boeing 757,05/14/2024,2024-05-14 06:41:00,2024-05-15 02:14:00,JAI,DEL,209.0,236,125,-84,111,20,41,62,83,22,12,8,10,46,24,17,22,71,38,24,33,94,50,33,44,"{'F': 12, 'P': 8}","{'C': 16, 'J': 12, 'Z': 12}","{'Q': 19, 'R': 12, 'S': 6, 'T': 6, 'H': 12, 'M': 6}","{'Y': 6, 'A': 6, 'B': 3, 'D': 3, 'E': 3, 'G': 6, 'I': 3, 'K': 6, 'L': 3, 'N': 3, 'O': 3, 'U': 6, 'V': 3, 'W': 3, 'X': 3}"
INV-ZZ-7107158,SCH-ZZ-5381276,ZZ,ZZ20240515JAIDEL3278.0,3278.0,Boeing 757,05/15/2024,2024-05-15 06:41:00,2024-05-16 02:14:00,JAI,DEL,209.0,236,122,-87,114,20,41,62,83,23,12,8,11,47,24,17,23,69,36,26,33,93,48,35,45,"{'F': 12, 'P': 8}","{'C': 16, 'J': 12, 'Z': 12}","{'Q': 19, 'R': 12, 'S': 6, 'T': 6, 'H': 12, 'M': 6}","{'Y': 6, 'A': 6, 'B': 3, 'D': 3, 'E': 3, 'G': 6, 'I': 3, 'K': 6, 'L': 3, 'N': 3, 'O': 3, 'U': 6, 'V': 3, 'W': 3, 'X': 3}"
INV-ZZ-6258471,SCH-ZZ-5381276,ZZ,ZZ20240517JAIDEL3278.0,3278.0,Boeing 757,05/17/2024,2024-05-17 06:41:00,2024-05-18 02:14:00,JAI,DEL,209.0,238,119,-90,119,20,41,62,83,23,11,9,12,47,23,18,24,71,35,27,36,98,49,34,49,"{'F': 12, 'P': 8}","{'C': 16, 'J': 12, 'Z': 12}","{'Q': 19, 'R': 12, 'S': 6, 'T': 6, 'H': 12, 'M': 6}","{'Y': 6, 'A': 6, 'B': 3, 'D': 3, 'E': 3, 'G': 6, 'I': 3, 'K': 6, 'L': 3, 'N': 3, 'O': 3, 'U': 6, 'V': 3, 'W': 3, 'X': 3}"
INV-ZZ-4113685,SCH-ZZ-5381276,ZZ,ZZ20240519JAIDEL3278.0,3278.0,Boeing 757,05/19/2024,2024-05-19 06:41:00,2024-05-20 02:14:00,JAI,DEL,209.0,230,113,-96,117,20,41,62,83,23,11,9,12,48,24,17,24,70,35,27,35,93,46,37,47,"{'F': 12, 'P': 8}","{'C': 16, 'J': 12, 'Z': 12}","{'Q': 19, 'R': 12, 'S': 6, 'T': 6, 'H': 12, 'M': 6}","{'Y': 6, 'A': 6, 'B': 3, 'D': 3, 'E': 3, 'G': 6, 'I': 3, 'K': 6, 'L': 3, 'N': 3, 'O': 3, 'U': 6, 'V': 3, 'W': 3, 'X': 3}"
INV-ZZ-7008049,SCH-ZZ-5381276,ZZ,ZZ20240520JAIDEL3278.0,3278.0,Boeing 757,05/20/2024,2024-05-20 06:41:00,2024-05-21 02:14:00,JAI,DEL,209.0,249,133,-76,116,20,41,62,83,22,12,8,10,49,26,15,23,73,39,23,34,91,49,34,42,"{'F': 12, 'P': 8}","{'C': 16, 'J': 12, 'Z': 12}","{'Q': 19, 'R': 12, 'S': 6, 'T': 6, 'H': 12, 'M': 6}","{'Y': 6, 'A': 6, 'B': 3, 'D': 3, 'E': 3, 'G': 6, 'I': 3, 'K': 6, 'L': 3, 'N': 3, 'O': 3, 'U': 6, 'V': 3, 'W': 3, 'X': 3}"
INV-ZZ-9667447,SCH-ZZ-5381276,ZZ,ZZ20240521JAIDEL3278.0,3278.0,Boeing 757,05/21/2024,2024-05-21 06:41:00,2024-05-22 02:14:00,JAI,DEL,209.0,239,121,-88,118,20,41,62,83,23,12,8,11,48,24,17,24,72,36,26,36,95,48,35,47,"{'F': 12, 'P': 8}","{'C': 16, 'J': 12, 'Z': 12}","{'Q': 19, 'R': 12, 'S': 6, 'T': 6, 'H': 12, 'M': 6}","{'Y': 6, 'A': 6, 'B': 3, 'D': 3, 'E': 3, 'G': 6, 'I': 3, 'K': 6, 'L': 3, 'N': 3, 'O': 3, 'U': 6, 'V': 3, 'W': 3, 'X': 3}"
INV-ZZ-4068241,SCH-ZZ-5381276,ZZ,ZZ20240522JAIDEL3278.0,3278.0,Boeing 757,05/22/2024,2024-05-22 06:41:00,2024-05-23 02:14:00,JAI,DEL,209.0,240,115,-94,125,20,41,62,83,23,11,9,12,45,22,19,23,71,34,28,37,93,45,38,48,"{'F': 12, 'P': 8}","{'C': 16, 'J': 12, 'Z': 12}","{'Q': 19, 'R': 12, 'S': 6, 'T': 6, 'H': 12, 'M': 6}","{'Y': 6, 'A': 6, 'B': 3, 'D': 3, 'E': 3, 'G': 6, 'I': 3, 'K': 6, 'L': 3, 'N': 3, 'O': 3, 'U': 6, 'V': 3, 'W': 3, 'X': 3}"
INV-ZZ-4815311,SCH-ZZ-5381276,ZZ,ZZ20240524JAIDEL3278.0,3278.0,Boeing 757,05/24/2024,2024-05-24 06:41:00,2024-05-25 02:14:00,JAI,DEL,209.0,238,112,-97,126,20,41,62,83,23,11,9,12,48,23,18,25,69,33,29,36,96,45,38,51,"{'F': 12, 'P': 8}","{'C': 16, 'J': 12, 'Z': 12}","{'Q': 19, 'R': 12, 'S': 6, 'T': 6, 'H': 12, 'M': 6}","{'Y': 6, 'A': 6, 'B': 3, 'D': 3, 'E': 3, 'G': 6, 'I': 3, 'K': 6, 'L': 3, 'N': 3, 'O': 3, 'U': 6, 'V': 3, 'W': 3, 'X': 3}"
INV-ZZ-3184319,SCH-ZZ-5381276,ZZ,ZZ20240526JAIDEL3278.0,3278.0,Boeing 757,05/26/2024,2024-05-26 06:41:00,2024-05-27 02:14:00,JAI,DEL,209.0,230,115,-94,115,20,41,62,83,23,11,9,12,46,23,18,23,71,35,27,36,96,48,35,48,"{'F': 12, 'P': 8}","{'C': 16, 'J': 12, 'Z': 12}","{'Q': 19, 'R': 12, 'S': 6, 'T': 6, 'H': 12, 'M': 6}","{'Y': 6, 'A': 6, 'B': 3, 'D': 3, 'E': 3, 'G': 6, 'I': 3, 'K': 6, 'L': 3, 'N': 3, 'O': 3, 'U': 6, 'V': 3, 'W': 3, 'X': 3}"
INV-ZZ-4336695,SCH-ZZ-5381276,ZZ,ZZ20240527JAIDEL3278.0,3278.0,Boeing 757,05/27/2024,2024-05-27 06:41:00,2024-05-28 02:14:00,JAI,DEL,209.0,246,119,-90,127,20,41,62,83,22,11,9,11,47,23,18,24,71,34,28,37,91,44,39,47,"{'F': 12, 'P': 8}","{'C': 16, 'J': 12, 'Z': 12}","{'Q': 19, 'R': 12, 'S': 6, 'T': 6, 'H': 12, 'M': 6}","{'Y': 6, 'A': 6, 'B': 3, 'D': 3, 'E': 3, 'G': 6, 'I': 3, 'K': 6, 'L': 3, 'N': 3, 'O': 3, 'U': 6, 'V': 3, 'W': 3, 'X': 3}"
INV-ZZ-1134158,SCH-ZZ-5381276,ZZ,ZZ20240528JAIDEL3278.0,3278.0,Boeing 757,05/28/2024,2024-05-28 06:41:00,2024-05-29 02:14:00,JAI,DEL,209.0,238,118,-91,120,20,41,62,83,23,11,9,12,46,23,18,23,72,36,26,36,91,45,38,46,"{'F': 12, 'P': 8}","{'C': 16, 'J': 12, 'Z': 12}","{'Q': 19, 'R': 12, 'S': 6, 'T': 6, 'H': 12, 'M': 6}","{'Y': 6, 'A': 6, 'B': 3, 'D': 3, 'E': 3, 'G': 6, 'I': 3, 'K': 6, 'L': 3, 'N': 3, 'O': 3, 'U': 6, 'V': 3, 'W': 3, 'X': 3}"
INV-ZZ-2502887,SCH-ZZ-5381276,ZZ,ZZ20240529JAIDEL3278.0,3278.0,Boeing 757,05/29/2024,2024-05-29 06:41:00,2024-05-30 02:14:00,JAI,DEL,209.0,244,123,-86,121,20,41,62,83,24,12,8,12,47,24,17,23,72,36,26,36,99,50,33,49,"{'F': 12, 'P': 8}","{'C': 16, 'J': 12, 'Z': 12}","{'Q': 19, 'R': 12, 'S': 6, 'T': 6, 'H': 12, 'M': 6}","{'Y': 6, 'A': 6, 'B': 3, 'D': 3, 'E': 3, 'G': 6, 'I': 3, 'K': 6, 'L': 3, 'N': 3, 'O': 3, 'U': 6, 'V': 3, 'W': 3, 'X': 3}"
INV-ZZ-4501020,SCH-ZZ-5381276,ZZ,ZZ20240531JAIDEL3278.0,3278.0,Boeing 757,05/31/2024,2024-05-31 06:41:00,2024-06-01 02:14:00,JAI,DEL,209.0,243,108,-101,135,20,41,62,83,23,10,10,13,47,21,20,26,72,32,30,40,98,44,39,54,"{'F': 12, 'P': 8}","{'C': 16, 'J': 12, 'Z': 12}","{'Q': 19, 'R': 12, 'S': 6, 'T': 6, 'H': 12, 'M': 6}","{'Y': 6, 'A': 6, 'B': 3, 'D': 3, 'E': 3, 'G': 6, 'I': 3, 'K': 6, 'L': 3, 'N': 3, 'O': 3, 'U': 6, 'V': 3, 'W': 3, 'X': 3}"
INV-ZZ-2590842,SCH-ZZ-5381276,ZZ,ZZ20240602JAIDEL3278.0,3278.0,Boeing 757,06/02/2024,2024-06-02 06:41:00,2024-06-03 02:14:00,JAI,DEL,209.0,238,121,-88,117,20,41,62,83,24,12,8,12,49,25,16,24,72,37,25,35,94,48,35,46,"{'F': 12, 'P': 8}","{'C': 16, 'J': 12, 'Z': 12}","{'Q': 19, 'R': 12, 'S': 6, 'T': 6, 'H': 12, 'M': 6}","{'Y': 6, 'A': 6, 'B': 3, 'D': 3, 'E': 3, 'G': 6, 'I': 3, 'K': 6, 'L': 3, 'N': 3, 'O': 3, 'U': 6, 'V': 3, 'W': 3, 'X': 3}"
INV-ZZ-2790333,SCH-ZZ-5381276,ZZ,ZZ20240603JAIDEL3278.0,3278.0,Boeing 757,06/03/2024,2024-06-03 06:41:00,2024-06-04 02:14:00,JAI,DEL,209.0,247,119,-90,128,20,41,62,83,23,11,9,12,48,23,18,25,72,35,27,37,99,48,35,51,"{'F': 12, 'P': 8}","{'C': 16, 'J': 12, 'Z': 12}","{'Q': 19, 'R': 12, 'S': 6, 'T': 6, 'H': 12, 'M': 6}","{'Y': 6, 'A': 6, 'B': 3, 'D': 3, 'E': 3, 'G': 6, 'I': 3, 'K': 6, 'L': 3, 'N': 3, 'O': 3, 'U': 6, 'V': 3, 'W': 3, 'X': 3}"
INV-ZZ-6515417,SCH-ZZ-5381276,ZZ,ZZ20240604JAIDEL3278.0,3278.0,Boeing 757,06/04/2024,2024-06-04 06:41:00,2024-06-05 02:14:00,JAI,DEL,209.0,239,112,-97,127,20,41,62,83,24,11,9,13,48,22,19,26,71,33,29,38,99,46,37,53,"{'F': 12, 'P': 8}","{'C': 16, 'J': 12, 'Z': 12}","{'Q': 19, 'R': 12, 'S': 6, 'T': 6, 'H': 12, 'M': 6}","{'Y': 6, 'A': 6, 'B': 3, 'D': 3, 'E': 3, 'G': 6, 'I': 3, 'K': 6, 'L': 3, 'N': 3, 'O': 3, 'U': 6, 'V': 3, 'W': 3, 'X': 3}"
INV-ZZ-8187644,SCH-ZZ-3821718,ZZ,ZZ20240501BBIBLR3776.0,3776.0,Boeing 757,05/01/2024,2024-05-01 00:53:00,2024-05-01 01:02:00,BBI,BLR,209.0,239,128,-81,111,20,41,62,83,23,12,8,11,46,25,16,21,74,40,22,34,94,50,33,44,"{'F': 12, 'P': 8}","{'C': 16, 'J': 12, 'Z': 12}","{'Q': 19, 'R': 12, 'S': 6, 'T': 6, 'H': 12, 'M': 6}","{'Y': 6, 'A': 6, 'B': 3, 'D': 3, 'E': 3, 'G': 6, 'I': 3, 'K': 6, 'L': 3, 'N': 3, 'O': 3, 'U': 6, 'V': 3, 'W': 3, 'X': 3}"
INV-ZZ-5942406,SCH-ZZ-3821718,ZZ,ZZ20240503BBIBLR3776.0,3776.0,Boeing 757,05/03/2024,2024-05-03 00:53:00,2024-05-03 01:02:00,BBI,BLR,209.0,234,127,-82,107,20,41,62,83,23,13,7,10,47,26,15,21,70,38,24,32,99,54,29,45,"{'F': 12, 'P': 8}","{'C': 16, 'J': 12, 'Z': 12}","{'Q': 19, 'R': 12, 'S': 6, 'T': 6, 'H': 12, 'M': 6}","{'Y': 6, 'A': 6, 'B': 3, 'D': 3, 'E': 3, 'G': 6, 'I': 3, 'K': 6, 'L': 3, 'N': 3, 'O': 3, 'U': 6, 'V': 3, 'W': 3, 'X': 3}"
INV-ZZ-3588163,SCH-ZZ-3821718,ZZ,ZZ20240506BBIBLR3776.0,3776.0,Boeing 757,05/06/2024,2024-05-06 00:53:00,2024-05-06 01:02:00,BBI,BLR,209.0,245,142,-67,103,20,41,62,83,23,13,7,10,48,28,13,20,70,41,21,29,96,56,27,40,"{'F': 12, 'P': 8}","{'C': 16, 'J': 12, 'Z': 12}","{'Q': 19, 'R': 12, 'S': 6, 'T': 6, 'H': 12, 'M': 6}","{'Y': 6, 'A': 6, 'B': 3, 'D': 3, 'E': 3, 'G': 6, 'I': 3, 'K': 6, 'L': 3, 'N': 3, 'O': 3, 'U': 6, 'V': 3, 'W': 3, 'X': 3}"
INV-ZZ-1250224,SCH-ZZ-3821718,ZZ,ZZ20240508BBIBLR3776.0,3776.0,Boeing 757,05/08/2024,2024-05-08 00:53:00,2024-05-08 01:02:00,BBI,BLR,209.0,248,125,-84,123,20,41,62,83,22,11,9,11,47,24,17,23,71,36,26,35,99,50,33,49,"{'F': 12, 'P': 8}","{'C': 16, 'J': 12, 'Z': 12}","{'Q': 19, 'R': 12, 'S': 6, 'T': 6, 'H': 12, 'M': 6}","{'Y': 6, 'A': 6, 'B': 3, 'D': 3, 'E': 3, 'G': 6, 'I': 3, 'K': 6, 'L': 3, 'N': 3, 'O': 3, 'U': 6, 'V': 3, 'W': 3, 'X': 3}"
INV-ZZ-2853191,SCH-ZZ-3821718,ZZ,ZZ20240510BBIBLR3776.0,3776.0,Boeing 757,05/10/2024,2024-05-10 00:53:00,2024-05-10 01:02:00,BBI,BLR,209.0,239,118,-91,121,20,41,62,83,23,11,9,12,46,23,18,23,74,36,26,38,99,49,34,50,"{'F': 12, 'P': 8}","{'C': 16, 'J': 12, 'Z': 12}","{'Q': 19, 'R': 12, 'S': 6, 'T': 6, 'H': 12, 'M': 6}","{'Y': 6, 'A': 6, 'B': 3, 'D': 3, 'E': 3, 'G': 6, 'I': 3, 'K': 6, 'L': 3, 'N': 3, 'O': 3, 'U': 6, 'V': 3, 'W': 3, 'X': 3}"
INV-ZZ-8110186,SCH-ZZ-3821718,ZZ,ZZ20240513BBIBLR3776.0,3776.0,Boeing 757,05/13/2024,2024-05-13 00:53:00,2024-05-13 01:02:00,BBI,BLR,209.0,243,130,-79,113,20,41,62,83,24,13,7,11,47,25,16,22,71,38,24,33,91,49,34,42,"{'F': 12, 'P': 8}","{'C': 16, 'J': 12, 'Z': 12}","{'Q': 19, 'R': 12, 'S': 6, 'T': 6, 'H': 12, 'M': 6}","{'Y': 6, 'A': 6, 'B': 3, 'D': 3, 'E': 3, 'G': 6, 'I': 3, 'K': 6, 'L': 3, 'N': 3, 'O': 3, 'U': 6, 'V': 3, 'W': 3, 'X': 3}"
INV-ZZ-7765650,SCH-ZZ-3821718,ZZ,ZZ20240515BBIBLR3776.0,3776.0,Boeing 757,05/15/2024,2024-05-15 00:53:00,2024-05-15 01:02:00,BBI,BLR,209.0,240,117,-92,123,20,41,62,83,22,11,9,11,46,22,19,24,68,33,29,35,95,46,37,49,"{'F': 12, 'P': 8}","{'C': 16, 'J': 12, 'Z': 12}","{'Q': 19, 'R': 12, 'S': 6, 'T': 6, 'H': 12, 'M': 6}","{'Y': 6, 'A': 6, 'B': 3, 'D': 3, 'E': 3, 'G': 6, 'I': 3, 'K': 6, 'L': 3, 'N': 3, 'O': 3, 'U': 6, 'V': 3, 'W': 3, 'X': 3}"
INV-ZZ-9511631,SCH-ZZ-3821718,ZZ,ZZ20240517BBIBLR3776.0,3776.0,Boeing 757,05/17/2024,2024-05-17 00:53:00,2024-05-17 01:02:00,BBI,BLR,209.0,247,131,-78,116,20,41,62,83,24,13,7,11,46,24,17,22,74,39,23,35,93,49,34,44,"{'F': 12, 'P': 8}","{'C': 16, 'J': 12, 'Z': 12}","{'Q': 19, 'R': 12, 'S': 6, 'T': 6, 'H': 12, 'M': 6}","{'Y': 6, 'A': 6, 'B': 3, 'D': 3, 'E': 3, 'G': 6, 'I': 3, 'K': 6, 'L': 3, 'N': 3, 'O': 3, 'U': 6, 'V': 3, 'W': 3, 'X': 3}"
INV-ZZ-8395249,SCH-ZZ-3821718,ZZ,ZZ20240520BBIBLR3776.0,3776.0,Boeing 757,05/20/2024,2024-05-20 00:53:00,2024-05-20 01:02:00,BBI,BLR,209.0,239,117,-92,122,20,41,62,83,24,12,8,12,45,22,19,23,69,34,28,35,97,48,35,49,"{'F': 12, 'P': 8}","{'C': 16, 'J': 12, 'Z': 12}","{'Q': 19, 'R': 12, 'S': 6, 'T': 6, 'H': 12, 'M': 6}","{'Y': 6, 'A': 6, 'B': 3, 'D': 3, 'E': 3, 'G': 6, 'I': 3, 'K': 6, 'L': 3, 'N': 3, 'O': 3, 'U': 6, 'V': 3, 'W': 3, 'X': 3}"
INV-ZZ-9711495,SCH-ZZ-3821718,ZZ,ZZ20240522BBIBLR3776.0,3776.0,Boeing 757,05/22/2024,2024-05-22 00:53:00,2024-05-22 01:02:00,BBI,BLR,209.0,230,110,-99,120,20,41,62,83,24,12,8,12,46,22,19,24,72,35,27,37,94,45,38,49,"{'F': 12, 'P': 8}","{'C': 16, 'J': 12, 'Z': 12}","{'Q': 19, 'R': 12, 'S': 6, 'T': 6, 'H': 12, 'M': 6}","{'Y': 6, 'A': 6, 'B': 3, 'D': 3, 'E': 3, 'G': 6, 'I': 3, 'K': 6, 'L': 3, 'N': 3, 'O': 3, 'U': 6, 'V': 3, 'W': 3, 'X': 3}"
INV-ZZ-3928801,SCH-ZZ-3821718,ZZ,ZZ20240524BBIBLR3776.0,3776.0,Boeing 757,05/24/2024,2024-05-24 00:53:00,2024-05-24 01:02:00,BBI,BLR,209.0,245,120,-89,125,20,41,62,83,24,12,8,12,48,23,18,25,74,36,26,38,98,48,35,50,"{'F': 12, 'P': 8}","{'C': 16, 'J': 12, 'Z': 12}","{'Q': 19, 'R': 12, 'S': 6, 'T': 6, 'H': 12, 'M': 6}","{'Y': 6, 'A': 6, 'B': 3, 'D': 3, 'E': 3, 'G': 6, 'I': 3, 'K': 6, 'L': 3, 'N': 3, 'O': 3, 'U': 6, 'V': 3, 'W': 3, 'X': 3}"
INV-ZZ-1686166,SCH-ZZ-3821718,ZZ,ZZ20240527BBIBLR3776.0,3776.0,Boeing 757,05/27/2024,2024-05-27 00:53:00,2024-05-27 01:02:00,BBI,BLR,209.0,237,112,-97,125,20,41,62,83,23,11,9,12,48,23,18,25,70,33,29,37,92,43,40,49,"{'F': 12, 'P': 8}","{'C': 16, 'J': 12, 'Z': 12}","{'Q': 19, 'R': 12, 'S': 6, 'T': 6, 'H': 12, 'M': 6}","{'Y': 6, 'A': 6, 'B': 3, 'D': 3, 'E': 3, 'G': 6, 'I': 3, 'K': 6, 'L': 3, 'N': 3, 'O': 3, 'U': 6, 'V': 3, 'W': 3, 'X': 3}"
INV-ZZ-8536808,SCH-ZZ-3821718,ZZ,ZZ20240529BBIBLR3776.0,3776.0,Boeing 757,05/29/2024,2024-05-29 00:53:00,2024-05-29 01:02:00,BBI,BLR,209.0,234,116,-93,118,20,41,62,83,23,11,9,12,49,24,17,25,74,37,25,37,97,48,35,49,"{'F': 12, 'P': 8}","{'C': 16, 'J': 12, 'Z': 12}","{'Q': 19, 'R': 12, 'S': 6, 'T': 6, 'H': 12, 'M': 6}","{'Y': 6, 'A': 6, 'B': 3, 'D': 3, 'E': 3, 'G': 6, 'I': 3, 'K': 6, 'L': 3, 'N': 3, 'O': 3, 'U': 6, 'V': 3, 'W': 3, 'X': 3}"
INV-ZZ-7905050,SCH-ZZ-3821718,ZZ,ZZ20240531BBIBLR3776.0,3776.0,Boeing 757,05/31/2024,2024-05-31 00:53:00,2024-05-31 01:02:00,BBI,BLR,209.0,231,103,-106,128,20,41,62,83,24,11,9,13,45,20,21,25,72,32,30,40,96,43,40,53,"{'F': 12, 'P': 8}","{'C': 16, 'J': 12, 'Z': 12}","{'Q': 19, 'R': 12, 'S': 6, 'T': 6, 'H': 12, 'M': 6}","{'Y': 6, 'A': 6, 'B': 3, 'D': 3, 'E': 3, 'G': 6, 'I': 3, 'K': 6, 'L': 3, 'N': 3, 'O': 3, 'U': 6, 'V': 3, 'W': 3, 'X': 3}"
INV-ZZ-8410309,SCH-ZZ-3821718,ZZ,ZZ20240603BBIBLR3776.0,3776.0,Boeing 757,06/03/2024,2024-06-03 00:53:00,2024-06-03 01:02:00,BBI,BLR,209.0,233,107,-102,126,20,41,62,83,23,11,9,12,46,21,20,25,73,34,28,39,98,45,38,53,"{'F': 12, 'P': 8}","{'C': 16, 'J': 12, 'Z': 12}","{'Q': 19, 'R': 12, 'S': 6, 'T': 6, 'H': 12, 'M': 6}","{'Y': 6, 'A': 6, 'B': 3, 'D': 3, 'E': 3, 'G': 6, 'I': 3, 'K': 6, 'L': 3, 'N': 3, 'O': 3, 'U': 6, 'V': 3, 'W': 3, 'X': 3}"
INV-ZZ-3592413,SCH-ZZ-3821718,ZZ,ZZ20240605BBIBLR3776.0,3776.0,Boeing 757,06/05/2024,2024-06-05 00:53:00,2024-06-05 01:02:00,BBI,BLR,209.0,249,124,-85,125,20,41,62,83,23,11,9,12,47,23,18,24,74,37,25,37,98,49,34,49,"{'F': 12, 'P': 8}","{'C': 16, 'J': 12, 'Z': 12}","{'Q': 19, 'R': 12, 'S': 6, 'T': 6, 'H': 12, 'M': 6}","{'Y': 6, 'A': 6, 'B': 3, 'D': 3, 'E': 3, 'G': 6, 'I': 3, 'K': 6, 'L': 3, 'N': 3, 'O': 3, 'U': 6, 'V': 3, 'W': 3, 'X': 3}"
INV-ZZ-5786200,SCH-ZZ-3821718,ZZ,ZZ20240607BBIBLR3776.0,3776.0,Boeing 757,06/07/2024,2024-06-07 00:53:00,2024-06-07 01:02:00,BBI,BLR,209.0,247,110,-99,137,20,41,62,83,23,10,10,13,45,20,21,25,70,31,31,39,91,40,43,51,"{'F': 12, 'P': 8}","{'C': 16, 'J': 12, 'Z': 12}","{'Q': 19, 'R': 12, 'S': 6, 'T': 6, 'H': 12, 'M': 6}","{'Y': 6, 'A': 6, 'B': 3, 'D': 3, 'E': 3, 'G': 6, 'I': 3, 'K': 6, 'L': 3, 'N': 3, 'O': 3, 'U': 6, 'V': 3, 'W': 3, 'X': 3}"
INV-ZZ-2006336,SCH-ZZ-3821718,ZZ,ZZ20240610BBIBLR3776.0,3776.0,Boeing 757,06/10/2024,2024-06-10 00:53:00,2024-06-10 01:02:00,BBI,BLR,209.0,244,111,-98,133,20,41,62,83,23,10,10,13,46,21,20,25,69,31,31,38,95,43,40,52,"{'F': 12, 'P': 8}","{'C': 16, 'J': 12, 'Z': 12}","{'Q': 19, 'R': 12, 'S': 6, 'T': 6, 'H': 12, 'M': 6}","{'Y': 6, 'A': 6, 'B': 3, 'D': 3, 'E': 3, 'G': 6, 'I': 3, 'K': 6, 'L': 3, 'N': 3, 'O': 3, 'U': 6, 'V': 3, 'W': 3, 'X': 3}"
INV-ZZ-1190716,SCH-ZZ-3821718,ZZ,ZZ20240612BBIBLR3776.0,3776.0,Boeing 757,06/12/2024,2024-06-12 00:53:00,2024-06-12 01:02:00,BBI,BLR,209.0,245,110,-99,135,20,41,62,83,24,11,9,13,48,21,20,27,74,33,29,41,97,43,40,54,"{'F': 12, 'P': 8}","{'C': 16, 'J': 12, 'Z': 12}","{'Q': 19, 'R': 12, 'S': 6, 'T': 6, 'H': 12, 'M': 6}","{'Y': 6, 'A': 6, 'B': 3, 'D': 3, 'E': 3, 'G': 6, 'I': 3, 'K': 6, 'L': 3, 'N': 3, 'O': 3, 'U': 6, 'V': 3, 'W': 3, 'X': 3}"
INV-ZZ-8739499,SCH-ZZ-3821718,ZZ,ZZ20240614BBIBLR3776.0,3776.0,Boeing 757,06/14/2024,2024-06-14 00:53:00,2024-06-14 01:02:00,BBI,BLR,209.0,235,110,-99,125,20,41,62,83,23,11,9,12,45,21,20,24,74,35,27,39,92,43,40,49,"{'F': 12, 'P': 8}","{'C': 16, 'J': 12, 'Z': 12}","{'Q': 19, 'R': 12, 'S': 6, 'T': 6, 'H': 12, 'M': 6}","{'Y': 6, 'A': 6, 'B': 3, 'D': 3, 'E': 3, 'G': 6, 'I': 3, 'K': 6, 'L': 3, 'N': 3, 'O': 3, 'U': 6, 'V': 3, 'W': 3, 'X': 3}"
INV-ZZ-2109580,SCH-ZZ-3820040,ZZ,ZZ20240406MAATRV2047.0,2047.0,Boeing 767,04/06/2024,2024-04-06 07:41:00,2024-04-07 02:50:00,MAA,TRV,278.0,327,189,-89,138,27,55,83,111,32,18,9,14,62,36,19,26,99,57,26,42,132,76,35,56,"{'F': 16, 'P': 11}","{'C': 22, 'J': 16, 'Z': 16}","{'Q': 25, 'R': 17, 'S': 8, 'T': 8, 'H': 17, 'M': 8}","{'Y': 8, 'A': 8, 'B': 4, 'D': 4, 'E': 4, 'G': 8, 'I': 4, 'K': 8, 'L': 4, 'N': 4, 'O': 4, 'U': 8, 'V': 4, 'W': 4, 'X': 4}"
INV-ZZ-6315776,SCH-ZZ-3820040,ZZ,ZZ20240407MAATRV2047.0,2047.0,Boeing 767,04/07/2024,2024-04-07 07:41:00,2024-04-08 02:50:00,MAA,TRV,278.0,308,182,-96,126,27,55,83,111,32,19,8,13,63,37,18,26,95,56,27,39,126,75,36,51,"{'F': 16, 'P': 11}","{'C': 22, 'J': 16, 'Z': 16}","{'Q': 25, 'R': 17, 'S': 8, 'T': 8, 'H': 17, 'M': 8}","{'Y': 8, 'A': 8, 'B': 4, 'D': 4, 'E': 4, 'G': 8, 'I': 4, 'K': 8, 'L': 4, 'N': 4, 'O': 4, 'U': 8, 'V': 4, 'W': 4, 'X': 4}"
INV-ZZ-7442576,SCH-ZZ-3820040,ZZ,ZZ20240408MAATRV2047.0,2047.0,Boeing 767,04/08/2024,2024-04-08 07:41:00,2024-04-09 02:50:00,MAA,TRV,278.0,315,207,-71,108,27,55,83,111,31,20,7,11,66,43,12,23,96,63,20,33,130,86,25,44,"{'F': 16, 'P': 11}","{'C': 22, 'J': 16, 'Z': 16}","{'Q': 25, 'R': 17, 'S': 8, 'T': 8, 'H': 17, 'M': 8}","{'Y': 8, 'A': 8, 'B': 4, 'D': 4, 'E': 4, 'G': 8, 'I': 4, 'K': 8, 'L': 4, 'N': 4, 'O': 4, 'U': 8, 'V': 4, 'W': 4, 'X': 4}"
INV-ZZ-8273413,SCH-ZZ-3820040,ZZ,ZZ20240413MAATRV2047.0,2047.0,Boeing 767,04/13/2024,2024-04-13 07:41:00,2024-04-14 02:50:00,MAA,TRV,278.0,314,193,-85,121,27,55,83,111,31,19,8,12,63,39,16,24,96,59,24,37,128,78,33,50,"{'F': 16, 'P': 11}","{'C': 22, 'J': 16, 'Z': 16}","{'Q': 25, 'R': 17, 'S': 8, 'T': 8, 'H': 17, 'M': 8}","{'Y': 8, 'A': 8, 'B': 4, 'D': 4, 'E': 4, 'G': 8, 'I': 4, 'K': 8, 'L': 4, 'N': 4, 'O': 4, 'U': 8, 'V': 4, 'W': 4, 'X': 4}"
INV-ZZ-2549156,SCH-ZZ-3820040,ZZ,ZZ20240414MAATRV2047.0,2047.0,Boeing 767,04/14/2024,2024-04-14 07:41:00,2024-04-15 02:50:00,MAA,TRV,278.0,321,186,-92,135,27,55,83,111,31,18,9,13,63,37,18,26,94,55,28,39,133,77,34,56,"{'F': 16, 'P': 11}","{'C': 22, 'J': 16, 'Z': 16}","{'Q': 25, 'R': 17, 'S': 8, 'T': 8, 'H': 17, 'M': 8}","{'Y': 8, 'A': 8, 'B': 4, 'D': 4, 'E': 4, 'G': 8, 'I': 4, 'K': 8, 'L': 4, 'N': 4, 'O': 4, 'U': 8, 'V': 4, 'W': 4, 'X': 4}"
INV-ZZ-4281931,SCH-ZZ-3820040,ZZ,ZZ20240415MAATRV2047.0,2047.0,Boeing 767,04/15/2024,2024-04-15 07:41:00,2024-04-16 02:50:00,MAA,TRV,278.0,322,202,-76,120,27,55,83,111,32,20,7,12,65,41,14,24,91,57,26,34,127,80,31,47,"{'F': 16, 'P': 11}","{'C': 22, 'J': 16, 'Z': 16}","{'Q': 25, 'R': 17, 'S': 8, 'T': 8, 'H': 17, 'M': 8}","{'Y': 8, 'A': 8, 'B': 4, 'D': 4, 'E': 4, 'G': 8, 'I': 4, 'K': 8, 'L': 4, 'N': 4, 'O': 4, 'U': 8, 'V': 4, 'W': 4, 'X': 4}"
INV-ZZ-3466080,SCH-ZZ-3820040,ZZ,ZZ20240420MAATRV2047.0,2047.0,Boeing 767,04/20/2024,2024-04-20 07:41:00,2024-04-21 02:50:00,MAA,TRV,278.0,314,178,-100,136,27,55,83,111,31,18,9,13,64,36,19,28,95,54,29,41,122,69,42,53,"{'F': 16, 'P': 11}","{'C': 22, 'J': 16, 'Z': 16}","{'Q': 25, 'R': 17, 'S': 8, 'T': 8, 'H': 17, 'M': 8}","{'Y': 8, 'A': 8, 'B': 4, 'D': 4, 'E': 4, 'G': 8, 'I': 4, 'K': 8, 'L': 4, 'N': 4, 'O': 4, 'U': 8, 'V': 4, 'W': 4, 'X': 4}"
INV-ZZ-6808081,SCH-ZZ-3820040,ZZ,ZZ20240421MAATRV2047.0,2047.0,Boeing 767,04/21/2024,2024-04-21 07:41:00,2024-04-22 02:50:00,MAA,TRV,278.0,333,198,-80,135,27,55,83,111,31,18,9,13,62,37,18,25,92,55,28,37,130,77,34,53,"{'F': 16, 'P': 11}","{'C': 22, 'J': 16, 'Z': 16}","{'Q': 25, 'R': 17, 'S': 8, 'T': 8, 'H': 17, 'M': 8}","{'Y': 8, 'A': 8, 'B': 4, 'D': 4, 'E': 4, 'G': 8, 'I': 4, 'K': 8, 'L': 4, 'N': 4, 'O': 4, 'U': 8, 'V': 4, 'W': 4, 'X': 4}"
INV-ZZ-7114199,SCH-ZZ-3820040,ZZ,ZZ20240422MAATRV2047.0,2047.0,Boeing 767,04/22/2024,2024-04-22 07:41:00,2024-04-23 02:50:00,MAA,TRV,278.0,311,171,-107,140,27,55,83,111,31,17,10,14,65,36,19,29,92,51,32,41,127,70,41,57,"{'F': 16, 'P': 11}","{'C': 22, 'J': 16, 'Z': 16}","{'Q': 25, 'R': 17, 'S': 8, 'T': 8, 'H': 17, 'M': 8}","{'Y': 8, 'A': 8, 'B': 4, 'D': 4, 'E': 4, 'G': 8, 'I': 4, 'K': 8, 'L': 4, 'N': 4, 'O': 4, 'U': 8, 'V': 4, 'W': 4, 'X': 4}"
INV-ZZ-6673982,SCH-ZZ-3820040,ZZ,ZZ20240427MAATRV2047.0,2047.0,Boeing 767,04/27/2024,2024-04-27 07:41:00,2024-04-28 02:50:00,MAA,TRV,278.0,312,188,-90,124,27,55,83,111,32,19,8,13,61,37,18,24,98,59,24,39,129,78,33,51,"{'F': 16, 'P': 11}","{'C': 22, 'J': 16, 'Z': 16}","{'Q': 25, 'R': 17, 'S': 8, 'T': 8, 'H': 17, 'M': 8}","{'Y': 8, 'A': 8, 'B': 4, 'D': 4, 'E': 4, 'G': 8, 'I': 4, 'K': 8, 'L': 4, 'N': 4, 'O': 4, 'U': 8, 'V': 4, 'W': 4, 'X': 4}"
INV-ZZ-7023949,SCH-ZZ-3820040,ZZ,ZZ20240428MAATRV2047.0,2047.0,Boeing 767,04/28/2024,2024-04-28 07:41:00,2024-04-29 02:50:00,MAA,TRV,278.0,324,171,-107,153,27,55,83,111,32,17,10,15,63,33,22,30,94,50,33,44,131,69,42,62,"{'F': 16, 'P': 11}","{'C': 22, 'J': 16, 'Z': 16}","{'Q': 25, 'R': 17, 'S': 8, 'T': 8, 'H': 17, 'M': 8}","{'Y': 8, 'A': 8, 'B': 4, 'D': 4, 'E': 4, 'G': 8, 'I': 4, 'K': 8, 'L': 4, 'N': 4, 'O': 4, 'U': 8, 'V': 4, 'W': 4, 'X': 4}"
INV-ZZ-7623332,SCH-ZZ-3820040,ZZ,ZZ20240429MAATRV2047.0,2047.0,Boeing 767,04/29/2024,2024-04-29 07:41:00,2024-04-30 02:50:00,MAA,TRV,278.0,327,176,-102,151,27,55,83,111,30,16,11,14,64,34,21,30,93,50,33,43,133,72,39,61,"{'F': 16, 'P': 11}","{'C': 22, 'J': 16, 'Z': 16}","{'Q': 25, 'R': 17, 'S': 8, 'T': 8, 'H': 17, 'M': 8}","{'Y': 8, 'A': 8, 'B': 4, 'D': 4, 'E': 4, 'G': 8, 'I': 4, 'K': 8, 'L': 4, 'N': 4, 'O': 4, 'U': 8, 'V': 4, 'W': 4, 'X': 4}"
INV-ZZ-4224781,SCH-ZZ-3820040,ZZ,ZZ20240504MAATRV2047.0,2047.0,Boeing 767,05/04/2024,2024-05-04 07:41:00,2024-05-05 02:50:00,MAA,TRV,278.0,328,171,-107,157,27,55,83,111,32,17,10,15,64,33,22,31,98,51,32,47,124,65,46,59,"{'F': 16, 'P': 11}","{'C': 22, 'J': 16, 'Z': 16}","{'Q': 25, 'R': 17, 'S': 8, 'T': 8, 'H': 17, 'M': 8}","{'Y': 8, 'A': 8, 'B': 4, 'D': 4, 'E': 4, 'G': 8, 'I': 4, 'K': 8, 'L': 4, 'N': 4, 'O': 4, 'U': 8, 'V': 4, 'W': 4, 'X': 4}"
INV-ZZ-1744723,SCH-ZZ-3820040,ZZ,ZZ20240505MAATRV2047.0,2047.0,Boeing 767,05/05/2024,2024-05-05 07:41:00,2024-05-06 02:50:00,MAA,TRV,278.0,328,177,-101,151,27,55,83,111,30,16,11,14,64,35,20,29,92,50,33,42,131,71,40,60,"{'F': 16, 'P': 11}","{'C': 22, 'J': 16, 'Z': 16}","{'Q': 25, 'R': 17, 'S': 8, 'T': 8, 'H': 17, 'M': 8}","{'Y': 8, 'A': 8, 'B': 4, 'D': 4, 'E': 4, 'G': 8, 'I': 4, 'K': 8, 'L': 4, 'N': 4, 'O': 4, 'U': 8, 'V': 4, 'W': 4, 'X': 4}"
INV-ZZ-3258463,SCH-ZZ-3820040,ZZ,ZZ20240506MAATRV2047.0,2047.0,Boeing 767,05/06/2024,2024-05-06 07:41:00,2024-05-07 02:50:00,MAA,TRV,278.0,310,165,-113,145,27,55,83,111,31,16,11,15,66,35,20,31,95,51,32,44,130,69,42,61,"{'F': 16, 'P': 11}","{'C': 22, 'J': 16, 'Z': 16}","{'Q': 25, 'R': 17, 'S': 8, 'T': 8, 'H': 17, 'M': 8}","{'Y': 8, 'A': 8, 'B': 4, 'D': 4, 'E': 4, 'G': 8, 'I': 4, 'K': 8, 'L': 4, 'N': 4, 'O': 4, 'U': 8, 'V': 4, 'W': 4, 'X': 4}"
INV-ZZ-6761209,SCH-ZZ-3820040,ZZ,ZZ20240511MAATRV2047.0,2047.0,Boeing 767,05/11/2024,2024-05-11 07:41:00,2024-05-12 02:50:00,MAA,TRV,278.0,311,158,-120,153,27,55,83,111,30,15,12,15,66,34,21,32,92,47,36,45,124,63,48,61,"{'F': 16, 'P': 11}","{'C': 22, 'J': 16, 'Z': 16}","{'Q': 25, 'R': 17, 'S': 8, 'T': 8, 'H': 17, 'M': 8}","{'Y': 8, 'A': 8, 'B': 4, 'D': 4, 'E': 4, 'G': 8, 'I': 4, 'K': 8, 'L': 4, 'N': 4, 'O': 4, 'U': 8, 'V': 4, 'W': 4, 'X': 4}"
INV-ZZ-4601045,SCH-ZZ-3820040,ZZ,ZZ20240512MAATRV2047.0,2047.0,Boeing 767,05/12/2024,2024-05-12 07:41:00,2024-05-13 02:50:00,MAA,TRV,278.0,307,152,-126,155,27,55,83,111,30,15,12,15,64,32,23,32,96,48,35,48,125,62,49,63,"{'F': 16, 'P': 11}","{'C': 22, 'J': 16, 'Z': 16}","{'Q': 25, 'R': 17, 'S': 8, 'T': 8, 'H': 17, 'M': 8}","{'Y': 8, 'A': 8, 'B': 4, 'D': 4, 'E': 4, 'G': 8, 'I': 4, 'K': 8, 'L': 4, 'N': 4, 'O': 4, 'U': 8, 'V': 4, 'W': 4, 'X': 4}"
INV-ZZ-7582762,SCH-ZZ-3820040,ZZ,ZZ20240513MAATRV2047.0,2047.0,Boeing 767,05/13/2024,2024-05-13 07:41:00,2024-05-14 02:50:00,MAA,TRV,278.0,313,163,-115,150,27,55,83,111,31,16,11,15,65,34,21,31,94,49,34,45,131,68,43,63,"{'F': 16, 'P': 11}","{'C': 22, 'J': 16, 'Z': 16}","{'Q': 25, 'R': 17, 'S': 8, 'T': 8, 'H': 17, 'M': 8}","{'Y': 8, 'A': 8, 'B': 4, 'D': 4, 'E': 4, 'G': 8, 'I': 4, 'K': 8, 'L': 4, 'N': 4, 'O': 4, 'U': 8, 'V': 4, 'W': 4, 'X': 4}"
INV-ZZ-6373982,SCH-ZZ-9037923,ZZ,ZZ20240506GAUBOM4819.0,4819.0,Boeing 757,05/06/2024,2024-05-06 10:11:00,2024-05-07 07:06:00,GAU,BOM,209.0,231,134,-75,97,20,41,62,83,22,13,7,9,47,27,14,20,74,43,19,31,93,54,29,39,"{'F': 12, 'P': 8}","{'C': 16, 'J': 12, 'Z': 12}","{'Q': 19, 'R': 12, 'S': 6, 'T': 6, 'H': 12, 'M': 6}","{'Y': 6, 'A': 6, 'B': 3, 'D': 3, 'E': 3, 'G': 6, 'I': 3, 'K': 6, 'L': 3, 'N': 3, 'O': 3, 'U': 6, 'V': 3, 'W': 3, 'X': 3}"
INV-ZZ-8592650,SCH-ZZ-9037923,ZZ,ZZ20240509GAUBOM4819.0,4819.0,Boeing 757,05/09/2024,2024-05-09 10:11:00,2024-05-10 07:06:00,GAU,BOM,209.0,240,120,-89,120,20,41,62,83,23,12,8,11,46,23,18,23,73,37,25,36,96,48,35,48,"{'F': 12, 'P': 8}","{'C': 16, 'J': 12, 'Z': 12}","{'Q': 19, 'R': 12, 'S': 6, 'T': 6, 'H': 12, 'M': 6}","{'Y': 6, 'A': 6, 'B': 3, 'D': 3, 'E': 3, 'G': 6, 'I': 3, 'K': 6, 'L': 3, 'N': 3, 'O': 3, 'U': 6, 'V': 3, 'W': 3, 'X': 3}"
INV-ZZ-9751291,SCH-ZZ-9037923,ZZ,ZZ20240511GAUBOM4819.0,4819.0,Boeing 757,05/11/2024,2024-05-11 10:11:00,2024-05-12 07:06:00,GAU,BOM,209.0,244,130,-79,114,20,41,62,83,24,13,7,11,49,26,15,23,69,37,25,32,92,49,34,43,"{'F': 12, 'P': 8}","{'C': 16, 'J': 12, 'Z': 12}","{'Q': 19, 'R': 12, 'S': 6, 'T': 6, 'H': 12, 'M': 6}","{'Y': 6, 'A': 6, 'B': 3, 'D': 3, 'E': 3, 'G': 6, 'I': 3, 'K': 6, 'L': 3, 'N': 3, 'O': 3, 'U': 6, 'V': 3, 'W': 3, 'X': 3}"
INV-ZZ-9825727,SCH-ZZ-9037923,ZZ,ZZ20240512GAUBOM4819.0,4819.0,Boeing 757,05/12/2024,2024-05-12 10:11:00,2024-05-13 07:06:00,GAU,BOM,209.0,245,119,-90,126,20,41,62,83,22,11,9,11,46,22,19,24,73,36,26,37,94,46,37,48,"{'F': 12, 'P': 8}","{'C': 16, 'J': 12, 'Z': 12}","{'Q': 19, 'R': 12, 'S': 6, 'T': 6, 'H': 12, 'M': 6}","{'Y': 6, 'A': 6, 'B': 3, 'D': 3, 'E': 3, 'G': 6, 'I': 3, 'K': 6, 'L': 3, 'N': 3, 'O': 3, 'U': 6, 'V': 3, 'W': 3, 'X': 3}"
INV-ZZ-5555915,SCH-ZZ-9037923,ZZ,ZZ20240513GAUBOM4819.0,4819.0,Boeing 757,05/13/2024,2024-05-13 10:11:00,2024-05-14 07:06:00,GAU,BOM,209.0,234,126,-83,108,20,41,62,83,23,12,8,11,46,25,16,21,69,37,25,32,98,53,30,45,"{'F': 12, 'P': 8}","{'C': 16, 'J': 12, 'Z': 12}","{'Q': 19, 'R': 12, 'S': 6, 'T': 6, 'H': 12, 'M': 6}","{'Y': 6, 'A': 6, 'B': 3, 'D': 3, 'E': 3, 'G': 6, 'I': 3, 'K': 6, 'L': 3, 'N': 3, 'O': 3, 'U': 6, 'V': 3, 'W': 3, 'X': 3}"
INV-ZZ-6743814,SCH-ZZ-9037923,ZZ,ZZ20240516GAUBOM4819.0,4819.0,Boeing 757,05/16/2024,2024-05-16 10:11:00,2024-05-17 07:06:00,GAU,BOM,209.0,239,128,-81,111,20,41,62,83,23,12,8,11,48,26,15,22,74,40,22,34,94,50,33,44,"{'F': 12, 'P': 8}","{'C': 16, 'J': 12, 'Z': 12}","{'Q': 19, 'R': 12, 'S': 6, 'T': 6, 'H': 12, 'M': 6}","{'Y': 6, 'A': 6, 'B': 3, 'D': 3, 'E': 3, 'G': 6, 'I': 3, 'K': 6, 'L': 3, 'N': 3, 'O': 3, 'U': 6, 'V': 3, 'W': 3, 'X': 3}"
INV-ZZ-7683128,SCH-ZZ-9037923,ZZ,ZZ20240518GAUBOM4819.0,4819.0,Boeing 757,05/18/2024,2024-05-18 10:11:00,2024-05-19 07:06:00,GAU,BOM,209.0,235,125,-84,110,20,41,62,83,24,13,7,11,48,26,15,22,72,38,24,34,96,51,32,45,"{'F': 12, 'P': 8}","{'C': 16, 'J': 12, 'Z': 12}","{'Q': 19, 'R': 12, 'S': 6, 'T': 6, 'H': 12, 'M': 6}","{'Y': 6, 'A': 6, 'B': 3, 'D': 3, 'E': 3, 'G': 6, 'I': 3, 'K': 6, 'L': 3, 'N': 3, 'O': 3, 'U': 6, 'V': 3, 'W': 3, 'X': 3}"
INV-ZZ-4643395,SCH-ZZ-9037923,ZZ,ZZ20240519GAUBOM4819.0,4819.0,Boeing 757,05/19/2024,2024-05-19 10:11:00,2024-05-20 07:06:00,GAU,BOM,209.0,248,126,-83,122,20,41,62,83,24,12,8,12,48,24,17,24,70,36,26,34,99,50,33,49,"{'F': 12, 'P': 8}","{'C': 16, 'J': 12, 'Z': 12}","{'Q': 19, 'R': 12, 'S': 6, 'T': 6, 'H': 12, 'M': 6}","{'Y': 6, 'A': 6, 'B': 3, 'D': 3, 'E': 3, 'G': 6, 'I': 3, 'K': 6, 'L': 3, 'N': 3, 'O': 3, 'U': 6, 'V': 3, 'W': 3, 'X': 3}"
INV-ZZ-3124974,SCH-ZZ-9037923,ZZ,ZZ20240520GAUBOM4819.0,4819.0,Boeing 757,05/20/2024,2024-05-20 10:11:00,2024-05-21 07:06:00,GAU,BOM,209.0,234,113,-96,121,20,41,62,83,24,12,8,12,48,23,18,25,72,35,27,37,94,45,38,49,"{'F': 12, 'P': 8}","{'C': 16, 'J': 12, 'Z': 12}","{'Q': 19, 'R': 12, 'S': 6, 'T': 6, 'H': 12, 'M': 6}","{'Y': 6, 'A': 6, 'B': 3, 'D': 3, 'E': 3, 'G': 6, 'I': 3, 'K': 6, 'L': 3, 'N': 3, 'O': 3, 'U': 6, 'V': 3, 'W': 3, 'X': 3}"
INV-ZZ-1674773,SCH-ZZ-9037923,ZZ,ZZ20240523GAUBOM4819.0,4819.0,Boeing 757,05/23/2024,2024-05-23 10:11:00,2024-05-24 07:06:00,GAU,BOM,209.0,230,122,-87,108,20,41,62,83,24,13,7,11,48,26,15,22,74,39,23,35,92,49,34,43,"{'F': 12, 'P': 8}","{'C': 16, 'J': 12, 'Z': 12}","{'Q': 19, 'R': 12, 'S': 6, 'T': 6, 'H': 12, 'M': 6}","{'Y': 6, 'A': 6, 'B': 3, 'D': 3, 'E': 3, 'G': 6, 'I': 3, 'K': 6, 'L': 3, 'N': 3, 'O': 3, 'U': 6, 'V': 3, 'W': 3, 'X': 3}"
INV-ZZ-9426800,SCH-ZZ-9037923,ZZ,ZZ20240525GAUBOM4819.0,4819.0,Boeing 757,05/25/2024,2024-05-25 10:11:00,2024-05-26 07:06:00,GAU,BOM,209.0,249,132,-77,117,20,41,62,83,24,13,7,11,47,25,16,22,69,37,25,32,97,51,32,46,"{'F': 12, 'P': 8}","{'C': 16, 'J': 12, 'Z': 12}","{'Q': 19, 'R': 12, 'S': 6, 'T': 6, 'H': 12, 'M': 6}","{'Y': 6, 'A': 6, 'B': 3, 'D': 3, 'E': 3, 'G': 6, 'I': 3, 'K': 6, 'L': 3, 'N': 3, 'O': 3, 'U': 6, 'V': 3, 'W': 3, 'X': 3}"
INV-ZZ-1905763,SCH-ZZ-9037923,ZZ,ZZ20240526GAUBOM4819.0,4819.0,Boeing 757,05/26/2024,2024-05-26 10:11:00,2024-05-27 07:06:00,GAU,BOM,209.0,235,117,-92,118,20,41,62,83,23,11,9,12,47,23,18,24,72,36,26,36,99,49,34,50,"{'F': 12, 'P': 8}","{'C': 16, 'J': 12, 'Z': 12}","{'Q': 19, 'R': 12, 'S': 6, 'T': 6, 'H': 12, 'M': 6}","{'Y': 6, 'A': 6, 'B': 3, 'D': 3, 'E': 3, 'G': 6, 'I': 3, 'K': 6, 'L': 3, 'N': 3, 'O': 3, 'U': 6, 'V': 3, 'W': 3, 'X': 3}"
INV-ZZ-7119200,SCH-ZZ-9037923,ZZ,ZZ20240527GAUBOM4819.0,4819.0,Boeing 757,05/27/2024,2024-05-27 10:11:00,2024-05-28 07:06:00,GAU,BOM,209.0,239,122,-87,117,20,41,62,83,23,12,8,11,45,23,18,22,72,37,25,35,93,47,36,46,"{'F': 12, 'P': 8}","{'C': 16, 'J': 12, 'Z': 12}","{'Q': 19, 'R': 12, 'S': 6, 'T': 6, 'H': 12, 'M': 6}","{'Y': 6, 'A': 6, 'B': 3, 'D': 3, 'E': 3, 'G': 6, 'I': 3, 'K': 6, 'L': 3, 'N': 3, 'O': 3, 'U': 6, 'V': 3, 'W': 3, 'X': 3}"
INV-ZZ-3197551,SCH-ZZ-9037923,ZZ,ZZ20240530GAUBOM4819.0,4819.0,Boeing 757,05/30/2024,2024-05-30 10:11:00,2024-05-31 07:06:00,GAU,BOM,209.0,234,117,-92,117,20,41,62,83,23,12,8,11,46,23,18,23,72,36,26,36,92,46,37,46,"{'F': 12, 'P': 8}","{'C': 16, 'J': 12, 'Z': 12}","{'Q': 19, 'R': 12, 'S': 6, 'T': 6, 'H': 12, 'M': 6}","{'Y': 6, 'A': 6, 'B': 3, 'D': 3, 'E': 3, 'G': 6, 'I': 3, 'K': 6, 'L': 3, 'N': 3, 'O': 3, 'U': 6, 'V': 3, 'W': 3, 'X': 3}"
INV-ZZ-3570366,SCH-ZZ-9037923,ZZ,ZZ20240601GAUBOM4819.0,4819.0,Boeing 757,06/01/2024,2024-06-01 10:11:00,2024-06-02 07:06:00,GAU,BOM,209.0,245,123,-86,122,20,41,62,83,22,11,9,11,46,23,18,23,71,36,26,35,97,49,34,48,"{'F': 12, 'P': 8}","{'C': 16, 'J': 12, 'Z': 12}","{'Q': 19, 'R': 12, 'S': 6, 'T': 6, 'H': 12, 'M': 6}","{'Y': 6, 'A': 6, 'B': 3, 'D': 3, 'E': 3, 'G': 6, 'I': 3, 'K': 6, 'L': 3, 'N': 3, 'O': 3, 'U': 6, 'V': 3, 'W': 3, 'X': 3}"
INV-ZZ-8664424,SCH-ZZ-9037923,ZZ,ZZ20240602GAUBOM4819.0,4819.0,Boeing 757,06/02/2024,2024-06-02 10:11:00,2024-06-03 07:06:00,GAU,BOM,209.0,242,117,-92,125,20,41,62,83,23,11,9,12,47,23,18,24,70,34,28,36,98,47,36,51,"{'F': 12, 'P': 8}","{'C': 16, 'J': 12, 'Z': 12}","{'Q': 19, 'R': 12, 'S': 6, 'T': 6, 'H': 12, 'M': 6}","{'Y': 6, 'A': 6, 'B': 3, 'D': 3, 'E': 3, 'G': 6, 'I': 3, 'K': 6, 'L': 3, 'N': 3, 'O': 3, 'U': 6, 'V': 3, 'W': 3, 'X': 3}"
INV-ZZ-5121900,SCH-ZZ-9037923,ZZ,ZZ20240603GAUBOM4819.0,4819.0,Boeing 757,06/03/2024,2024-06-03 10:11:00,2024-06-04 07:06:00,GAU,BOM,209.0,247,123,-86,124,20,41,62,83,22,11,9,11,48,24,17,24,74,37,25,37,98,49,34,49,"{'F': 12, 'P': 8}","{'C': 16, 'J': 12, 'Z': 12}","{'Q': 19, 'R': 12, 'S': 6, 'T': 6, 'H': 12, 'M': 6}","{'Y': 6, 'A': 6, 'B': 3, 'D': 3, 'E': 3, 'G': 6, 'I': 3, 'K': 6, 'L': 3, 'N': 3, 'O': 3, 'U': 6, 'V': 3, 'W': 3, 'X': 3}"
INV-ZZ-4173657,SCH-ZZ-9037923,ZZ,ZZ20240606GAUBOM4819.0,4819.0,Boeing 757,06/06/2024,2024-06-06 10:11:00,2024-06-07 07:06:00,GAU,BOM,209.0,236,115,-94,121,20,41,62,83,23,11,9,12,46,22,19,24,70,34,28,36,99,48,35,51,"{'F': 12, 'P': 8}","{'C': 16, 'J': 12, 'Z': 12}","{'Q': 19, 'R': 12, 'S': 6, 'T': 6, 'H': 12, 'M': 6}","{'Y': 6, 'A': 6, 'B': 3, 'D': 3, 'E': 3, 'G': 6, 'I': 3, 'K': 6, 'L': 3, 'N': 3, 'O': 3, 'U': 6, 'V': 3, 'W': 3, 'X': 3}"
INV-ZZ-7982035,SCH-ZZ-9037923,ZZ,ZZ20240608GAUBOM4819.0,4819.0,Boeing 757,06/08/2024,2024-06-08 10:11:00,2024-06-09 07:06:00,GAU,BOM,209.0,237,111,-98,126,20,41,62,83,22,10,10,12,49,23,18,26,71,33,29,38,98,46,37,52,"{'F': 12, 'P': 8}","{'C': 16, 'J': 12, 'Z': 12}","{'Q': 19, 'R': 12, 'S': 6, 'T': 6, 'H': 12, 'M': 6}","{'Y': 6, 'A': 6, 'B': 3, 'D': 3, 'E': 3, 'G': 6, 'I': 3, 'K': 6, 'L': 3, 'N': 3, 'O': 3, 'U': 6, 'V': 3, 'W': 3, 'X': 3}"
INV-ZZ-7952593,SCH-ZZ-9037923,ZZ,ZZ20240609GAUBOM4819.0,4819.0,Boeing 757,06/09/2024,2024-06-09 10:11:00,2024-06-10 07:06:00,GAU,BOM,209.0,242,105,-104,137,20,41,62,83,22,10,10,12,46,20,21,26,69,30,32,39,94,41,42,53,"{'F': 12, 'P': 8}","{'C': 16, 'J': 12, 'Z': 12}","{'Q': 19, 'R': 12, 'S': 6, 'T': 6, 'H': 12, 'M': 6}","{'Y': 6, 'A': 6, 'B': 3, 'D': 3, 'E': 3, 'G': 6, 'I': 3, 'K': 6, 'L': 3, 'N': 3, 'O': 3, 'U': 6, 'V': 3, 'W': 3, 'X': 3}"
INV-ZZ-9206760,SCH-ZZ-9037923,ZZ,ZZ20240610GAUBOM4819.0,4819.0,Boeing 757,06/10/2024,2024-06-10 10:11:00,2024-06-11 07:06:00,GAU,BOM,209.0,239,102,-107,137,20,41,62,83,24,10,10,14,46,20,21,26,74,32,30,42,97,41,42,56,"{'F': 12, 'P': 8}","{'C': 16, 'J': 12, 'Z': 12}","{'Q': 19, 'R': 12, 'S': 6, 'T': 6, 'H': 12, 'M': 6}","{'Y': 6, 'A': 6, 'B': 3, 'D': 3, 'E': 3, 'G': 6, 'I': 3, 'K': 6, 'L': 3, 'N': 3, 'O': 3, 'U': 6, 'V': 3, 'W': 3, 'X': 3}"
INV-ZZ-4402319,SCH-ZZ-9037923,ZZ,ZZ20240613GAUBOM4819.0,4819.0,Boeing 757,06/13/2024,2024-06-13 10:11:00,2024-06-14 07:06:00,GAU,BOM,209.0,249,114,-95,135,20,41,62,83,23,11,9,12,45,21,20,24,69,32,30,37,94,43,40,51,"{'F': 12, 'P': 8}","{'C': 16, 'J': 12, 'Z': 12}","{'Q': 19, 'R': 12, 'S': 6, 'T': 6, 'H': 12, 'M': 6}","{'Y': 6, 'A': 6, 'B': 3, 'D': 3, 'E': 3, 'G': 6, 'I': 3, 'K': 6, 'L': 3, 'N': 3, 'O': 3, 'U': 6, 'V': 3, 'W': 3, 'X': 3}"
INV-ZZ-2678252,SCH-ZZ-9037923,ZZ,ZZ20240615GAUBOM4819.0,4819.0,Boeing 757,06/15/2024,2024-06-15 10:11:00,2024-06-16 07:06:00,GAU,BOM,209.0,244,104,-105,140,20,41,62,83,22,9,11,13,45,19,22,26,74,31,31,43,98,42,41,56,"{'F': 12, 'P': 8}","{'C': 16, 'J': 12, 'Z': 12}","{'Q': 19, 'R': 12, 'S': 6, 'T': 6, 'H': 12, 'M': 6}","{'Y': 6, 'A': 6, 'B': 3, 'D': 3, 'E': 3, 'G': 6, 'I': 3, 'K': 6, 'L': 3, 'N': 3, 'O': 3, 'U': 6, 'V': 3, 'W': 3, 'X': 3}"
INV-ZZ-2536551,SCH-ZZ-9037923,ZZ,ZZ20240616GAUBOM4819.0,4819.0,Boeing 757,06/16/2024,2024-06-16 10:11:00,2024-06-17 07:06:00,GAU,BOM,209.0,236,97,-112,139,20,41,62,83,23,9,11,14,48,20,21,28,72,30,32,42,93,38,45,55,"{'F': 12, 'P': 8}","{'C': 16, 'J': 12, 'Z': 12}","{'Q': 19, 'R': 12, 'S': 6, 'T': 6, 'H': 12, 'M': 6}","{'Y': 6, 'A': 6, 'B': 3, 'D': 3, 'E': 3, 'G': 6, 'I': 3, 'K': 6, 'L': 3, 'N': 3, 'O': 3, 'U': 6, 'V': 3, 'W': 3, 'X': 3}"
INV-ZZ-2401469,SCH-ZZ-9037923,ZZ,ZZ20240617GAUBOM4819.0,4819.0,Boeing 757,06/17/2024,2024-06-17 10:11:00,2024-06-18 07:06:00,GAU,BOM,209.0,249,102,-107,147,20,41,62,83,22,9,11,13,48,20,21,28,74,30,32,44,98,40,43,58,"{'F': 12, 'P': 8}","{'C': 16, 'J': 12, 'Z': 12}","{'Q': 19, 'R': 12, 'S': 6, 'T': 6, 'H': 12, 'M': 6}","{'Y': 6, 'A': 6, 'B': 3, 'D': 3, 'E': 3, 'G': 6, 'I': 3, 'K': 6, 'L': 3, 'N': 3, 'O': 3, 'U': 6, 'V': 3, 'W': 3, 'X': 3}"
INV-ZZ-9805291,SCH-ZZ-9037923,ZZ,ZZ20240620GAUBOM4819.0,4819.0,Boeing 757,06/20/2024,2024-06-20 10:11:00,2024-06-21 07:06:00,GAU,BOM,209.0,234,106,-103,128,20,41,62,83,23,10,10,13,48,22,19,26,71,32,30,39,98,44,39,54,"{'F': 12, 'P': 8}","{'C': 16, 'J': 12, 'Z': 12}","{'Q': 19, 'R': 12, 'S': 6, 'T': 6, 'H': 12, 'M': 6}","{'Y': 6, 'A': 6, 'B': 3, 'D': 3, 'E': 3, 'G': 6, 'I': 3, 'K': 6, 'L': 3, 'N': 3, 'O': 3, 'U': 6, 'V': 3, 'W': 3, 'X': 3}"
INV-ZZ-5731235,SCH-ZZ-1972995,ZZ,ZZ20240509LKOBLR2560.0,2560.0,Boeing 767,05/09/2024,2024-05-09 21:07:00,2024-05-10 16:35:00,LKO,BLR,278.0,324,161,-117,163,27,55,83,111,30,15,12,15,63,31,24,32,94,47,36,47,131,65,46,66,"{'F': 16, 'P': 11}","{'C': 22, 'J': 16, 'Z': 16}","{'Q': 25, 'R': 17, 'S': 8, 'T': 8, 'H': 17, 'M': 8}","{'Y': 8, 'A': 8, 'B': 4, 'D': 4, 'E': 4, 'G': 8, 'I': 4, 'K': 8, 'L': 4, 'N': 4, 'O': 4, 'U': 8, 'V': 4, 'W': 4, 'X': 4}"
INV-ZZ-4403897,SCH-ZZ-1972995,ZZ,ZZ20240512LKOBLR2560.0,2560.0,Boeing 767,05/12/2024,2024-05-12 21:07:00,2024-05-13 16:35:00,LKO,BLR,278.0,313,179,-99,134,27,55,83,111,31,18,9,13,65,37,18,28,93,53,30,40,125,71,40,54,"{'F': 16, 'P': 11}","{'C': 22, 'J': 16, 'Z': 16}","{'Q': 25, 'R': 17, 'S': 8, 'T': 8, 'H': 17, 'M': 8}","{'Y': 8, 'A': 8, 'B': 4, 'D': 4, 'E': 4, 'G': 8, 'I': 4, 'K': 8, 'L': 4, 'N': 4, 'O': 4, 'U': 8, 'V': 4, 'W': 4, 'X': 4}"
INV-ZZ-5486715,SCH-ZZ-1972995,ZZ,ZZ20240516LKOBLR2560.0,2560.0,Boeing 767,05/16/2024,2024-05-16 21:07:00,2024-05-17 16:35:00,LKO,BLR,278.0,318,169,-109,149,27,55,83,111,31,16,11,15,66,35,20,31,99,53,30,46,129,68,43,61,"{'F': 16, 'P': 11}","{'C': 22, 'J': 16, 'Z': 16}","{'Q': 25, 'R': 17, 'S': 8, 'T': 8, 'H': 17, 'M': 8}","{'Y': 8, 'A': 8, 'B': 4, 'D': 4, 'E': 4, 'G': 8, 'I': 4, 'K': 8, 'L': 4, 'N': 4, 'O': 4, 'U': 8, 'V': 4, 'W': 4, 'X': 4}"
INV-ZZ-2576345,SCH-ZZ-1972995,ZZ,ZZ20240519LKOBLR2560.0,2560.0,Boeing 767,05/19/2024,2024-05-19 21:07:00,2024-05-20 16:35:00,LKO,BLR,278.0,310,148,-130,162,27,55,83,111,31,15,12,16,62,30,25,32,96,46,37,50,129,62,49,67,"{'F': 16, 'P': 11}","{'C': 22, 'J': 16, 'Z': 16}","{'Q': 25, 'R': 17, 'S': 8, 'T': 8, 'H': 17, 'M': 8}","{'Y': 8, 'A': 8, 'B': 4, 'D': 4, 'E': 4, 'G': 8, 'I': 4, 'K': 8, 'L': 4, 'N': 4, 'O': 4, 'U': 8, 'V': 4, 'W': 4, 'X': 4}"
INV-ZZ-1063668,SCH-ZZ-1972995,ZZ,ZZ20240523LKOBLR2560.0,2560.0,Boeing 767,05/23/2024,2024-05-23 21:07:00,2024-05-24 16:35:00,LKO,BLR,278.0,331,159,-119,172,27,55,83,111,32,15,12,17,63,30,25,33,97,47,36,50,128,62,49,66,"{'F': 16, 'P': 11}","{'C': 22, 'J': 16, 'Z': 16}","{'Q': 25, 'R': 17, 'S': 8, 'T': 8, 'H': 17, 'M': 8}","{'Y': 8, 'A': 8, 'B': 4, 'D': 4, 'E': 4, 'G': 8, 'I': 4, 'K': 8, 'L': 4, 'N': 4, 'O': 4, 'U': 8, 'V': 4, 'W': 4, 'X': 4}"
INV-ZZ-8675489,SCH-ZZ-1972995,ZZ,ZZ20240526LKOBLR2560.0,2560.0,Boeing 767,05/26/2024,2024-05-26 21:07:00,2024-05-27 16:35:00,LKO,BLR,278.0,313,166,-112,147,27,55,83,111,32,17,10,15,63,33,22,30,98,52,31,46,125,66,45,59,"{'F': 16, 'P': 11}","{'C': 22, 'J': 16, 'Z': 16}","{'Q': 25, 'R': 17, 'S': 8, 'T': 8, 'H': 17, 'M': 8}","{'Y': 8, 'A': 8, 'B': 4, 'D': 4, 'E': 4, 'G': 8, 'I': 4, 'K': 8, 'L': 4, 'N': 4, 'O': 4, 'U': 8, 'V': 4, 'W': 4, 'X': 4}"
INV-ZZ-2754858,SCH-ZZ-1972995,ZZ,ZZ20240530LKOBLR2560.0,2560.0,Boeing 767,05/30/2024,2024-05-30 21:07:00,2024-05-31 16:35:00,LKO,BLR,278.0,328,147,-131,181,27,55,83,111,30,13,14,17,63,28,27,35,94,42,41,52,128,57,54,71,"{'F': 16, 'P': 11}","{'C': 22, 'J': 16, 'Z': 16}","{'Q': 25, 'R': 17, 'S': 8, 'T': 8, 'H': 17, 'M': 8}","{'Y': 8, 'A': 8, 'B': 4, 'D': 4, 'E': 4, 'G': 8, 'I': 4, 'K': 8, 'L': 4, 'N': 4, 'O': 4, 'U': 8, 'V': 4, 'W': 4, 'X': 4}"
INV-ZZ-3649829,SCH-ZZ-1972995,ZZ,ZZ20240602LKOBLR2560.0,2560.0,Boeing 767,06/02/2024,2024-06-02 21:07:00,2024-06-03 16:35:00,LKO,BLR,278.0,324,150,-128,174,27,55,83,111,31,14,13,17,64,30,25,34,93,43,40,50,131,61,50,70,"{'F': 16, 'P': 11}","{'C': 22, 'J': 16, 'Z': 16}","{'Q': 25, 'R': 17, 'S': 8, 'T': 8, 'H': 17, 'M': 8}","{'Y': 8, 'A': 8, 'B': 4, 'D': 4, 'E': 4, 'G': 8, 'I': 4, 'K': 8, 'L': 4, 'N': 4, 'O': 4, 'U': 8, 'V': 4, 'W': 4, 'X': 4}"
INV-ZZ-4455101,SCH-ZZ-1972995,ZZ,ZZ20240606LKOBLR2560.0,2560.0,Boeing 767,06/06/2024,2024-06-06 21:07:00,2024-06-07 16:35:00,LKO,BLR,278.0,310,151,-127,159,27,55,83,111,32,16,11,16,65,32,23,33,95,46,37,49,130,63,48,67,"{'F': 16, 'P': 11}","{'C': 22, 'J': 16, 'Z': 16}","{'Q': 25, 'R': 17, 'S': 8, 'T': 8, 'H': 17, 'M': 8}","{'Y': 8, 'A': 8, 'B': 4, 'D': 4, 'E': 4, 'G': 8, 'I': 4, 'K': 8, 'L': 4, 'N': 4, 'O': 4, 'U': 8, 'V': 4, 'W': 4, 'X': 4}"
INV-ZZ-3755062,SCH-ZZ-1972995,ZZ,ZZ20240609LKOBLR2560.0,2560.0,Boeing 767,06/09/2024,2024-06-09 21:07:00,2024-06-10 16:35:00,LKO,BLR,278.0,317,151,-127,166,27,55,83,111,31,15,12,16,65,31,24,34,94,45,38,49,126,60,51,66,"{'F': 16, 'P': 11}","{'C': 22, 'J': 16, 'Z': 16}","{'Q': 25, 'R': 17, 'S': 8, 'T': 8, 'H': 17, 'M': 8}","{'Y': 8, 'A': 8, 'B': 4, 'D': 4, 'E': 4, 'G': 8, 'I': 4, 'K': 8, 'L': 4, 'N': 4, 'O': 4, 'U': 8, 'V': 4, 'W': 4, 'X': 4}"
INV-ZZ-5738895,SCH-ZZ-1972995,ZZ,ZZ20240613LKOBLR2560.0,2560.0,Boeing 767,06/13/2024,2024-06-13 21:07:00,2024-06-14 16:35:00,LKO,BLR,278.0,331,158,-120,173,27,55,83,111,30,14,13,16,63,30,25,33,92,44,39,48,127,61,50,66,"{'F': 16, 'P': 11}","{'C': 22, 'J': 16, 'Z': 16}","{'Q': 25, 'R': 17, 'S': 8, 'T': 8, 'H': 17, 'M': 8}","{'Y': 8, 'A': 8, 'B': 4, 'D': 4, 'E': 4, 'G': 8, 'I': 4, 'K': 8, 'L': 4, 'N': 4, 'O': 4, 'U': 8, 'V': 4, 'W': 4, 'X': 4}"
INV-ZZ-9906542,SCH-ZZ-1972995,ZZ,ZZ20240616LKOBLR2560.0,2560.0,Boeing 767,06/16/2024,2024-06-16 21:07:00,2024-06-17 16:35:00,LKO,BLR,278.0,322,132,-146,190,27,55,83,111,30,12,15,18,64,26,29,38,96,39,44,57,125,51,60,74,"{'F': 16, 'P': 11}","{'C': 22, 'J': 16, 'Z': 16}","{'Q': 25, 'R': 17, 'S': 8, 'T': 8, 'H': 17, 'M': 8}","{'Y': 8, 'A': 8, 'B': 4, 'D': 4, 'E': 4, 'G': 8, 'I': 4, 'K': 8, 'L': 4, 'N': 4, 'O': 4, 'U': 8, 'V': 4, 'W': 4, 'X': 4}"
INV-ZZ-5919689,SCH-ZZ-1972995,ZZ,ZZ20240620LKOBLR2560.0,2560.0,Boeing 767,06/20/2024,2024-06-20 21:07:00,2024-06-21 16:35:00,LKO,BLR,278.0,307,122,-156,185,27,55,83,111,31,12,15,19,64,25,30,39,95,38,45,57,125,50,61,75,"{'F': 16, 'P': 11}","{'C': 22, 'J': 16, 'Z': 16}","{'Q': 25, 'R': 17, 'S': 8, 'T': 8, 'H': 17, 'M': 8}","{'Y': 8, 'A': 8, 'B': 4, 'D': 4, 'E': 4, 'G': 8, 'I': 4, 'K': 8, 'L': 4, 'N': 4, 'O': 4, 'U': 8, 'V': 4, 'W': 4, 'X': 4}"
INV-ZZ-9589851,SCH-ZZ-2729891,ZZ,ZZ20240404GOIMAA4516.0,4516.0,Airbus A320-200,04/04/2024,2024-04-04 06:48:00,2024-04-05 02:04:00,GOI,MAA,150.0,178,112,-38,66,15,30,45,60,17,11,4,6,35,22,8,13,54,34,11,20,66,41,19,25,"{'F': 9, 'P': 6}","{'C': 12, 'J': 9, 'Z': 9}","{'Q': 14, 'R': 9, 'S': 4, 'T': 4, 'H': 9, 'M': 4}","{'Y': 4, 'A': 4, 'B': 2, 'D': 2, 'E': 2, 'G': 4, 'I': 2, 'K': 4, 'L': 2, 'N': 2, 'O': 2, 'U': 4, 'V': 2, 'W': 2, 'X': 2}"
INV-ZZ-6558820,SCH-ZZ-2729891,ZZ,ZZ20240407GOIMAA4516.0,4516.0,Airbus A320-200,04/07/2024,2024-04-07 06:48:00,2024-04-08 02:04:00,GOI,MAA,150.0,170,113,-37,57,15,30,45,60,17,11,4,6,36,24,6,12,51,34,11,17,70,47,13,23,"{'F': 9, 'P': 6}","{'C': 12, 'J': 9, 'Z': 9}","{'Q': 14, 'R': 9, 'S': 4, 'T': 4, 'H': 9, 'M': 4}","{'Y': 4, 'A': 4, 'B': 2, 'D': 2, 'E': 2, 'G': 4, 'I': 2, 'K': 4, 'L': 2, 'N': 2, 'O': 2, 'U': 4, 'V': 2, 'W': 2, 'X': 2}"
INV-ZZ-4154672,SCH-ZZ-2729891,ZZ,ZZ20240410GOIMAA4516.0,4516.0,Airbus A320-200,04/10/2024,2024-04-10 06:48:00,2024-04-11 02:04:00,GOI,MAA,150.0,170,107,-43,63,15,30,45,60,17,11,4,6,35,22,8,13,54,34,11,20,66,41,19,25,"{'F': 9, 'P': 6}","{'C': 12, 'J': 9, 'Z': 9}","{'Q': 14, 'R': 9, 'S': 4, 'T': 4, 'H': 9, 'M': 4}","{'Y': 4, 'A': 4, 'B': 2, 'D': 2, 'E': 2, 'G': 4, 'I': 2, 'K': 4, 'L': 2, 'N': 2, 'O': 2, 'U': 4, 'V': 2, 'W': 2, 'X': 2}"
INV-ZZ-2929384,SCH-ZZ-2729891,ZZ,ZZ20240411GOIMAA4516.0,4516.0,Airbus A320-200,04/11/2024,2024-04-11 06:48:00,2024-04-12 02:04:00,GOI,MAA,150.0,173,100,-50,73,15,30,45,60,17,10,5,7,34,20,10,14,50,29,16,21,71,41,19,30,"{'F': 9, 'P': 6}","{'C': 12, 'J': 9, 'Z': 9}","{'Q': 14, 'R': 9, 'S': 4, 'T': 4, 'H': 9, 'M': 4}","{'Y': 4, 'A': 4, 'B': 2, 'D': 2, 'E': 2, 'G': 4, 'I': 2, 'K': 4, 'L': 2, 'N': 2, 'O': 2, 'U': 4, 'V': 2, 'W': 2, 'X': 2}"
INV-ZZ-8739157,SCH-ZZ-2729891,ZZ,ZZ20240414GOIMAA4516.0,4516.0,Airbus A320-200,04/14/2024,2024-04-14 06:48:00,2024-04-15 02:04:00,GOI,MAA,150.0,179,110,-40,69,15,30,45,60,18,11,4,7,35,21,9,14,52,32,13,20,68,42,18,26,"{'F': 9, 'P': 6}","{'C': 12, 'J': 9, 'Z': 9}","{'Q': 14, 'R': 9, 'S': 4, 'T': 4, 'H': 9, 'M': 4}","{'Y': 4, 'A': 4, 'B': 2, 'D': 2, 'E': 2, 'G': 4, 'I': 2, 'K': 4, 'L': 2, 'N': 2, 'O': 2, 'U': 4, 'V': 2, 'W': 2, 'X': 2}"
INV-ZZ-9201075,SCH-ZZ-2729891,ZZ,ZZ20240417GOIMAA4516.0,4516.0,Airbus A320-200,04/17/2024,2024-04-17 06:48:00,2024-04-18 02:04:00,GOI,MAA,150.0,170,100,-50,70,15,30,45,60,17,10,5,7,34,20,10,14,50,30,15,20,69,41,19,28,"{'F': 9, 'P': 6}","{'C': 12, 'J': 9, 'Z': 9}","{'Q': 14, 'R': 9, 'S': 4, 'T': 4, 'H': 9, 'M': 4}","{'Y': 4, 'A': 4, 'B': 2, 'D': 2, 'E': 2, 'G': 4, 'I': 2, 'K': 4, 'L': 2, 'N': 2, 'O': 2, 'U': 4, 'V': 2, 'W': 2, 'X': 2}"
INV-ZZ-5048860,SCH-ZZ-2729891,ZZ,ZZ20240418GOIMAA4516.0,4516.0,Airbus A320-200,04/18/2024,2024-04-18 06:48:00,2024-04-19 02:04:00,GOI,MAA,150.0,175,104,-46,71,15,30,45,60,17,10,5,7,34,20,10,14,53,31,14,22,72,43,17,29,"{'F': 9, 'P': 6}","{'C': 12, 'J': 9, 'Z': 9}","{'Q': 14, 'R': 9, 'S': 4, 'T': 4, 'H': 9, 'M': 4}","{'Y': 4, 'A': 4, 'B': 2, 'D': 2, 'E': 2, 'G': 4, 'I': 2, 'K': 4, 'L': 2, 'N': 2, 'O': 2, 'U': 4, 'V': 2, 'W': 2, 'X': 2}"
INV-ZZ-5078776,SCH-ZZ-2729891,ZZ,ZZ20240421GOIMAA4516.0,4516.0,Airbus A320-200,04/21/2024,2024-04-21 06:48:00,2024-04-22 02:04:00,GOI,MAA,150.0,170,97,-53,73,15,30,45,60,18,10,5,8,35,20,10,15,53,30,15,23,67,38,22,29,"{'F': 9, 'P': 6}","{'C': 12, 'J': 9, 'Z': 9}","{'Q': 14, 'R': 9, 'S': 4, 'T': 4, 'H': 9, 'M': 4}","{'Y': 4, 'A': 4, 'B': 2, 'D': 2, 'E': 2, 'G': 4, 'I': 2, 'K': 4, 'L': 2, 'N': 2, 'O': 2, 'U': 4, 'V': 2, 'W': 2, 'X': 2}"
INV-ZZ-9787502,SCH-ZZ-2729891,ZZ,ZZ20240424GOIMAA4516.0,4516.0,Airbus A320-200,04/24/2024,2024-04-24 06:48:00,2024-04-25 02:04:00,GOI,MAA,150.0,175,94,-56,81,15,30,45,60,18,10,5,8,34,18,12,16,51,27,18,24,69,37,23,32,"{'F': 9, 'P': 6}","{'C': 12, 'J': 9, 'Z': 9}","{'Q': 14, 'R': 9, 'S': 4, 'T': 4, 'H': 9, 'M': 4}","{'Y': 4, 'A': 4, 'B': 2, 'D': 2, 'E': 2, 'G': 4, 'I': 2, 'K': 4, 'L': 2, 'N': 2, 'O': 2, 'U': 4, 'V': 2, 'W': 2, 'X': 2}"
INV-ZZ-6842829,SCH-ZZ-2729891,ZZ,ZZ20240425GOIMAA4516.0,4516.0,Airbus A320-200,04/25/2024,2024-04-25 06:48:00,2024-04-26 02:04:00,GOI,MAA,150.0,166,97,-53,69,15,30,45,60,17,10,5,7,35,21,9,14,52,30,15,22,71,42,18,29,"{'F': 9, 'P': 6}","{'C': 12, 'J': 9, 'Z': 9}","{'Q': 14, 'R': 9, 'S': 4, 'T': 4, 'H': 9, 'M': 4}","{'Y': 4, 'A': 4, 'B': 2, 'D': 2, 'E': 2, 'G': 4, 'I': 2, 'K': 4, 'L': 2, 'N': 2, 'O': 2, 'U': 4, 'V': 2, 'W': 2, 'X': 2}"
INV-ZZ-6880546,SCH-ZZ-2729891,ZZ,ZZ20240428GOIMAA4516.0,4516.0,Airbus A320-200,04/28/2024,2024-04-28 06:48:00,2024-04-29 02:04:00,GOI,MAA,150.0,177,104,-46,73,15,30,45,60,17,10,5,7,35,21,9,14,53,31,14,22,70,41,19,29,"{'F': 9, 'P': 6}","{'C': 12, 'J': 9, 'Z': 9}","{'Q': 14, 'R': 9, 'S': 4, 'T': 4, 'H': 9, 'M': 4}","{'Y': 4, 'A': 4, 'B': 2, 'D': 2, 'E': 2, 'G': 4, 'I': 2, 'K': 4, 'L': 2, 'N': 2, 'O': 2, 'U': 4, 'V': 2, 'W': 2, 'X': 2}"
INV-ZZ-6592358,SCH-ZZ-2729891,ZZ,ZZ20240501GOIMAA4516.0,4516.0,Airbus A320-200,05/01/2024,2024-05-01 06:48:00,2024-05-02 02:04:00,GOI,MAA,150.0,172,97,-53,75,15,30,45,60,17,10,5,7,33,19,11,14,54,31,14,23,70,40,20,30,"{'F': 9, 'P': 6}","{'C': 12, 'J': 9, 'Z': 9}","{'Q': 14, 'R': 9, 'S': 4, 'T': 4, 'H': 9, 'M': 4}","{'Y': 4, 'A': 4, 'B': 2, 'D': 2, 'E': 2, 'G': 4, 'I': 2, 'K': 4, 'L': 2, 'N': 2, 'O': 2, 'U': 4, 'V': 2, 'W': 2, 'X': 2}"
INV-ZZ-4019704,SCH-ZZ-2729891,ZZ,ZZ20240502GOIMAA4516.0,4516.0,Airbus A320-200,05/02/2024,2024-05-02 06:48:00,2024-05-03 02:04:00,GOI,MAA,150.0,165,95,-55,70,15,30,45,60,18,10,5,8,34,20,10,14,52,30,15,22,69,40,20,29,"{'F': 9, 'P': 6}","{'C': 12, 'J': 9, 'Z': 9}","{'Q': 14, 'R': 9, 'S': 4, 'T': 4, 'H': 9, 'M': 4}","{'Y': 4, 'A': 4, 'B': 2, 'D': 2, 'E': 2, 'G': 4, 'I': 2, 'K': 4, 'L': 2, 'N': 2, 'O': 2, 'U': 4, 'V': 2, 'W': 2, 'X': 2}"
INV-ZZ-5498701,SCH-ZZ-2729891,ZZ,ZZ20240505GOIMAA4516.0,4516.0,Airbus A320-200,05/05/2024,2024-05-05 06:48:00,2024-05-06 02:04:00,GOI,MAA,150.0,169,97,-53,72,15,30,45,60,18,10,5,8,35,20,10,15,53,30,15,23,71,41,19,30,"{'F': 9, 'P': 6}","{'C': 12, 'J': 9, 'Z': 9}","{'Q': 14, 'R': 9, 'S': 4, 'T': 4, 'H': 9, 'M': 4}","{'Y': 4, 'A': 4, 'B': 2, 'D': 2, 'E': 2, 'G': 4, 'I': 2, 'K': 4, 'L': 2, 'N': 2, 'O': 2, 'U': 4, 'V': 2, 'W': 2, 'X': 2}"
INV-ZZ-5327420,SCH-ZZ-2729891,ZZ,ZZ20240508GOIMAA4516.0,4516.0,Airbus A320-200,05/08/2024,2024-05-08 06:48:00,2024-05-09 02:04:00,GOI,MAA,150.0,170,99,-51,71,15,30,45,60,18,10,5,8,34,20,10,14,50,29,16,21,71,41,19,30,"{'F': 9, 'P': 6}","{'C': 12, 'J': 9, 'Z': 9}","{'Q': 14, 'R': 9, 'S': 4, 'T': 4, 'H': 9, 'M': 4}","{'Y': 4, 'A': 4, 'B': 2, 'D': 2, 'E': 2, 'G': 4, 'I': 2, 'K': 4, 'L': 2, 'N': 2, 'O': 2, 'U': 4, 'V': 2, 'W': 2, 'X': 2}"
INV-ZZ-5925991,SCH-ZZ-2729891,ZZ,ZZ20240509GOIMAA4516.0,4516.0,Airbus A320-200,05/09/2024,2024-05-09 06:48:00,2024-05-10 02:04:00,GOI,MAA,150.0,173,93,-57,80,15,30,45,60,18,10,5,8,35,19,11,16,52,28,17,24,68,37,23,31,"{'F': 9, 'P': 6}","{'C': 12, 'J': 9, 'Z': 9}","{'Q': 14, 'R': 9, 'S': 4, 'T': 4, 'H': 9, 'M': 4}","{'Y': 4, 'A': 4, 'B': 2, 'D': 2, 'E': 2, 'G': 4, 'I': 2, 'K': 4, 'L': 2, 'N': 2, 'O': 2, 'U': 4, 'V': 2, 'W': 2, 'X': 2}"
INV-ZZ-2049133,SCH-ZZ-2729891,ZZ,ZZ20240512GOIMAA4516.0,4516.0,Airbus A320-200,05/12/2024,2024-05-12 06:48:00,2024-05-13 02:04:00,GOI,MAA,150.0,174,93,-57,81,15,30,45,60,17,9,6,8,36,19,11,17,50,27,18,23,69,37,23,32,"{'F': 9, 'P': 6}","{'C': 12, 'J': 9, 'Z': 9}","{'Q': 14, 'R': 9, 'S': 4, 'T': 4, 'H': 9, 'M': 4}","{'Y': 4, 'A': 4, 'B': 2, 'D': 2, 'E': 2, 'G': 4, 'I': 2, 'K': 4, 'L': 2, 'N': 2, 'O': 2, 'U': 4, 'V': 2, 'W': 2, 'X': 2}"
INV-ZZ-5355793,SCH-ZZ-2729891,ZZ,ZZ20240515GOIMAA4516.0,4516.0,Airbus A320-200,05/15/2024,2024-05-15 06:48:00,2024-05-16 02:04:00,GOI,MAA,150.0,165,81,-69,84,15,30,45,60,17,8,7,9,36,18,12,18,52,26,19,26,68,33,27,35,"{'F': 9, 'P': 6}","{'C': 12, 'J': 9, 'Z': 9}","{'Q': 14, 'R': 9, 'S': 4, 'T': 4, 'H': 9, 'M': 4}","{'Y': 4, 'A': 4, 'B': 2, 'D': 2, 'E': 2, 'G': 4, 'I': 2, 'K': 4, 'L': 2, 'N': 2, 'O': 2, 'U': 4, 'V': 2, 'W': 2, 'X': 2}"
INV-ZZ-2151409,SCH-ZZ-2729891,ZZ,ZZ20240516GOIMAA4516.0,4516.0,Airbus A320-200,05/16/2024,2024-05-16 06:48:00,2024-05-17 02:04:00,GOI,MAA,150.0,165,79,-71,86,15,30,45,60,17,8,7,9,34,16,14,18,53,25,20,28,70,33,27,37,"{'F': 9, 'P': 6}","{'C': 12, 'J': 9, 'Z': 9}","{'Q': 14, 'R': 9, 'S': 4, 'T': 4, 'H': 9, 'M': 4}","{'Y': 4, 'A': 4, 'B': 2, 'D': 2, 'E': 2, 'G': 4, 'I': 2, 'K': 4, 'L': 2, 'N': 2, 'O': 2, 'U': 4, 'V': 2, 'W': 2, 'X': 2}"
INV-ZZ-2808210,SCH-ZZ-2729891,ZZ,ZZ20240519GOIMAA4516.0,4516.0,Airbus A320-200,05/19/2024,2024-05-19 06:48:00,2024-05-20 02:04:00,GOI,MAA,150.0,167,87,-63,80,15,30,45,60,18,9,6,9,36,19,11,17,50,26,19,24,71,37,23,34,"{'F': 9, 'P': 6}","{'C': 12, 'J': 9, 'Z': 9}","{'Q': 14, 'R': 9, 'S': 4, 'T': 4, 'H': 9, 'M': 4}","{'Y': 4, 'A': 4, 'B': 2, 'D': 2, 'E': 2, 'G': 4, 'I': 2, 'K': 4, 'L': 2, 'N': 2, 'O': 2, 'U': 4, 'V': 2, 'W': 2, 'X': 2}"
INV-ZZ-9223256,SCH-ZZ-5041804,ZZ,ZZ20240409HYDCJB2880.0,2880.0,ATR 72,04/09/2024,2024-04-09 23:47:00,2024-04-10 13:44:00,HYD,CJB,72.0,80,50,-22,30,7,14,21,28,8,5,2,3,17,11,3,6,24,15,6,9,32,20,8,12,"{'F': 4, 'P': 3}","{'C': 6, 'J': 4, 'Z': 4}","{'Q': 6, 'R': 4, 'S': 2, 'T': 2, 'H': 4, 'M': 2}","{'Y': 2, 'A': 2, 'B': 1, 'D': 1, 'E': 1, 'G': 2, 'I': 1, 'K': 2, 'L': 1, 'N': 1, 'O': 1, 'U': 2, 'V': 1, 'W': 1, 'X': 1}"
INV-ZZ-4205297,SCH-ZZ-5041804,ZZ,ZZ20240410HYDCJB2880.0,2880.0,ATR 72,04/10/2024,2024-04-10 23:47:00,2024-04-11 13:44:00,HYD,CJB,72.0,84,52,-20,32,7,14,21,28,8,5,2,3,16,10,4,6,25,16,5,9,33,20,8,13,"{'F': 4, 'P': 3}","{'C': 6, 'J': 4, 'Z': 4}","{'Q': 6, 'R': 4, 'S': 2, 'T': 2, 'H': 4, 'M': 2}","{'Y': 2, 'A': 2, 'B': 1, 'D': 1, 'E': 1, 'G': 2, 'I': 1, 'K': 2, 'L': 1, 'N': 1, 'O': 1, 'U': 2, 'V': 1, 'W': 1, 'X': 1}"
INV-ZZ-7294072,SCH-ZZ-5041804,ZZ,ZZ20240411HYDCJB2880.0,2880.0,ATR 72,04/11/2024,2024-04-11 23:47:00,2024-04-12 13:44:00,HYD,CJB,72.0,81,53,-19,28,7,14,21,28,8,5,2,3,16,10,4,6,25,16,5,9,32,21,7,11,"{'F': 4, 'P': 3}","{'C': 6, 'J': 4, 'Z': 4}","{'Q': 6, 'R': 4, 'S': 2, 'T': 2, 'H': 4, 'M': 2}","{'Y': 2, 'A': 2, 'B': 1, 'D': 1, 'E': 1, 'G': 2, 'I': 1, 'K': 2, 'L': 1, 'N': 1, 'O': 1, 'U': 2, 'V': 1, 'W': 1, 'X': 1}"
INV-ZZ-8631094,SCH-ZZ-5041804,ZZ,ZZ20240414HYDCJB2880.0,2880.0,ATR 72,04/14/2024,2024-04-14 23:47:00,2024-04-15 13:44:00,HYD,CJB,72.0,81,45,-27,36,7,14,21,28,8,4,3,4,17,10,4,7,24,13,8,11,33,18,10,15,"{'F': 4, 'P': 3}","{'C': 6, 'J': 4, 'Z': 4}","{'Q': 6, 'R': 4, 'S': 2, 'T': 2, 'H': 4, 'M': 2}","{'Y': 2, 'A': 2, 'B': 1, 'D': 1, 'E': 1, 'G': 2, 'I': 1, 'K': 2, 'L': 1, 'N': 1, 'O': 1, 'U': 2, 'V': 1, 'W': 1, 'X': 1}"
INV-ZZ-5724322,SCH-ZZ-5041804,ZZ,ZZ20240416HYDCJB2880.0,2880.0,ATR 72,04/16/2024,2024-04-16 23:47:00,2024-04-17 13:44:00,HYD,CJB,72.0,84,48,-24,36,7,14,21,28,8,5,2,3,15,9,5,6,23,13,8,10,34,19,9,15,"{'F': 4, 'P': 3}","{'C': 6, 'J': 4, 'Z': 4}","{'Q': 6, 'R': 4, 'S': 2, 'T': 2, 'H': 4, 'M': 2}","{'Y': 2, 'A': 2, 'B': 1, 'D': 1, 'E': 1, 'G': 2, 'I': 1, 'K': 2, 'L': 1, 'N': 1, 'O': 1, 'U': 2, 'V': 1, 'W': 1, 'X': 1}"
INV-ZZ-5777960,SCH-ZZ-5041804,ZZ,ZZ20240417HYDCJB2880.0,2880.0,ATR 72,04/17/2024,2024-04-17 23:47:00,2024-04-18 13:44:00,HYD,CJB,72.0,84,52,-20,32,7,14,21,28,8,5,2,3,17,10,4,7,25,15,6,10,33,20,8,13,"{'F': 4, 'P': 3}","{'C': 6, 'J': 4, 'Z': 4}","{'Q': 6, 'R': 4, 'S': 2, 'T': 2, 'H': 4, 'M': 2}","{'Y': 2, 'A': 2, 'B': 1, 'D': 1, 'E': 1, 'G': 2, 'I': 1, 'K': 2, 'L': 1, 'N': 1, 'O': 1, 'U': 2, 'V': 1, 'W': 1, 'X': 1}"
INV-ZZ-4743206,SCH-ZZ-5041804,ZZ,ZZ20240418HYDCJB2880.0,2880.0,ATR 72,04/18/2024,2024-04-18 23:47:00,2024-04-19 13:44:00,HYD,CJB,72.0,82,49,-23,33,7,14,21,28,8,5,2,3,16,10,4,6,25,15,6,10,33,20,8,13,"{'F': 4, 'P': 3}","{'C': 6, 'J': 4, 'Z': 4}","{'Q': 6, 'R': 4, 'S': 2, 'T': 2, 'H': 4, 'M': 2}","{'Y': 2, 'A': 2, 'B': 1, 'D': 1, 'E': 1, 'G': 2, 'I': 1, 'K': 2, 'L': 1, 'N': 1, 'O': 1, 'U': 2, 'V': 1, 'W': 1, 'X': 1}"
INV-ZZ-8827627,SCH-ZZ-5041804,ZZ,ZZ20240421HYDCJB2880.0,2880.0,ATR 72,04/21/2024,2024-04-21 23:47:00,2024-04-22 13:44:00,HYD,CJB,72.0,85,49,-23,36,7,14,21,28,8,5,2,3,16,9,5,7,24,14,7,10,31,18,10,13,"{'F': 4, 'P': 3}","{'C': 6, 'J': 4, 'Z': 4}","{'Q': 6, 'R': 4, 'S': 2, 'T': 2, 'H': 4, 'M': 2}","{'Y': 2, 'A': 2, 'B': 1, 'D': 1, 'E': 1, 'G': 2, 'I': 1, 'K': 2, 'L': 1, 'N': 1, 'O': 1, 'U': 2, 'V': 1, 'W': 1, 'X': 1}"
INV-ZZ-5034455,SCH-ZZ-5041804,ZZ,ZZ20240423HYDCJB2880.0,2880.0,ATR 72,04/23/2024,2024-04-23 23:47:00,2024-04-24 13:44:00,HYD,CJB,72.0,81,49,-23,32,7,14,21,28,8,5,2,3,16,10,4,6,25,15,6,10,32,19,9,13,"{'F': 4, 'P': 3}","{'C': 6, 'J': 4, 'Z': 4}","{'Q': 6, 'R': 4, 'S': 2, 'T': 2, 'H': 4, 'M': 2}","{'Y': 2, 'A': 2, 'B': 1, 'D': 1, 'E': 1, 'G': 2, 'I': 1, 'K': 2, 'L': 1, 'N': 1, 'O': 1, 'U': 2, 'V': 1, 'W': 1, 'X': 1}"
INV-ZZ-9425434,SCH-ZZ-5041804,ZZ,ZZ20240424HYDCJB2880.0,2880.0,ATR 72,04/24/2024,2024-04-24 23:47:00,2024-04-25 13:44:00,HYD,CJB,72.0,81,46,-26,35,7,14,21,28,8,5,2,3,17,10,4,7,24,14,7,10,31,18,10,13,"{'F': 4, 'P': 3}","{'C': 6, 'J': 4, 'Z': 4}","{'Q': 6, 'R': 4, 'S': 2, 'T': 2, 'H': 4, 'M': 2}","{'Y': 2, 'A': 2, 'B': 1, 'D': 1, 'E': 1, 'G': 2, 'I': 1, 'K': 2, 'L': 1, 'N': 1, 'O': 1, 'U': 2, 'V': 1, 'W': 1, 'X': 1}"
INV-ZZ-2198229,SCH-ZZ-5041804,ZZ,ZZ20240425HYDCJB2880.0,2880.0,ATR 72,04/25/2024,2024-04-25 23:47:00,2024-04-26 13:44:00,HYD,CJB,72.0,80,45,-27,35,7,14,21,28,8,5,2,3,16,9,5,7,24,14,7,10,32,18,10,14,"{'F': 4, 'P': 3}","{'C': 6, 'J': 4, 'Z': 4}","{'Q': 6, 'R': 4, 'S': 2, 'T': 2, 'H': 4, 'M': 2}","{'Y': 2, 'A': 2, 'B': 1, 'D': 1, 'E': 1, 'G': 2, 'I': 1, 'K': 2, 'L': 1, 'N': 1, 'O': 1, 'U': 2, 'V': 1, 'W': 1, 'X': 1}"
INV-ZZ-5848628,SCH-ZZ-5041804,ZZ,ZZ20240428HYDCJB2880.0,2880.0,ATR 72,04/28/2024,2024-04-28 23:47:00,2024-04-29 13:44:00,HYD,CJB,72.0,81,46,-26,35,7,14,21,28,8,5,2,3,16,9,5,7,24,14,7,10,33,19,9,14,"{'F': 4, 'P': 3}","{'C': 6, 'J': 4, 'Z': 4}","{'Q': 6, 'R': 4, 'S': 2, 'T': 2, 'H': 4, 'M': 2}","{'Y': 2, 'A': 2, 'B': 1, 'D': 1, 'E': 1, 'G': 2, 'I': 1, 'K': 2, 'L': 1, 'N': 1, 'O': 1, 'U': 2, 'V': 1, 'W': 1, 'X': 1}"
INV-ZZ-4967803,SCH-ZZ-5041804,ZZ,ZZ20240430HYDCJB2880.0,2880.0,ATR 72,04/30/2024,2024-04-30 23:47:00,2024-05-01 13:44:00,HYD,CJB,72.0,83,49,-23,34,7,14,21,28,8,5,2,3,17,10,4,7,24,14,7,10,31,18,10,13,"{'F': 4, 'P': 3}","{'C': 6, 'J': 4, 'Z': 4}","{'Q': 6, 'R': 4, 'S': 2, 'T': 2, 'H': 4, 'M': 2}","{'Y': 2, 'A': 2, 'B': 1, 'D': 1, 'E': 1, 'G': 2, 'I': 1, 'K': 2, 'L': 1, 'N': 1, 'O': 1, 'U': 2, 'V': 1, 'W': 1, 'X': 1}"
INV-ZZ-7652913,SCH-ZZ-5041804,ZZ,ZZ20240501HYDCJB2880.0,2880.0,ATR 72,05/01/2024,2024-05-01 23:47:00,2024-05-02 13:44:00,HYD,CJB,72.0,81,48,-24,33,7,14,21,28,8,5,2,3,16,9,5,7,24,14,7,10,32,19,9,13,"{'F': 4, 'P': 3}","{'C': 6, 'J': 4, 'Z': 4}","{'Q': 6, 'R': 4, 'S': 2, 'T': 2, 'H': 4, 'M': 2}","{'Y': 2, 'A': 2, 'B': 1, 'D': 1, 'E': 1, 'G': 2, 'I': 1, 'K': 2, 'L': 1, 'N': 1, 'O': 1, 'U': 2, 'V': 1, 'W': 1, 'X': 1}"
INV-ZZ-8066003,SCH-ZZ-5041804,ZZ,ZZ20240502HYDCJB2880.0,2880.0,ATR 72,05/02/2024,2024-05-02 23:47:00,2024-05-03 13:44:00,HYD,CJB,72.0,86,44,-28,42,7,14,21,28,8,4,3,4,15,8,6,7,24,12,9,12,32,16,12,16,"{'F': 4, 'P': 3}","{'C': 6, 'J': 4, 'Z': 4}","{'Q': 6, 'R': 4, 'S': 2, 'T': 2, 'H': 4, 'M': 2}","{'Y': 2, 'A': 2, 'B': 1, 'D': 1, 'E': 1, 'G': 2, 'I': 1, 'K': 2, 'L': 1, 'N': 1, 'O': 1, 'U': 2, 'V': 1, 'W': 1, 'X': 1}"
INV-ZZ-1789135,SCH-ZZ-5041804,ZZ,ZZ20240505HYDCJB2880.0,2880.0,ATR 72,05/05/2024,2024-05-05 23:47:00,2024-05-06 13:44:00,HYD,CJB,72.0,82,44,-28,38,7,14,21,28,8,4,3,4,16,9,5,7,24,13,8,11,33,18,10,15,"{'F': 4, 'P': 3}","{'C': 6, 'J': 4, 'Z': 4}","{'Q': 6, 'R': 4, 'S': 2, 'T': 2, 'H': 4, 'M': 2}","{'Y': 2, 'A': 2, 'B': 1, 'D': 1, 'E': 1, 'G': 2, 'I': 1, 'K': 2, 'L': 1, 'N': 1, 'O': 1, 'U': 2, 'V': 1, 'W': 1, 'X': 1}"
INV-ZZ-1828959,SCH-ZZ-5041804,ZZ,ZZ20240507HYDCJB2880.0,2880.0,ATR 72,05/07/2024,2024-05-07 23:47:00,2024-05-08 13:44:00,HYD,CJB,72.0,82,47,-25,35,7,14,21,28,8,5,2,3,16,9,5,7,24,14,7,10,31,18,10,13,"{'F': 4, 'P': 3}","{'C': 6, 'J': 4, 'Z': 4}","{'Q': 6, 'R': 4, 'S': 2, 'T': 2, 'H': 4, 'M': 2}","{'Y': 2, 'A': 2, 'B': 1, 'D': 1, 'E': 1, 'G': 2, 'I': 1, 'K': 2, 'L': 1, 'N': 1, 'O': 1, 'U': 2, 'V': 1, 'W': 1, 'X': 1}"
INV-ZZ-6466732,SCH-ZZ-5041804,ZZ,ZZ20240508HYDCJB2880.0,2880.0,ATR 72,05/08/2024,2024-05-08 23:47:00,2024-05-09 13:44:00,HYD,CJB,72.0,79,42,-30,36,7,14,21,28,8,4,3,4,16,9,5,7,25,13,8,12,33,18,10,15,"{'F': 4, 'P': 3}","{'C': 6, 'J': 4, 'Z': 4}","{'Q': 6, 'R': 4, 'S': 2, 'T': 2, 'H': 4, 'M': 2}","{'Y': 2, 'A': 2, 'B': 1, 'D': 1, 'E': 1, 'G': 2, 'I': 1, 'K': 2, 'L': 1, 'N': 1, 'O': 1, 'U': 2, 'V': 1, 'W': 1, 'X': 1}"
INV-ZZ-6796416,SCH-ZZ-5041804,ZZ,ZZ20240509HYDCJB2880.0,2880.0,ATR 72,05/09/2024,2024-05-09 23:47:00,2024-05-10 13:44:00,HYD,CJB,72.0,81,44,-28,37,7,14,21,28,8,4,3,4,16,9,5,7,24,13,8,11,31,17,11,14,"{'F': 4, 'P': 3}","{'C': 6, 'J': 4, 'Z': 4}","{'Q': 6, 'R': 4, 'S': 2, 'T': 2, 'H': 4, 'M': 2}","{'Y': 2, 'A': 2, 'B': 1, 'D': 1, 'E': 1, 'G': 2, 'I': 1, 'K': 2, 'L': 1, 'N': 1, 'O': 1, 'U': 2, 'V': 1, 'W': 1, 'X': 1}"
INV-ZZ-4536008,SCH-ZZ-5041804,ZZ,ZZ20240512HYDCJB2880.0,2880.0,ATR 72,05/12/2024,2024-05-12 23:47:00,2024-05-13 13:44:00,HYD,CJB,72.0,81,41,-31,40,7,14,21,28,8,4,3,4,16,8,6,8,24,12,9,12,32,16,12,16,"{'F': 4, 'P': 3}","{'C': 6, 'J': 4, 'Z': 4}","{'Q': 6, 'R': 4, 'S': 2, 'T': 2, 'H': 4, 'M': 2}","{'Y': 2, 'A': 2, 'B': 1, 'D': 1, 'E': 1, 'G': 2, 'I': 1, 'K': 2, 'L': 1, 'N': 1, 'O': 1, 'U': 2, 'V': 1, 'W': 1, 'X': 1}"
INV-ZZ-1630729,SCH-ZZ-5041804,ZZ,ZZ20240514HYDCJB2880.0,2880.0,ATR 72,05/14/2024,2024-05-14 23:47:00,2024-05-15 13:44:00,HYD,CJB,72.0,81,44,-28,37,7,14,21,28,8,4,3,4,17,9,5,8,24,13,8,11,32,17,11,15,"{'F': 4, 'P': 3}","{'C': 6, 'J': 4, 'Z': 4}","{'Q': 6, 'R': 4, 'S': 2, 'T': 2, 'H': 4, 'M': 2}","{'Y': 2, 'A': 2, 'B': 1, 'D': 1, 'E': 1, 'G': 2, 'I': 1, 'K': 2, 'L': 1, 'N': 1, 'O': 1, 'U': 2, 'V': 1, 'W': 1, 'X': 1}"
INV-ZZ-5769726,SCH-ZZ-5041804,ZZ,ZZ20240515HYDCJB2880.0,2880.0,ATR 72,05/15/2024,2024-05-15 23:47:00,2024-05-16 13:44:00,HYD,CJB,72.0,81,44,-28,36,7,14,21,28,8,4,3,4,16,9,5,7,25,14,7,11,33,18,10,15,"{'F': 4, 'P': 3}","{'C': 6, 'J': 4, 'Z': 4}","{'Q': 6, 'R': 4, 'S': 2, 'T': 2, 'H': 4, 'M': 2}","{'Y': 2, 'A': 2, 'B': 1, 'D': 1, 'E': 1, 'G': 2, 'I': 1, 'K': 2, 'L': 1, 'N': 1, 'O': 1, 'U': 2, 'V': 1, 'W': 1, 'X': 1}"
INV-ZZ-1798875,SCH-ZZ-5041804,ZZ,ZZ20240516HYDCJB2880.0,2880.0,ATR 72,05/16/2024,2024-05-16 23:47:00,2024-05-17 13:44:00,HYD,CJB,72.0,83,43,-29,40,7,14,21,28,8,4,3,4,16,8,6,8,24,12,9,12,32,17,11,15,"{'F': 4, 'P': 3}","{'C': 6, 'J': 4, 'Z': 4}","{'Q': 6, 'R': 4, 'S': 2, 'T': 2, 'H': 4, 'M': 2}","{'Y': 2, 'A': 2, 'B': 1, 'D': 1, 'E': 1, 'G': 2, 'I': 1, 'K': 2, 'L': 1, 'N': 1, 'O': 1, 'U': 2, 'V': 1, 'W': 1, 'X': 1}"
INV-ZZ-8814838,SCH-ZZ-5041804,ZZ,ZZ20240519HYDCJB2880.0,2880.0,ATR 72,05/19/2024,2024-05-19 23:47:00,2024-05-20 13:44:00,HYD,CJB,72.0,82,42,-30,40,7,14,21,28,8,4,3,4,16,8,6,8,24,12,9,12,33,17,11,16,"{'F': 4, 'P': 3}","{'C': 6, 'J': 4, 'Z': 4}","{'Q': 6, 'R': 4, 'S': 2, 'T': 2, 'H': 4, 'M': 2}","{'Y': 2, 'A': 2, 'B': 1, 'D': 1, 'E': 1, 'G': 2, 'I': 1, 'K': 2, 'L': 1, 'N': 1, 'O': 1, 'U': 2, 'V': 1, 'W': 1, 'X': 1}"
INV-ZZ-7334199,SCH-ZZ-5041804,ZZ,ZZ20240521HYDCJB2880.0,2880.0,ATR 72,05/21/2024,2024-05-21 23:47:00,2024-05-22 13:44:00,HYD,CJB,72.0,80,39,-33,41,7,14,21,28,8,4,3,4,16,8,6,8,24,12,9,12,33,16,12,17,"{'F': 4, 'P': 3}","{'C': 6, 'J': 4, 'Z': 4}","{'Q': 6, 'R': 4, 'S': 2, 'T': 2, 'H': 4, 'M': 2}","{'Y': 2, 'A': 2, 'B': 1, 'D': 1, 'E': 1, 'G': 2, 'I': 1, 'K': 2, 'L': 1, 'N': 1, 'O': 1, 'U': 2, 'V': 1, 'W': 1, 'X': 1}"
INV-ZZ-8882483,SCH-ZZ-5041804,ZZ,ZZ20240522HYDCJB2880.0,2880.0,ATR 72,05/22/2024,2024-05-22 23:47:00,2024-05-23 13:44:00,HYD,CJB,72.0,80,39,-33,41,7,14,21,28,8,4,3,4,16,8,6,8,24,12,9,12,32,15,13,17,"{'F': 4, 'P': 3}","{'C': 6, 'J': 4, 'Z': 4}","{'Q': 6, 'R': 4, 'S': 2, 'T': 2, 'H': 4, 'M': 2}","{'Y': 2, 'A': 2, 'B': 1, 'D': 1, 'E': 1, 'G': 2, 'I': 1, 'K': 2, 'L': 1, 'N': 1, 'O': 1, 'U': 2, 'V': 1, 'W': 1, 'X': 1}"
INV-ZZ-3865847,SCH-ZZ-5041804,ZZ,ZZ20240523HYDCJB2880.0,2880.0,ATR 72,05/23/2024,2024-05-23 23:47:00,2024-05-24 13:44:00,HYD,CJB,72.0,81,38,-34,43,7,14,21,28,8,4,3,4,17,8,6,9,24,11,10,13,33,15,13,18,"{'F': 4, 'P': 3}","{'C': 6, 'J': 4, 'Z': 4}","{'Q': 6, 'R': 4, 'S': 2, 'T': 2, 'H': 4, 'M': 2}","{'Y': 2, 'A': 2, 'B': 1, 'D': 1, 'E': 1, 'G': 2, 'I': 1, 'K': 2, 'L': 1, 'N': 1, 'O': 1, 'U': 2, 'V': 1, 'W': 1, 'X': 1}"
INV-ZZ-3121065,SCH-ZZ-5840327,ZZ,ZZ20240418IDRHYD2795.0,2795.0,Airbus A321 Neo,04/18/2024,2024-04-18 14:29:00,2024-04-19 02:10:00,IDR,HYD,220.0,244,147,-73,97,22,44,66,88,24,15,7,9,50,30,14,20,78,47,19,31,102,62,26,40,"{'F': 13, 'P': 9}","{'C': 18, 'J': 13, 'Z': 13}","{'Q': 20, 'R': 13, 'S': 7, 'T': 7, 'H': 13, 'M': 7}","{'Y': 7, 'A': 7, 'B': 3, 'D': 3, 'E': 3, 'G': 7, 'I': 3, 'K': 7, 'L': 3, 'N': 3, 'O': 3, 'U': 7, 'V': 3, 'W': 3, 'X': 3}"
INV-ZZ-9258559,SCH-ZZ-5840327,ZZ,ZZ20240421IDRHYD2795.0,2795.0,Airbus A321 Neo,04/21/2024,2024-04-21 14:29:00,2024-04-22 02:10:00,IDR,HYD,220.0,244,132,-88,112,22,44,66,88,25,14,8,11,49,27,17,22,75,41,25,34,104,56,32,48,"{'F': 13, 'P': 9}","{'C': 18, 'J': 13, 'Z': 13}","{'Q': 20, 'R': 13, 'S': 7, 'T': 7, 'H': 13, 'M': 7}","{'Y': 7, 'A': 7, 'B': 3, 'D': 3, 'E': 3, 'G': 7, 'I': 3, 'K': 7, 'L': 3, 'N': 3, 'O': 3, 'U': 7, 'V': 3, 'W': 3, 'X': 3}"
INV-ZZ-9746570,SCH-ZZ-5840327,ZZ,ZZ20240423IDRHYD2795.0,2795.0,Airbus A321 Neo,04/23/2024,2024-04-23 14:29:00,2024-04-24 02:10:00,IDR,HYD,220.0,257,139,-81,118,22,44,66,88,26,14,8,12,50,27,17,23,79,43,23,36,105,57,31,48,"{'F': 13, 'P': 9}","{'C': 18, 'J': 13, 'Z': 13}","{'Q': 20, 'R': 13, 'S': 7, 'T': 7, 'H': 13, 'M': 7}","{'Y': 7, 'A': 7, 'B': 3, 'D': 3, 'E': 3, 'G': 7, 'I': 3, 'K': 7, 'L': 3, 'N': 3, 'O': 3, 'U': 7, 'V': 3, 'W': 3, 'X': 3}"
INV-ZZ-7612917,SCH-ZZ-5840327,ZZ,ZZ20240425IDRHYD2795.0,2795.0,Airbus A321 Neo,04/25/2024,2024-04-25 14:29:00,2024-04-26 02:10:00,IDR,HYD,220.0,260,161,-59,99,22,44,66,88,26,16,6,10,50,31,13,19,73,45,21,28,101,62,26,39,"{'F': 13, 'P': 9}","{'C': 18, 'J': 13, 'Z': 13}","{'Q': 20, 'R': 13, 'S': 7, 'T': 7, 'H': 13, 'M': 7}","{'Y': 7, 'A': 7, 'B': 3, 'D': 3, 'E': 3, 'G': 7, 'I': 3, 'K': 7, 'L': 3, 'N': 3, 'O': 3, 'U': 7, 'V': 3, 'W': 3, 'X': 3}"
INV-ZZ-6970551,SCH-ZZ-5840327,ZZ,ZZ20240428IDRHYD2795.0,2795.0,Airbus A321 Neo,04/28/2024,2024-04-28 14:29:00,2024-04-29 02:10:00,IDR,HYD,220.0,242,138,-82,104,22,44,66,88,25,14,8,11,52,30,14,22,74,42,24,32,103,59,29,44,"{'F': 13, 'P': 9}","{'C': 18, 'J': 13, 'Z': 13}","{'Q': 20, 'R': 13, 'S': 7, 'T': 7, 'H': 13, 'M': 7}","{'Y': 7, 'A': 7, 'B': 3, 'D': 3, 'E': 3, 'G': 7, 'I': 3, 'K': 7, 'L': 3, 'N': 3, 'O': 3, 'U': 7, 'V': 3, 'W': 3, 'X': 3}"
INV-ZZ-3076605,SCH-ZZ-5840327,ZZ,ZZ20240430IDRHYD2795.0,2795.0,Airbus A321 Neo,04/30/2024,2024-04-30 14:29:00,2024-05-01 02:10:00,IDR,HYD,220.0,261,152,-68,109,22,44,66,88,25,15,7,10,51,30,14,21,79,46,20,33,103,60,28,43,"{'F': 13, 'P': 9}","{'C': 18, 'J': 13, 'Z': 13}","{'Q': 20, 'R': 13, 'S': 7, 'T': 7, 'H': 13, 'M': 7}","{'Y': 7, 'A': 7, 'B': 3, 'D': 3, 'E': 3, 'G': 7, 'I': 3, 'K': 7, 'L': 3, 'N': 3, 'O': 3, 'U': 7, 'V': 3, 'W': 3, 'X': 3}"
INV-ZZ-2096688,SCH-ZZ-5840327,ZZ,ZZ20240502IDRHYD2795.0,2795.0,Airbus A321 Neo,05/02/2024,2024-05-02 14:29:00,2024-05-03 02:10:00,IDR,HYD,220.0,246,136,-84,110,22,44,66,88,26,14,8,12,51,28,16,23,73,40,26,33,101,56,32,45,"{'F': 13, 'P': 9}","{'C': 18, 'J': 13, 'Z': 13}","{'Q': 20, 'R': 13, 'S': 7, 'T': 7, 'H': 13, 'M': 7}","{'Y': 7, 'A': 7, 'B': 3, 'D': 3, 'E': 3, 'G': 7, 'I': 3, 'K': 7, 'L': 3, 'N': 3, 'O': 3, 'U': 7, 'V': 3, 'W': 3, 'X': 3}"
INV-ZZ-5241815,SCH-ZZ-5840327,ZZ,ZZ20240505IDRHYD2795.0,2795.0,Airbus A321 Neo,05/05/2024,2024-05-05 14:29:00,2024-05-06 02:10:00,IDR,HYD,220.0,252,139,-81,113,22,44,66,88,26,14,8,12,52,29,15,23,76,42,24,34,103,57,31,46,"{'F': 13, 'P': 9}","{'C': 18, 'J': 13, 'Z': 13}","{'Q': 20, 'R': 13, 'S': 7, 'T': 7, 'H': 13, 'M': 7}","{'Y': 7, 'A': 7, 'B': 3, 'D': 3, 'E': 3, 'G': 7, 'I': 3, 'K': 7, 'L': 3, 'N': 3, 'O': 3, 'U': 7, 'V': 3, 'W': 3, 'X': 3}"
INV-ZZ-9332910,SCH-ZZ-5840327,ZZ,ZZ20240507IDRHYD2795.0,2795.0,Airbus A321 Neo,05/07/2024,2024-05-07 14:29:00,2024-05-08 02:10:00,IDR,HYD,220.0,244,124,-96,120,22,44,66,88,24,12,10,12,49,25,19,24,74,38,28,36,104,53,35,51,"{'F': 13, 'P': 9}","{'C': 18, 'J': 13, 'Z': 13}","{'Q': 20, 'R': 13, 'S': 7, 'T': 7, 'H': 13, 'M': 7}","{'Y': 7, 'A': 7, 'B': 3, 'D': 3, 'E': 3, 'G': 7, 'I': 3, 'K': 7, 'L': 3, 'N': 3, 'O': 3, 'U': 7, 'V': 3, 'W': 3, 'X': 3}"
INV-ZZ-4899608,SCH-ZZ-5840327,ZZ,ZZ20240509IDRHYD2795.0,2795.0,Airbus A321 Neo,05/09/2024,2024-05-09 14:29:00,2024-05-10 02:10:00,IDR,HYD,220.0,263,131,-89,132,22,44,66,88,25,12,10,13,52,26,18,26,76,38,28,38,100,50,38,50,"{'F': 13, 'P': 9}","{'C': 18, 'J': 13, 'Z': 13}","{'Q': 20, 'R': 13, 'S': 7, 'T': 7, 'H': 13, 'M': 7}","{'Y': 7, 'A': 7, 'B': 3, 'D': 3, 'E': 3, 'G': 7, 'I': 3, 'K': 7, 'L': 3, 'N': 3, 'O': 3, 'U': 7, 'V': 3, 'W': 3, 'X': 3}"
INV-ZZ-5424903,SCH-ZZ-5840327,ZZ,ZZ20240512IDRHYD2795.0,2795.0,Airbus A321 Neo,05/12/2024,2024-05-12 14:29:00,2024-05-13 02:10:00,IDR,HYD,220.0,261,128,-92,133,22,44,66,88,26,13,9,13,49,24,20,25,76,37,29,39,103,51,37,52,"{'F': 13, 'P': 9}","{'C': 18, 'J': 13, 'Z': 13}","{'Q': 20, 'R': 13, 'S': 7, 'T': 7, 'H': 13, 'M': 7}","{'Y': 7, 'A': 7, 'B': 3, 'D': 3, 'E': 3, 'G': 7, 'I': 3, 'K': 7, 'L': 3, 'N': 3, 'O': 3, 'U': 7, 'V': 3, 'W': 3, 'X': 3}"
INV-ZZ-9171020,SCH-ZZ-5840327,ZZ,ZZ20240514IDRHYD2795.0,2795.0,Airbus A321 Neo,05/14/2024,2024-05-14 14:29:00,2024-05-15 02:10:00,IDR,HYD,220.0,252,129,-91,123,22,44,66,88,25,13,9,12,50,26,18,24,78,40,26,38,99,51,37,48,"{'F': 13, 'P': 9}","{'C': 18, 'J': 13, 'Z': 13}","{'Q': 20, 'R': 13, 'S': 7, 'T': 7, 'H': 13, 'M': 7}","{'Y': 7, 'A': 7, 'B': 3, 'D': 3, 'E': 3, 'G': 7, 'I': 3, 'K': 7, 'L': 3, 'N': 3, 'O': 3, 'U': 7, 'V': 3, 'W': 3, 'X': 3}"
INV-ZZ-7411820,SCH-ZZ-5840327,ZZ,ZZ20240516IDRHYD2795.0,2795.0,Airbus A321 Neo,05/16/2024,2024-05-16 14:29:00,2024-05-17 02:10:00,IDR,HYD,220.0,257,136,-84,121,22,44,66,88,26,14,8,12,51,27,17,24,78,41,25,37,98,52,36,46,"{'F': 13, 'P': 9}","{'C': 18, 'J': 13, 'Z': 13}","{'Q': 20, 'R': 13, 'S': 7, 'T': 7, 'H': 13, 'M': 7}","{'Y': 7, 'A': 7, 'B': 3, 'D': 3, 'E': 3, 'G': 7, 'I': 3, 'K': 7, 'L': 3, 'N': 3, 'O': 3, 'U': 7, 'V': 3, 'W': 3, 'X': 3}"
INV-ZZ-6824262,SCH-ZZ-5840327,ZZ,ZZ20240519IDRHYD2795.0,2795.0,Airbus A321 Neo,05/19/2024,2024-05-19 14:29:00,2024-05-20 02:10:00,IDR,HYD,220.0,259,140,-80,119,22,44,66,88,24,13,9,11,52,28,16,24,79,43,23,36,101,54,34,47,"{'F': 13, 'P': 9}","{'C': 18, 'J': 13, 'Z': 13}","{'Q': 20, 'R': 13, 'S': 7, 'T': 7, 'H': 13, 'M': 7}","{'Y': 7, 'A': 7, 'B': 3, 'D': 3, 'E': 3, 'G': 7, 'I': 3, 'K': 7, 'L': 3, 'N': 3, 'O': 3, 'U': 7, 'V': 3, 'W': 3, 'X': 3}"
INV-ZZ-3531803,SCH-ZZ-5840327,ZZ,ZZ20240521IDRHYD2795.0,2795.0,Airbus A321 Neo,05/21/2024,2024-05-21 14:29:00,2024-05-22 02:10:00,IDR,HYD,220.0,261,142,-78,119,22,44,66,88,26,14,8,12,49,27,17,22,77,42,24,35,101,55,33,46,"{'F': 13, 'P': 9}","{'C': 18, 'J': 13, 'Z': 13}","{'Q': 20, 'R': 13, 'S': 7, 'T': 7, 'H': 13, 'M': 7}","{'Y': 7, 'A': 7, 'B': 3, 'D': 3, 'E': 3, 'G': 7, 'I': 3, 'K': 7, 'L': 3, 'N': 3, 'O': 3, 'U': 7, 'V': 3, 'W': 3, 'X': 3}"
INV-ZZ-1082401,SCH-ZZ-5840327,ZZ,ZZ20240523IDRHYD2795.0,2795.0,Airbus A321 Neo,05/23/2024,2024-05-23 14:29:00,2024-05-24 02:10:00,IDR,HYD,220.0,253,130,-90,123,22,44,66,88,25,13,9,12,50,26,18,24,78,40,26,38,101,52,36,49,"{'F': 13, 'P': 9}","{'C': 18, 'J': 13, 'Z': 13}","{'Q': 20, 'R': 13, 'S': 7, 'T': 7, 'H': 13, 'M': 7}","{'Y': 7, 'A': 7, 'B': 3, 'D': 3, 'E': 3, 'G': 7, 'I': 3, 'K': 7, 'L': 3, 'N': 3, 'O': 3, 'U': 7, 'V': 3, 'W': 3, 'X': 3}"
INV-ZZ-8529993,SCH-ZZ-5840327,ZZ,ZZ20240526IDRHYD2795.0,2795.0,Airbus A321 Neo,05/26/2024,2024-05-26 14:29:00,2024-05-27 02:10:00,IDR,HYD,220.0,242,128,-92,114,22,44,66,88,24,13,9,11,51,27,17,24,79,42,24,37,103,54,34,49,"{'F': 13, 'P': 9}","{'C': 18, 'J': 13, 'Z': 13}","{'Q': 20, 'R': 13, 'S': 7, 'T': 7, 'H': 13, 'M': 7}","{'Y': 7, 'A': 7, 'B': 3, 'D': 3, 'E': 3, 'G': 7, 'I': 3, 'K': 7, 'L': 3, 'N': 3, 'O': 3, 'U': 7, 'V': 3, 'W': 3, 'X': 3}"
INV-ZZ-7865049,SCH-ZZ-5840327,ZZ,ZZ20240528IDRHYD2795.0,2795.0,Airbus A321 Neo,05/28/2024,2024-05-28 14:29:00,2024-05-29 02:10:00,IDR,HYD,220.0,262,135,-85,127,22,44,66,88,24,12,10,12,49,25,19,24,73,38,28,35,102,53,35,49,"{'F': 13, 'P': 9}","{'C': 18, 'J': 13, 'Z': 13}","{'Q': 20, 'R': 13, 'S': 7, 'T': 7, 'H': 13, 'M': 7}","{'Y': 7, 'A': 7, 'B': 3, 'D': 3, 'E': 3, 'G': 7, 'I': 3, 'K': 7, 'L': 3, 'N': 3, 'O': 3, 'U': 7, 'V': 3, 'W': 3, 'X': 3}"
INV-ZZ-7305307,SCH-ZZ-5840327,ZZ,ZZ20240530IDRHYD2795.0,2795.0,Airbus A321 Neo,05/30/2024,2024-05-30 14:29:00,2024-05-31 02:10:00,IDR,HYD,220.0,246,121,-99,125,22,44,66,88,25,12,10,13,52,26,18,26,73,36,30,37,102,50,38,52,"{'F': 13, 'P': 9}","{'C': 18, 'J': 13, 'Z': 13}","{'Q': 20, 'R': 13, 'S': 7, 'T': 7, 'H': 13, 'M': 7}","{'Y': 7, 'A': 7, 'B': 3, 'D': 3, 'E': 3, 'G': 7, 'I': 3, 'K': 7, 'L': 3, 'N': 3, 'O': 3, 'U': 7, 'V': 3, 'W': 3, 'X': 3}"
INV-ZZ-6391873,SCH-ZZ-5840327,ZZ,ZZ20240602IDRHYD2795.0,2795.0,Airbus A321 Neo,06/02/2024,2024-06-02 14:29:00,2024-06-03 02:10:00,IDR,HYD,220.0,249,128,-92,121,22,44,66,88,26,13,9,13,49,25,19,24,75,38,28,37,102,52,36,50,"{'F': 13, 'P': 9}","{'C': 18, 'J': 13, 'Z': 13}","{'Q': 20, 'R': 13, 'S': 7, 'T': 7, 'H': 13, 'M': 7}","{'Y': 7, 'A': 7, 'B': 3, 'D': 3, 'E': 3, 'G': 7, 'I': 3, 'K': 7, 'L': 3, 'N': 3, 'O': 3, 'U': 7, 'V': 3, 'W': 3, 'X': 3}"
INV-ZZ-2357403,SCH-ZZ-4703145,ZZ,ZZ20240503BBIBLR2099.0,2099.0,Boeing 787,05/03/2024,2024-05-03 11:35:00,2024-05-03 20:31:00,BBI,BLR,270.0,308,158,-112,150,27,54,81,108,31,16,11,15,61,31,23,30,93,48,33,45,125,64,44,61,"{'F': 16, 'P': 11}","{'C': 22, 'J': 16, 'Z': 16}","{'Q': 24, 'R': 16, 'S': 8, 'T': 8, 'H': 16, 'M': 8}","{'Y': 8, 'A': 8, 'B': 4, 'D': 4, 'E': 4, 'G': 8, 'I': 4, 'K': 8, 'L': 4, 'N': 4, 'O': 4, 'U': 8, 'V': 4, 'W': 4, 'X': 4}"
INV-ZZ-1723315,SCH-ZZ-4703145,ZZ,ZZ20240504BBIBLR2099.0,2099.0,Boeing 787,05/04/2024,2024-05-04 11:35:00,2024-05-04 20:31:00,BBI,BLR,270.0,318,165,-105,153,27,54,81,108,32,17,10,15,60,31,23,29,94,49,32,45,129,67,41,62,"{'F': 16, 'P': 11}","{'C': 22, 'J': 16, 'Z': 16}","{'Q': 24, 'R': 16, 'S': 8, 'T': 8, 'H': 16, 'M': 8}","{'Y': 8, 'A': 8, 'B': 4, 'D': 4, 'E': 4, 'G': 8, 'I': 4, 'K': 8, 'L': 4, 'N': 4, 'O': 4, 'U': 8, 'V': 4, 'W': 4, 'X': 4}"
INV-ZZ-1812465,SCH-ZZ-4703145,ZZ,ZZ20240510BBIBLR2099.0,2099.0,Boeing 787,05/10/2024,2024-05-10 11:35:00,2024-05-10 20:31:00,BBI,BLR,270.0,315,168,-102,147,27,54,81,108,30,16,11,14,61,33,21,28,97,52,29,45,123,66,42,57,"{'F': 16, 'P': 11}","{'C': 22, 'J': 16, 'Z': 16}","{'Q': 24, 'R': 16, 'S': 8, 'T': 8, 'H': 16, 'M': 8}","{'Y': 8, 'A': 8, 'B': 4, 'D': 4, 'E': 4, 'G': 8, 'I': 4, 'K': 8, 'L': 4, 'N': 4, 'O': 4, 'U': 8, 'V': 4, 'W': 4, 'X': 4}"
INV-ZZ-4966564,SCH-ZZ-4703145,ZZ,ZZ20240511BBIBLR2099.0,2099.0,Boeing 787,05/11/2024,2024-05-11 11:35:00,2024-05-11 20:31:00,BBI,BLR,270.0,298,153,-117,145,27,54,81,108,32,16,11,16,65,33,21,32,96,49,32,47,124,63,45,61,"{'F': 16, 'P': 11}","{'C': 22, 'J': 16, 'Z': 16}","{'Q': 24, 'R': 16, 'S': 8, 'T': 8, 'H': 16, 'M': 8}","{'Y': 8, 'A': 8, 'B': 4, 'D': 4, 'E': 4, 'G': 8, 'I': 4, 'K': 8, 'L': 4, 'N': 4, 'O': 4, 'U': 8, 'V': 4, 'W': 4, 'X': 4}"
INV-ZZ-2707744,SCH-ZZ-4703145,ZZ,ZZ20240517BBIBLR2099.0,2099.0,Boeing 787,05/17/2024,2024-05-17 11:35:00,2024-05-17 20:31:00,BBI,BLR,270.0,314,172,-98,142,27,54,81,108,30,16,11,14,62,34,20,28,96,52,29,44,120,66,42,54,"{'F': 16, 'P': 11}","{'C': 22, 'J': 16, 'Z': 16}","{'Q': 24, 'R': 16, 'S': 8, 'T': 8, 'H': 16, 'M': 8}","{'Y': 8, 'A': 8, 'B': 4, 'D': 4, 'E': 4, 'G': 8, 'I': 4, 'K': 8, 'L': 4, 'N': 4, 'O': 4, 'U': 8, 'V': 4, 'W': 4, 'X': 4}"
INV-ZZ-3357389,SCH-ZZ-4703145,ZZ,ZZ20240518BBIBLR2099.0,2099.0,Boeing 787,05/18/2024,2024-05-18 11:35:00,2024-05-18 20:31:00,BBI,BLR,270.0,321,162,-108,159,27,54,81,108,32,16,11,16,59,30,24,29,91,46,35,45,122,61,47,61,"{'F': 16, 'P': 11}","{'C': 22, 'J': 16, 'Z': 16}","{'Q': 24, 'R': 16, 'S': 8, 'T': 8, 'H': 16, 'M': 8}","{'Y': 8, 'A': 8, 'B': 4, 'D': 4, 'E': 4, 'G': 8, 'I': 4, 'K': 8, 'L': 4, 'N': 4, 'O': 4, 'U': 8, 'V': 4, 'W': 4, 'X': 4}"
INV-ZZ-5247959,SCH-ZZ-4703145,ZZ,ZZ20240524BBIBLR2099.0,2099.0,Boeing 787,05/24/2024,2024-05-24 11:35:00,2024-05-24 20:31:00,BBI,BLR,270.0,308,143,-127,165,27,54,81,108,32,15,12,17,64,30,24,34,95,44,37,51,128,59,49,69,"{'F': 16, 'P': 11}","{'C': 22, 'J': 16, 'Z': 16}","{'Q': 24, 'R': 16, 'S': 8, 'T': 8, 'H': 16, 'M': 8}","{'Y': 8, 'A': 8, 'B': 4, 'D': 4, 'E': 4, 'G': 8, 'I': 4, 'K': 8, 'L': 4, 'N': 4, 'O': 4, 'U': 8, 'V': 4, 'W': 4, 'X': 4}"
INV-ZZ-2303070,SCH-ZZ-4703145,ZZ,ZZ20240525BBIBLR2099.0,2099.0,Boeing 787,05/25/2024,2024-05-25 11:35:00,2024-05-25 20:31:00,BBI,BLR,270.0,313,148,-122,165,27,54,81,108,32,15,12,17,62,29,25,33,94,45,36,49,122,58,50,64,"{'F': 16, 'P': 11}","{'C': 22, 'J': 16, 'Z': 16}","{'Q': 24, 'R': 16, 'S': 8, 'T': 8, 'H': 16, 'M': 8}","{'Y': 8, 'A': 8, 'B': 4, 'D': 4, 'E': 4, 'G': 8, 'I': 4, 'K': 8, 'L': 4, 'N': 4, 'O': 4, 'U': 8, 'V': 4, 'W': 4, 'X': 4}"
INV-ZZ-9658213,SCH-ZZ-4703145,ZZ,ZZ20240531BBIBLR2099.0,2099.0,Boeing 787,05/31/2024,2024-05-31 11:35:00,2024-05-31 20:31:00,BBI,BLR,270.0,300,145,-125,155,27,54,81,108,31,15,12,16,61,30,24,31,97,47,34,50,121,59,49,62,"{'F': 16, 'P': 11}","{'C': 22, 'J': 16, 'Z': 16}","{'Q': 24, 'R': 16, 'S': 8, 'T': 8, 'H': 16, 'M': 8}","{'Y': 8, 'A': 8, 'B': 4, 'D': 4, 'E': 4, 'G': 8, 'I': 4, 'K': 8, 'L': 4, 'N': 4, 'O': 4, 'U': 8, 'V': 4, 'W': 4, 'X': 4}"
INV-ZZ-2395610,SCH-ZZ-4703145,ZZ,ZZ20240601BBIBLR2099.0,2099.0,Boeing 787,06/01/2024,2024-06-01 11:35:00,2024-06-01 20:31:00,BBI,BLR,270.0,315,151,-119,164,27,54,81,108,30,14,13,16,62,30,24,32,90,43,38,47,121,58,50,63,"{'F': 16, 'P': 11}","{'C': 22, 'J': 16, 'Z': 16}","{'Q': 24, 'R': 16, 'S': 8, 'T': 8, 'H': 16, 'M': 8}","{'Y': 8, 'A': 8, 'B': 4, 'D': 4, 'E': 4, 'G': 8, 'I': 4, 'K': 8, 'L': 4, 'N': 4, 'O': 4, 'U': 8, 'V': 4, 'W': 4, 'X': 4}"
INV-ZZ-1782116,SCH-ZZ-4703145,ZZ,ZZ20240607BBIBLR2099.0,2099.0,Boeing 787,06/07/2024,2024-06-07 11:35:00,2024-06-07 20:31:00,BBI,BLR,270.0,301,149,-121,152,27,54,81,108,30,15,12,15,64,32,22,32,93,46,35,47,120,59,49,61,"{'F': 16, 'P': 11}","{'C': 22, 'J': 16, 'Z': 16}","{'Q': 24, 'R': 16, 'S': 8, 'T': 8, 'H': 16, 'M': 8}","{'Y': 8, 'A': 8, 'B': 4, 'D': 4, 'E': 4, 'G': 8, 'I': 4, 'K': 8, 'L': 4, 'N': 4, 'O': 4, 'U': 8, 'V': 4, 'W': 4, 'X': 4}"
INV-ZZ-2368197,SCH-ZZ-4703145,ZZ,ZZ20240608BBIBLR2099.0,2099.0,Boeing 787,06/08/2024,2024-06-08 11:35:00,2024-06-08 20:31:00,BBI,BLR,270.0,301,128,-142,173,27,54,81,108,30,13,14,17,64,27,27,37,90,38,43,52,126,53,55,73,"{'F': 16, 'P': 11}","{'C': 22, 'J': 16, 'Z': 16}","{'Q': 24, 'R': 16, 'S': 8, 'T': 8, 'H': 16, 'M': 8}","{'Y': 8, 'A': 8, 'B': 4, 'D': 4, 'E': 4, 'G': 8, 'I': 4, 'K': 8, 'L': 4, 'N': 4, 'O': 4, 'U': 8, 'V': 4, 'W': 4, 'X': 4}"
INV-ZZ-6682544,SCH-ZZ-7145989,ZZ,ZZ20240422HYDCJB2914.0,2914.0,Boeing 787,04/22/2024,2024-04-22 01:16:00,2024-04-22 09:23:00,HYD,CJB,270.0,307,186,-84,121,27,54,81,108,32,19,8,13,63,38,16,25,90,55,26,35,122,74,34,48,"{'F': 16, 'P': 11}","{'C': 22, 'J': 16, 'Z': 16}","{'Q': 24, 'R': 16, 'S': 8, 'T': 8, 'H': 16, 'M': 8}","{'Y': 8, 'A': 8, 'B': 4, 'D': 4, 'E': 4, 'G': 8, 'I': 4, 'K': 8, 'L': 4, 'N': 4, 'O': 4, 'U': 8, 'V': 4, 'W': 4, 'X': 4}"
INV-ZZ-4555986,SCH-ZZ-7145989,ZZ,ZZ20240423HYDCJB2914.0,2914.0,Boeing 787,04/23/2024,2024-04-23 01:16:00,2024-04-23 09:23:00,HYD,CJB,270.0,300,185,-85,115,27,54,81,108,32,20,7,12,60,37,17,23,89,55,26,34,124,76,32,48,"{'F': 16, 'P': 11}","{'C': 22, 'J': 16, 'Z': 16}","{'Q': 24, 'R': 16, 'S': 8, 'T': 8, 'H': 16, 'M': 8}","{'Y': 8, 'A': 8, 'B': 4, 'D': 4, 'E': 4, 'G': 8, 'I': 4, 'K': 8, 'L': 4, 'N': 4, 'O': 4, 'U': 8, 'V': 4, 'W': 4, 'X': 4}"
INV-ZZ-6135328,SCH-ZZ-7145989,ZZ,ZZ20240429HYDCJB2914.0,2914.0,Boeing 787,04/29/2024,2024-04-29 01:16:00,2024-04-29 09:23:00,HYD,CJB,270.0,323,182,-88,141,27,54,81,108,32,18,9,14,61,34,20,27,96,54,27,42,127,72,36,55,"{'F': 16, 'P': 11}","{'C': 22, 'J': 16, 'Z': 16}","{'Q': 24, 'R': 16, 'S': 8, 'T': 8, 'H': 16, 'M': 8}","{'Y': 8, 'A': 8, 'B': 4, 'D': 4, 'E': 4, 'G': 8, 'I': 4, 'K': 8, 'L': 4, 'N': 4, 'O': 4, 'U': 8, 'V': 4, 'W': 4, 'X': 4}"
INV-ZZ-6552982,SCH-ZZ-7145989,ZZ,ZZ20240430HYDCJB2914.0,2914.0,Boeing 787,04/30/2024,2024-04-30 01:16:00,2024-04-30 09:23:00,HYD,CJB,270.0,303,164,-106,139,27,54,81,108,31,17,10,14,61,33,21,28,97,52,29,45,129,70,38,59,"{'F': 16, 'P': 11}","{'C': 22, 'J': 16, 'Z': 16}","{'Q': 24, 'R': 16, 'S': 8, 'T': 8, 'H': 16, 'M': 8}","{'Y': 8, 'A': 8, 'B': 4, 'D': 4, 'E': 4, 'G': 8, 'I': 4, 'K': 8, 'L': 4, 'N': 4, 'O': 4, 'U': 8, 'V': 4, 'W': 4, 'X': 4}"
INV-ZZ-5032561,SCH-ZZ-7145989,ZZ,ZZ20240506HYDCJB2914.0,2914.0,Boeing 787,05/06/2024,2024-05-06 01:16:00,2024-05-06 09:23:00,HYD,CJB,270.0,318,166,-104,152,27,54,81,108,30,16,11,14,60,31,23,29,94,49,32,45,122,64,44,58,"{'F': 16, 'P': 11}","{'C': 22, 'J': 16, 'Z': 16}","{'Q': 24, 'R': 16, 'S': 8, 'T': 8, 'H': 16, 'M': 8}","{'Y': 8, 'A': 8, 'B': 4, 'D': 4, 'E': 4, 'G': 8, 'I': 4, 'K': 8, 'L': 4, 'N': 4, 'O': 4, 'U': 8, 'V': 4, 'W': 4, 'X': 4}"
INV-ZZ-4574448,SCH-ZZ-7145989,ZZ,ZZ20240507HYDCJB2914.0,2914.0,Boeing 787,05/07/2024,2024-05-07 01:16:00,2024-05-07 09:23:00,HYD,CJB,270.0,314,165,-105,149,27,54,81,108,32,17,10,15,60,32,22,28,92,48,33,44,120,63,45,57,"{'F': 16, 'P': 11}","{'C': 22, 'J': 16, 'Z': 16}","{'Q': 24, 'R': 16, 'S': 8, 'T': 8, 'H': 16, 'M': 8}","{'Y': 8, 'A': 8, 'B': 4, 'D': 4, 'E': 4, 'G': 8, 'I': 4, 'K': 8, 'L': 4, 'N': 4, 'O': 4, 'U': 8, 'V': 4, 'W': 4, 'X': 4}"
INV-ZZ-1140373,SCH-ZZ-7145989,ZZ,ZZ20240513HYDCJB2914.0,2914.0,Boeing 787,05/13/2024,2024-05-13 01:16:00,2024-05-13 09:23:00,HYD,CJB,270.0,323,158,-112,165,27,54,81,108,31,15,12,16,61,30,24,31,96,47,34,49,124,61,47,63,"{'F': 16, 'P': 11}","{'C': 22, 'J': 16, 'Z': 16}","{'Q': 24, 'R': 16, 'S': 8, 'T': 8, 'H': 16, 'M': 8}","{'Y': 8, 'A': 8, 'B': 4, 'D': 4, 'E': 4, 'G': 8, 'I': 4, 'K': 8, 'L': 4, 'N': 4, 'O': 4, 'U': 8, 'V': 4, 'W': 4, 'X': 4}"
INV-ZZ-2064126,SCH-ZZ-7145989,ZZ,ZZ20240514HYDCJB2914.0,2914.0,Boeing 787,05/14/2024,2024-05-14 01:16:00,2024-05-14 09:23:00,HYD,CJB,270.0,311,164,-106,147,27,54,81,108,30,16,11,14,64,34,20,30,95,50,31,45,121,64,44,57,"{'F': 16, 'P': 11}","{'C': 22, 'J': 16, 'Z': 16}","{'Q': 24, 'R': 16, 'S': 8, 'T': 8, 'H': 16, 'M': 8}","{'Y': 8, 'A': 8, 'B': 4, 'D': 4, 'E': 4, 'G': 8, 'I': 4, 'K': 8, 'L': 4, 'N': 4, 'O': 4, 'U': 8, 'V': 4, 'W': 4, 'X': 4}"
INV-ZZ-4662565,SCH-ZZ-7145989,ZZ,ZZ20240520HYDCJB2914.0,2914.0,Boeing 787,05/20/2024,2024-05-20 01:16:00,2024-05-20 09:23:00,HYD,CJB,270.0,306,145,-125,161,27,54,81,108,30,14,13,16,64,30,24,34,96,46,35,50,122,58,50,64,"{'F': 16, 'P': 11}","{'C': 22, 'J': 16, 'Z': 16}","{'Q': 24, 'R': 16, 'S': 8, 'T': 8, 'H': 16, 'M': 8}","{'Y': 8, 'A': 8, 'B': 4, 'D': 4, 'E': 4, 'G': 8, 'I': 4, 'K': 8, 'L': 4, 'N': 4, 'O': 4, 'U': 8, 'V': 4, 'W': 4, 'X': 4}"
INV-ZZ-4130402,SCH-ZZ-7145989,ZZ,ZZ20240521HYDCJB2914.0,2914.0,Boeing 787,05/21/2024,2024-05-21 01:16:00,2024-05-21 09:23:00,HYD,CJB,270.0,309,156,-114,153,27,54,81,108,31,16,11,15,64,32,22,32,95,48,33,47,123,62,46,61,"{'F': 16, 'P': 11}","{'C': 22, 'J': 16, 'Z': 16}","{'Q': 24, 'R': 16, 'S': 8, 'T': 8, 'H': 16, 'M': 8}","{'Y': 8, 'A': 8, 'B': 4, 'D': 4, 'E': 4, 'G': 8, 'I': 4, 'K': 8, 'L': 4, 'N': 4, 'O': 4, 'U': 8, 'V': 4, 'W': 4, 'X': 4}"
INV-ZZ-5255512,SCH-ZZ-7145989,ZZ,ZZ20240527HYDCJB2914.0,2914.0,Boeing 787,05/27/2024,2024-05-27 01:16:00,2024-05-27 09:23:00,HYD,CJB,270.0,305,148,-122,157,27,54,81,108,30,15,12,15,60,29,25,31,91,44,37,47,125,60,48,65,"{'F': 16, 'P': 11}","{'C': 22, 'J': 16, 'Z': 16}","{'Q': 24, 'R': 16, 'S': 8, 'T': 8, 'H': 16, 'M': 8}","{'Y': 8, 'A': 8, 'B': 4, 'D': 4, 'E': 4, 'G': 8, 'I': 4, 'K': 8, 'L': 4, 'N': 4, 'O': 4, 'U': 8, 'V': 4, 'W': 4, 'X': 4}"
INV-ZZ-3975371,SCH-ZZ-7145989,ZZ,ZZ20240528HYDCJB2914.0,2914.0,Boeing 787,05/28/2024,2024-05-28 01:16:00,2024-05-28 09:23:00,HYD,CJB,270.0,320,155,-115,165,27,54,81,108,31,15,12,16,63,31,23,32,92,45,36,47,128,62,46,66,"{'F': 16, 'P': 11}","{'C': 22, 'J': 16, 'Z': 16}","{'Q': 24, 'R': 16, 'S': 8, 'T': 8, 'H': 16, 'M': 8}","{'Y': 8, 'A': 8, 'B': 4, 'D': 4, 'E': 4, 'G': 8, 'I': 4, 'K': 8, 'L': 4, 'N': 4, 'O': 4, 'U': 8, 'V': 4, 'W': 4, 'X': 4}"
INV-ZZ-1870536,SCH-ZZ-7145989,ZZ,ZZ20240603HYDCJB2914.0,2914.0,Boeing 787,06/03/2024,2024-06-03 01:16:00,2024-06-03 09:23:00,HYD,CJB,270.0,303,137,-133,166,27,54,81,108,31,14,13,17,62,28,26,34,92,41,40,51,123,55,53,68,"{'F': 16, 'P': 11}","{'C': 22, 'J': 16, 'Z': 16}","{'Q': 24, 'R': 16, 'S': 8, 'T': 8, 'H': 16, 'M': 8}","{'Y': 8, 'A': 8, 'B': 4, 'D': 4, 'E': 4, 'G': 8, 'I': 4, 'K': 8, 'L': 4, 'N': 4, 'O': 4, 'U': 8, 'V': 4, 'W': 4, 'X': 4}"
INV-ZZ-8001851,SCH-ZZ-4227852,ZZ,ZZ20240421GOIBOM2453.0,2453.0,Airbus A320 Neo,04/21/2024,2024-04-21 08:27:00,2024-04-21 13:54:00,GOI,BOM,180.0,215,129,-51,86,18,36,54,72,21,13,5,8,43,26,10,17,61,37,17,24,83,50,22,33,"{'F': 11, 'P': 7}","{'C': 14, 'J': 11, 'Z': 11}","{'Q': 16, 'R': 11, 'S': 5, 'T': 5, 'H': 11, 'M': 5}","{'Y': 5, 'A': 5, 'B': 3, 'D': 3, 'E': 3, 'G': 5, 'I': 3, 'K': 5, 'L': 3, 'N': 3, 'O': 3, 'U': 5, 'V': 3, 'W': 3, 'X': 3}"
INV-ZZ-3400872,SCH-ZZ-4227852,ZZ,ZZ20240423GOIBOM2453.0,2453.0,Airbus A320 Neo,04/23/2024,2024-04-23 08:27:00,2024-04-23 13:54:00,GOI,BOM,180.0,212,128,-52,84,18,36,54,72,20,12,6,8,42,25,11,17,62,37,17,25,84,51,21,33,"{'F': 11, 'P': 7}","{'C': 14, 'J': 11, 'Z': 11}","{'Q': 16, 'R': 11, 'S': 5, 'T': 5, 'H': 11, 'M': 5}","{'Y': 5, 'A': 5, 'B': 3, 'D': 3, 'E': 3, 'G': 5, 'I': 3, 'K': 5, 'L': 3, 'N': 3, 'O': 3, 'U': 5, 'V': 3, 'W': 3, 'X': 3}"
INV-ZZ-4078818,SCH-ZZ-4227852,ZZ,ZZ20240424GOIBOM2453.0,2453.0,Airbus A320 Neo,04/24/2024,2024-04-24 08:27:00,2024-04-24 13:54:00,GOI,BOM,180.0,215,125,-55,90,18,36,54,72,21,12,6,9,40,23,13,17,61,35,19,26,83,48,24,35,"{'F': 11, 'P': 7}","{'C': 14, 'J': 11, 'Z': 11}","{'Q': 16, 'R': 11, 'S': 5, 'T': 5, 'H': 11, 'M': 5}","{'Y': 5, 'A': 5, 'B': 3, 'D': 3, 'E': 3, 'G': 5, 'I': 3, 'K': 5, 'L': 3, 'N': 3, 'O': 3, 'U': 5, 'V': 3, 'W': 3, 'X': 3}"
INV-ZZ-7301640,SCH-ZZ-4227852,ZZ,ZZ20240425GOIBOM2453.0,2453.0,Airbus A320 Neo,04/25/2024,2024-04-25 08:27:00,2024-04-25 13:54:00,GOI,BOM,180.0,214,117,-63,97,18,36,54,72,20,11,7,9,43,23,13,20,61,33,21,28,85,46,26,39,"{'F': 11, 'P': 7}","{'C': 14, 'J': 11, 'Z': 11}","{'Q': 16, 'R': 11, 'S': 5, 'T': 5, 'H': 11, 'M': 5}","{'Y': 5, 'A': 5, 'B': 3, 'D': 3, 'E': 3, 'G': 5, 'I': 3, 'K': 5, 'L': 3, 'N': 3, 'O': 3, 'U': 5, 'V': 3, 'W': 3, 'X': 3}"
INV-ZZ-7651999,SCH-ZZ-4227852,ZZ,ZZ20240427GOIBOM2453.0,2453.0,Airbus A320 Neo,04/27/2024,2024-04-27 08:27:00,2024-04-27 13:54:00,GOI,BOM,180.0,205,123,-57,82,18,36,54,72,21,13,5,8,43,26,10,17,60,36,18,24,80,48,24,32,"{'F': 11, 'P': 7}","{'C': 14, 'J': 11, 'Z': 11}","{'Q': 16, 'R': 11, 'S': 5, 'T': 5, 'H': 11, 'M': 5}","{'Y': 5, 'A': 5, 'B': 3, 'D': 3, 'E': 3, 'G': 5, 'I': 3, 'K': 5, 'L': 3, 'N': 3, 'O': 3, 'U': 5, 'V': 3, 'W': 3, 'X': 3}"
INV-ZZ-1475439,SCH-ZZ-4227852,ZZ,ZZ20240428GOIBOM2453.0,2453.0,Airbus A320 Neo,04/28/2024,2024-04-28 08:27:00,2024-04-28 13:54:00,GOI,BOM,180.0,205,120,-60,85,18,36,54,72,20,12,6,8,40,23,13,17,62,36,18,26,81,47,25,34,"{'F': 11, 'P': 7}","{'C': 14, 'J': 11, 'Z': 11}","{'Q': 16, 'R': 11, 'S': 5, 'T': 5, 'H': 11, 'M': 5}","{'Y': 5, 'A': 5, 'B': 3, 'D': 3, 'E': 3, 'G': 5, 'I': 3, 'K': 5, 'L': 3, 'N': 3, 'O': 3, 'U': 5, 'V': 3, 'W': 3, 'X': 3}"
INV-ZZ-5582276,SCH-ZZ-4227852,ZZ,ZZ20240430GOIBOM2453.0,2453.0,Airbus A320 Neo,04/30/2024,2024-04-30 08:27:00,2024-04-30 13:54:00,GOI,BOM,180.0,208,113,-67,95,18,36,54,72,20,11,7,9,40,22,14,18,64,35,19,29,86,47,25,39,"{'F': 11, 'P': 7}","{'C': 14, 'J': 11, 'Z': 11}","{'Q': 16, 'R': 11, 'S': 5, 'T': 5, 'H': 11, 'M': 5}","{'Y': 5, 'A': 5, 'B': 3, 'D': 3, 'E': 3, 'G': 5, 'I': 3, 'K': 5, 'L': 3, 'N': 3, 'O': 3, 'U': 5, 'V': 3, 'W': 3, 'X': 3}"
INV-ZZ-3104507,SCH-ZZ-4227852,ZZ,ZZ20240501GOIBOM2453.0,2453.0,Airbus A320 Neo,05/01/2024,2024-05-01 08:27:00,2024-05-01 13:54:00,GOI,BOM,180.0,203,114,-66,89,18,36,54,72,20,11,7,9,43,24,12,19,62,35,19,27,83,47,25,36,"{'F': 11, 'P': 7}","{'C': 14, 'J': 11, 'Z': 11}","{'Q': 16, 'R': 11, 'S': 5, 'T': 5, 'H': 11, 'M': 5}","{'Y': 5, 'A': 5, 'B': 3, 'D': 3, 'E': 3, 'G': 5, 'I': 3, 'K': 5, 'L': 3, 'N': 3, 'O': 3, 'U': 5, 'V': 3, 'W': 3, 'X': 3}"
INV-ZZ-2459951,SCH-ZZ-4227852,ZZ,ZZ20240502GOIBOM2453.0,2453.0,Airbus A320 Neo,05/02/2024,2024-05-02 08:27:00,2024-05-02 13:54:00,GOI,BOM,180.0,201,106,-74,95,18,36,54,72,20,11,7,9,42,22,14,20,60,32,22,28,83,44,28,39,"{'F': 11, 'P': 7}","{'C': 14, 'J': 11, 'Z': 11}","{'Q': 16, 'R': 11, 'S': 5, 'T': 5, 'H': 11, 'M': 5}","{'Y': 5, 'A': 5, 'B': 3, 'D': 3, 'E': 3, 'G': 5, 'I': 3, 'K': 5, 'L': 3, 'N': 3, 'O': 3, 'U': 5, 'V': 3, 'W': 3, 'X': 3}"
INV-ZZ-9388899,SCH-ZZ-4227852,ZZ,ZZ20240504GOIBOM2453.0,2453.0,Airbus A320 Neo,05/04/2024,2024-05-04 08:27:00,2024-05-04 13:54:00,GOI,BOM,180.0,206,105,-75,101,18,36,54,72,21,11,7,10,42,22,14,20,61,31,23,30,84,43,29,41,"{'F': 11, 'P': 7}","{'C': 14, 'J': 11, 'Z': 11}","{'Q': 16, 'R': 11, 'S': 5, 'T': 5, 'H': 11, 'M': 5}","{'Y': 5, 'A': 5, 'B': 3, 'D': 3, 'E': 3, 'G': 5, 'I': 3, 'K': 5, 'L': 3, 'N': 3, 'O': 3, 'U': 5, 'V': 3, 'W': 3, 'X': 3}"
INV-ZZ-9503297,SCH-ZZ-4227852,ZZ,ZZ20240505GOIBOM2453.0,2453.0,Airbus A320 Neo,05/05/2024,2024-05-05 08:27:00,2024-05-05 13:54:00,GOI,BOM,180.0,198,102,-78,96,18,36,54,72,20,10,8,10,42,22,14,20,61,31,23,30,81,42,30,39,"{'F': 11, 'P': 7}","{'C': 14, 'J': 11, 'Z': 11}","{'Q': 16, 'R': 11, 'S': 5, 'T': 5, 'H': 11, 'M': 5}","{'Y': 5, 'A': 5, 'B': 3, 'D': 3, 'E': 3, 'G': 5, 'I': 3, 'K': 5, 'L': 3, 'N': 3, 'O': 3, 'U': 5, 'V': 3, 'W': 3, 'X': 3}"
INV-ZZ-4225848,SCH-ZZ-4227852,ZZ,ZZ20240507GOIBOM2453.0,2453.0,Airbus A320 Neo,05/07/2024,2024-05-07 08:27:00,2024-05-07 13:54:00,GOI,BOM,180.0,202,104,-76,98,18,36,54,72,21,11,7,10,43,22,14,21,61,32,22,29,80,41,31,39,"{'F': 11, 'P': 7}","{'C': 14, 'J': 11, 'Z': 11}","{'Q': 16, 'R': 11, 'S': 5, 'T': 5, 'H': 11, 'M': 5}","{'Y': 5, 'A': 5, 'B': 3, 'D': 3, 'E': 3, 'G': 5, 'I': 3, 'K': 5, 'L': 3, 'N': 3, 'O': 3, 'U': 5, 'V': 3, 'W': 3, 'X': 3}"
INV-ZZ-6554157,SCH-ZZ-4227852,ZZ,ZZ20240508GOIBOM2453.0,2453.0,Airbus A320 Neo,05/08/2024,2024-05-08 08:27:00,2024-05-08 13:54:00,GOI,BOM,180.0,211,109,-71,102,18,36,54,72,20,10,8,10,42,22,14,20,60,31,23,29,86,44,28,42,"{'F': 11, 'P': 7}","{'C': 14, 'J': 11, 'Z': 11}","{'Q': 16, 'R': 11, 'S': 5, 'T': 5, 'H': 11, 'M': 5}","{'Y': 5, 'A': 5, 'B': 3, 'D': 3, 'E': 3, 'G': 5, 'I': 3, 'K': 5, 'L': 3, 'N': 3, 'O': 3, 'U': 5, 'V': 3, 'W': 3, 'X': 3}"
INV-ZZ-9111086,SCH-ZZ-4227852,ZZ,ZZ20240509GOIBOM2453.0,2453.0,Airbus A320 Neo,05/09/2024,2024-05-09 08:27:00,2024-05-09 13:54:00,GOI,BOM,180.0,209,108,-72,101,18,36,54,72,20,10,8,10,41,21,15,20,63,33,21,30,81,42,30,39,"{'F': 11, 'P': 7}","{'C': 14, 'J': 11, 'Z': 11}","{'Q': 16, 'R': 11, 'S': 5, 'T': 5, 'H': 11, 'M': 5}","{'Y': 5, 'A': 5, 'B': 3, 'D': 3, 'E': 3, 'G': 5, 'I': 3, 'K': 5, 'L': 3, 'N': 3, 'O': 3, 'U': 5, 'V': 3, 'W': 3, 'X': 3}"
INV-ZZ-6107258,SCH-ZZ-4227852,ZZ,ZZ20240511GOIBOM2453.0,2453.0,Airbus A320 Neo,05/11/2024,2024-05-11 08:27:00,2024-05-11 13:54:00,GOI,BOM,180.0,209,112,-68,97,18,36,54,72,20,11,7,9,42,22,14,20,59,32,22,27,84,45,27,39,"{'F': 11, 'P': 7}","{'C': 14, 'J': 11, 'Z': 11}","{'Q': 16, 'R': 11, 'S': 5, 'T': 5, 'H': 11, 'M': 5}","{'Y': 5, 'A': 5, 'B': 3, 'D': 3, 'E': 3, 'G': 5, 'I': 3, 'K': 5, 'L': 3, 'N': 3, 'O': 3, 'U': 5, 'V': 3, 'W': 3, 'X': 3}"
INV-ZZ-1930548,SCH-ZZ-4227852,ZZ,ZZ20240512GOIBOM2453.0,2453.0,Airbus A320 Neo,05/12/2024,2024-05-12 08:27:00,2024-05-12 13:54:00,GOI,BOM,180.0,212,114,-66,98,18,36,54,72,21,11,7,10,40,22,14,18,62,33,21,29,81,44,28,37,"{'F': 11, 'P': 7}","{'C': 14, 'J': 11, 'Z': 11}","{'Q': 16, 'R': 11, 'S': 5, 'T': 5, 'H': 11, 'M': 5}","{'Y': 5, 'A': 5, 'B': 3, 'D': 3, 'E': 3, 'G': 5, 'I': 3, 'K': 5, 'L': 3, 'N': 3, 'O': 3, 'U': 5, 'V': 3, 'W': 3, 'X': 3}"
INV-ZZ-6067966,SCH-ZZ-4227852,ZZ,ZZ20240514GOIBOM2453.0,2453.0,Airbus A320 Neo,05/14/2024,2024-05-14 08:27:00,2024-05-14 13:54:00,GOI,BOM,180.0,212,117,-63,95,18,36,54,72,21,12,6,9,42,23,13,19,60,33,21,27,80,44,28,36,"{'F': 11, 'P': 7}","{'C': 14, 'J': 11, 'Z': 11}","{'Q': 16, 'R': 11, 'S': 5, 'T': 5, 'H': 11, 'M': 5}","{'Y': 5, 'A': 5, 'B': 3, 'D': 3, 'E': 3, 'G': 5, 'I': 3, 'K': 5, 'L': 3, 'N': 3, 'O': 3, 'U': 5, 'V': 3, 'W': 3, 'X': 3}"
INV-ZZ-1307600,SCH-ZZ-4227852,ZZ,ZZ20240515GOIBOM2453.0,2453.0,Airbus A320 Neo,05/15/2024,2024-05-15 08:27:00,2024-05-15 13:54:00,GOI,BOM,180.0,206,115,-65,91,18,36,54,72,21,12,6,9,42,24,12,18,64,36,18,28,80,45,27,35,"{'F': 11, 'P': 7}","{'C': 14, 'J': 11, 'Z': 11}","{'Q': 16, 'R': 11, 'S': 5, 'T': 5, 'H': 11, 'M': 5}","{'Y': 5, 'A': 5, 'B': 3, 'D': 3, 'E': 3, 'G': 5, 'I': 3, 'K': 5, 'L': 3, 'N': 3, 'O': 3, 'U': 5, 'V': 3, 'W': 3, 'X': 3}"
INV-ZZ-2694745,SCH-ZZ-4227852,ZZ,ZZ20240516GOIBOM2453.0,2453.0,Airbus A320 Neo,05/16/2024,2024-05-16 08:27:00,2024-05-16 13:54:00,GOI,BOM,180.0,215,112,-68,103,18,36,54,72,21,11,7,10,41,21,15,20,62,32,22,30,80,42,30,38,"{'F': 11, 'P': 7}","{'C': 14, 'J': 11, 'Z': 11}","{'Q': 16, 'R': 11, 'S': 5, 'T': 5, 'H': 11, 'M': 5}","{'Y': 5, 'A': 5, 'B': 3, 'D': 3, 'E': 3, 'G': 5, 'I': 3, 'K': 5, 'L': 3, 'N': 3, 'O': 3, 'U': 5, 'V': 3, 'W': 3, 'X': 3}"
INV-ZZ-9764538,SCH-ZZ-4227852,ZZ,ZZ20240518GOIBOM2453.0,2453.0,Airbus A320 Neo,05/18/2024,2024-05-18 08:27:00,2024-05-18 13:54:00,GOI,BOM,180.0,205,107,-73,98,18,36,54,72,21,11,7,10,40,21,15,19,61,32,22,29,82,43,29,39,"{'F': 11, 'P': 7}","{'C': 14, 'J': 11, 'Z': 11}","{'Q': 16, 'R': 11, 'S': 5, 'T': 5, 'H': 11, 'M': 5}","{'Y': 5, 'A': 5, 'B': 3, 'D': 3, 'E': 3, 'G': 5, 'I': 3, 'K': 5, 'L': 3, 'N': 3, 'O': 3, 'U': 5, 'V': 3, 'W': 3, 'X': 3}"
INV-ZZ-2739512,SCH-ZZ-4227852,ZZ,ZZ20240519GOIBOM2453.0,2453.0,Airbus A320 Neo,05/19/2024,2024-05-19 08:27:00,2024-05-19 13:54:00,GOI,BOM,180.0,206,104,-76,102,18,36,54,72,20,10,8,10,41,21,15,20,62,31,23,31,84,43,29,41,"{'F': 11, 'P': 7}","{'C': 14, 'J': 11, 'Z': 11}","{'Q': 16, 'R': 11, 'S': 5, 'T': 5, 'H': 11, 'M': 5}","{'Y': 5, 'A': 5, 'B': 3, 'D': 3, 'E': 3, 'G': 5, 'I': 3, 'K': 5, 'L': 3, 'N': 3, 'O': 3, 'U': 5, 'V': 3, 'W': 3, 'X': 3}"
INV-ZZ-9567743,SCH-ZZ-4227852,ZZ,ZZ20240521GOIBOM2453.0,2453.0,Airbus A320 Neo,05/21/2024,2024-05-21 08:27:00,2024-05-21 13:54:00,GOI,BOM,180.0,202,109,-71,93,18,36,54,72,21,11,7,10,42,23,13,19,62,33,21,29,82,44,28,38,"{'F': 11, 'P': 7}","{'C': 14, 'J': 11, 'Z': 11}","{'Q': 16, 'R': 11, 'S': 5, 'T': 5, 'H': 11, 'M': 5}","{'Y': 5, 'A': 5, 'B': 3, 'D': 3, 'E': 3, 'G': 5, 'I': 3, 'K': 5, 'L': 3, 'N': 3, 'O': 3, 'U': 5, 'V': 3, 'W': 3, 'X': 3}"
INV-ZZ-1729030,SCH-ZZ-4227852,ZZ,ZZ20240522GOIBOM2453.0,2453.0,Airbus A320 Neo,05/22/2024,2024-05-22 08:27:00,2024-05-22 13:54:00,GOI,BOM,180.0,198,93,-87,105,18,36,54,72,21,10,8,11,41,19,17,22,62,29,25,33,85,40,32,45,"{'F': 11, 'P': 7}","{'C': 14, 'J': 11, 'Z': 11}","{'Q': 16, 'R': 11, 'S': 5, 'T': 5, 'H': 11, 'M': 5}","{'Y': 5, 'A': 5, 'B': 3, 'D': 3, 'E': 3, 'G': 5, 'I': 3, 'K': 5, 'L': 3, 'N': 3, 'O': 3, 'U': 5, 'V': 3, 'W': 3, 'X': 3}"
INV-ZZ-3828820,SCH-ZZ-4227852,ZZ,ZZ20240523GOIBOM2453.0,2453.0,Airbus A320 Neo,05/23/2024,2024-05-23 08:27:00,2024-05-23 13:54:00,GOI,BOM,180.0,213,111,-69,102,18,36,54,72,20,10,8,10,40,21,15,19,61,32,22,29,82,43,29,39,"{'F': 11, 'P': 7}","{'C': 14, 'J': 11, 'Z': 11}","{'Q': 16, 'R': 11, 'S': 5, 'T': 5, 'H': 11, 'M': 5}","{'Y': 5, 'A': 5, 'B': 3, 'D': 3, 'E': 3, 'G': 5, 'I': 3, 'K': 5, 'L': 3, 'N': 3, 'O': 3, 'U': 5, 'V': 3, 'W': 3, 'X': 3}"
INV-ZZ-5679734,SCH-ZZ-4227852,ZZ,ZZ20240525GOIBOM2453.0,2453.0,Airbus A320 Neo,05/25/2024,2024-05-25 08:27:00,2024-05-25 13:54:00,GOI,BOM,180.0,206,101,-79,105,18,36,54,72,20,10,8,10,41,20,16,21,63,31,23,32,82,40,32,42,"{'F': 11, 'P': 7}","{'C': 14, 'J': 11, 'Z': 11}","{'Q': 16, 'R': 11, 'S': 5, 'T': 5, 'H': 11, 'M': 5}","{'Y': 5, 'A': 5, 'B': 3, 'D': 3, 'E': 3, 'G': 5, 'I': 3, 'K': 5, 'L': 3, 'N': 3, 'O': 3, 'U': 5, 'V': 3, 'W': 3, 'X': 3}"
INV-ZZ-9387907,SCH-ZZ-4227852,ZZ,ZZ20240526GOIBOM2453.0,2453.0,Airbus A320 Neo,05/26/2024,2024-05-26 08:27:00,2024-05-26 13:54:00,GOI,BOM,180.0,202,95,-85,107,18,36,54,72,21,10,8,11,41,19,17,22,60,28,26,32,85,40,32,45,"{'F': 11, 'P': 7}","{'C': 14, 'J': 11, 'Z': 11}","{'Q': 16, 'R': 11, 'S': 5, 'T': 5, 'H': 11, 'M': 5}","{'Y': 5, 'A': 5, 'B': 3, 'D': 3, 'E': 3, 'G': 5, 'I': 3, 'K': 5, 'L': 3, 'N': 3, 'O': 3, 'U': 5, 'V': 3, 'W': 3, 'X': 3}"
INV-ZZ-8209063,SCH-ZZ-4227852,ZZ,ZZ20240528GOIBOM2453.0,2453.0,Airbus A320 Neo,05/28/2024,2024-05-28 08:27:00,2024-05-28 13:54:00,GOI,BOM,180.0,215,104,-76,111,18,36,54,72,20,10,8,10,41,20,16,21,63,30,24,33,83,40,32,43,"{'F': 11, 'P': 7}","{'C': 14, 'J': 11, 'Z': 11}","{'Q': 16, 'R': 11, 'S': 5, 'T': 5, 'H': 11, 'M': 5}","{'Y': 5, 'A': 5, 'B': 3, 'D': 3, 'E': 3, 'G': 5, 'I': 3, 'K': 5, 'L': 3, 'N': 3, 'O': 3, 'U': 5, 'V': 3, 'W': 3, 'X': 3}"
INV-ZZ-2594297,SCH-ZZ-4227852,ZZ,ZZ20240529GOIBOM2453.0,2453.0,Airbus A320 Neo,05/29/2024,2024-05-29 08:27:00,2024-05-29 13:54:00,GOI,BOM,180.0,210,108,-72,102,18,36,54,72,22,11,7,11,40,21,15,19,64,33,21,31,82,42,30,40,"{'F': 11, 'P': 7}","{'C': 14, 'J': 11, 'Z': 11}","{'Q': 16, 'R': 11, 'S': 5, 'T': 5, 'H': 11, 'M': 5}","{'Y': 5, 'A': 5, 'B': 3, 'D': 3, 'E': 3, 'G': 5, 'I': 3, 'K': 5, 'L': 3, 'N': 3, 'O': 3, 'U': 5, 'V': 3, 'W': 3, 'X': 3}"
INV-ZZ-1443915,SCH-ZZ-4227852,ZZ,ZZ20240530GOIBOM2453.0,2453.0,Airbus A320 Neo,05/30/2024,2024-05-30 08:27:00,2024-05-30 13:54:00,GOI,BOM,180.0,206,105,-75,101,18,36,54,72,21,11,7,10,42,22,14,20,60,31,23,29,80,41,31,39,"{'F': 11, 'P': 7}","{'C': 14, 'J': 11, 'Z': 11}","{'Q': 16, 'R': 11, 'S': 5, 'T': 5, 'H': 11, 'M': 5}","{'Y': 5, 'A': 5, 'B': 3, 'D': 3, 'E': 3, 'G': 5, 'I': 3, 'K': 5, 'L': 3, 'N': 3, 'O': 3, 'U': 5, 'V': 3, 'W': 3, 'X': 3}"
INV-ZZ-4532524,SCH-ZZ-4227852,ZZ,ZZ20240601GOIBOM2453.0,2453.0,Airbus A320 Neo,06/01/2024,2024-06-01 08:27:00,2024-06-01 13:54:00,GOI,BOM,180.0,215,100,-80,115,18,36,54,72,20,9,9,11,40,19,17,21,62,29,25,33,81,37,35,44,"{'F': 11, 'P': 7}","{'C': 14, 'J': 11, 'Z': 11}","{'Q': 16, 'R': 11, 'S': 5, 'T': 5, 'H': 11, 'M': 5}","{'Y': 5, 'A': 5, 'B': 3, 'D': 3, 'E': 3, 'G': 5, 'I': 3, 'K': 5, 'L': 3, 'N': 3, 'O': 3, 'U': 5, 'V': 3, 'W': 3, 'X': 3}"
INV-ZZ-8689652,SCH-ZZ-4227852,ZZ,ZZ20240602GOIBOM2453.0,2453.0,Airbus A320 Neo,06/02/2024,2024-06-02 08:27:00,2024-06-02 13:54:00,GOI,BOM,180.0,203,99,-81,104,18,36,54,72,22,11,7,11,42,20,16,22,61,30,24,31,85,41,31,44,"{'F': 11, 'P': 7}","{'C': 14, 'J': 11, 'Z': 11}","{'Q': 16, 'R': 11, 'S': 5, 'T': 5, 'H': 11, 'M': 5}","{'Y': 5, 'A': 5, 'B': 3, 'D': 3, 'E': 3, 'G': 5, 'I': 3, 'K': 5, 'L': 3, 'N': 3, 'O': 3, 'U': 5, 'V': 3, 'W': 3, 'X': 3}"
INV-ZZ-4000662,SCH-ZZ-4227852,ZZ,ZZ20240604GOIBOM2453.0,2453.0,Airbus A320 Neo,06/04/2024,2024-06-04 08:27:00,2024-06-04 13:54:00,GOI,BOM,180.0,201,97,-83,104,18,36,54,72,21,10,8,11,41,20,16,21,64,31,23,33,82,40,32,42,"{'F': 11, 'P': 7}","{'C': 14, 'J': 11, 'Z': 11}","{'Q': 16, 'R': 11, 'S': 5, 'T': 5, 'H': 11, 'M': 5}","{'Y': 5, 'A': 5, 'B': 3, 'D': 3, 'E': 3, 'G': 5, 'I': 3, 'K': 5, 'L': 3, 'N': 3, 'O': 3, 'U': 5, 'V': 3, 'W': 3, 'X': 3}"
INV-ZZ-5579594,SCH-ZZ-4227852,ZZ,ZZ20240605GOIBOM2453.0,2453.0,Airbus A320 Neo,06/05/2024,2024-06-05 08:27:00,2024-06-05 13:54:00,GOI,BOM,180.0,200,96,-84,104,18,36,54,72,21,10,8,11,42,20,16,22,60,29,25,31,83,40,32,43,"{'F': 11, 'P': 7}","{'C': 14, 'J': 11, 'Z': 11}","{'Q': 16, 'R': 11, 'S': 5, 'T': 5, 'H': 11, 'M': 5}","{'Y': 5, 'A': 5, 'B': 3, 'D': 3, 'E': 3, 'G': 5, 'I': 3, 'K': 5, 'L': 3, 'N': 3, 'O': 3, 'U': 5, 'V': 3, 'W': 3, 'X': 3}"
INV-ZZ-6928496,SCH-ZZ-3158405,ZZ,ZZ20240428PNQBOM3772.0,3772.0,BAe 146,04/28/2024,2024-04-28 02:35:00,2024-04-28 09:59:00,PNQ,BOM,91.0,101,62,-29,39,9,18,27,36,11,7,2,4,21,13,5,8,31,19,8,12,43,26,10,17,"{'F': 5, 'P': 4}","{'C': 7, 'J': 5, 'Z': 5}","{'Q': 8, 'R': 5, 'S': 3, 'T': 3, 'H': 5, 'M': 3}","{'Y': 3, 'A': 3, 'B': 1, 'D': 1, 'E': 1, 'G': 3, 'I': 1, 'K': 3, 'L': 1, 'N': 1, 'O': 1, 'U': 3, 'V': 1, 'W': 1, 'X': 1}"
INV-ZZ-5469455,SCH-ZZ-3158405,ZZ,ZZ20240429PNQBOM3772.0,3772.0,BAe 146,04/29/2024,2024-04-29 02:35:00,2024-04-29 09:59:00,PNQ,BOM,91.0,109,59,-32,50,9,18,27,36,10,5,4,5,21,11,7,10,31,17,10,14,40,22,14,18,"{'F': 5, 'P': 4}","{'C': 7, 'J': 5, 'Z': 5}","{'Q': 8, 'R': 5, 'S': 3, 'T': 3, 'H': 5, 'M': 3}","{'Y': 3, 'A': 3, 'B': 1, 'D': 1, 'E': 1, 'G': 3, 'I': 1, 'K': 3, 'L': 1, 'N': 1, 'O': 1, 'U': 3, 'V': 1, 'W': 1, 'X': 1}"
INV-ZZ-9797707,SCH-ZZ-3158405,ZZ,ZZ20240501PNQBOM3772.0,3772.0,BAe 146,05/01/2024,2024-05-01 02:35:00,2024-05-01 09:59:00,PNQ,BOM,91.0,102,57,-34,45,9,18,27,36,10,6,3,4,20,11,7,9,32,18,9,14,40,22,14,18,"{'F': 5, 'P': 4}","{'C': 7, 'J': 5, 'Z': 5}","{'Q': 8, 'R': 5, 'S': 3, 'T': 3, 'H': 5, 'M': 3}","{'Y': 3, 'A': 3, 'B': 1, 'D': 1, 'E': 1, 'G': 3, 'I': 1, 'K': 3, 'L': 1, 'N': 1, 'O': 1, 'U': 3, 'V': 1, 'W': 1, 'X': 1}"
INV-ZZ-1422140,SCH-ZZ-3158405,ZZ,ZZ20240502PNQBOM3772.0,3772.0,BAe 146,05/02/2024,2024-05-02 02:35:00,2024-05-02 09:59:00,PNQ,BOM,91.0,103,58,-33,45,9,18,27,36,11,6,3,5,20,11,7,9,31,17,10,14,42,23,13,19,"{'F': 5, 'P': 4}","{'C': 7, 'J': 5, 'Z': 5}","{'Q': 8, 'R': 5, 'S': 3, 'T': 3, 'H': 5, 'M': 3}","{'Y': 3, 'A': 3, 'B': 1, 'D': 1, 'E': 1, 'G': 3, 'I': 1, 'K': 3, 'L': 1, 'N': 1, 'O': 1, 'U': 3, 'V': 1, 'W': 1, 'X': 1}"
INV-ZZ-2046108,SCH-ZZ-3158405,ZZ,ZZ20240503PNQBOM3772.0,3772.0,BAe 146,05/03/2024,2024-05-03 02:35:00,2024-05-03 09:59:00,PNQ,BOM,91.0,102,57,-34,45,9,18,27,36,10,6,3,4,21,12,6,9,31,17,10,14,41,23,13,18,"{'F': 5, 'P': 4}","{'C': 7, 'J': 5, 'Z': 5}","{'Q': 8, 'R': 5, 'S': 3, 'T': 3, 'H': 5, 'M': 3}","{'Y': 3, 'A': 3, 'B': 1, 'D': 1, 'E': 1, 'G': 3, 'I': 1, 'K': 3, 'L': 1, 'N': 1, 'O': 1, 'U': 3, 'V': 1, 'W': 1, 'X': 1}"
INV-ZZ-1460181,SCH-ZZ-3158405,ZZ,ZZ20240505PNQBOM3772.0,3772.0,BAe 146,05/05/2024,2024-05-05 02:35:00,2024-05-05 09:59:00,PNQ,BOM,91.0,102,60,-31,42,9,18,27,36,11,6,3,5,20,12,6,8,30,18,9,12,40,24,12,16,"{'F': 5, 'P': 4}","{'C': 7, 'J': 5, 'Z': 5}","{'Q': 8, 'R': 5, 'S': 3, 'T': 3, 'H': 5, 'M': 3}","{'Y': 3, 'A': 3, 'B': 1, 'D': 1, 'E': 1, 'G': 3, 'I': 1, 'K': 3, 'L': 1, 'N': 1, 'O': 1, 'U': 3, 'V': 1, 'W': 1, 'X': 1}"
INV-ZZ-4668049,SCH-ZZ-3158405,ZZ,ZZ20240506PNQBOM3772.0,3772.0,BAe 146,05/06/2024,2024-05-06 02:35:00,2024-05-06 09:59:00,PNQ,BOM,91.0,108,63,-28,45,9,18,27,36,10,6,3,4,20,12,6,8,31,18,9,13,42,25,11,17,"{'F': 5, 'P': 4}","{'C': 7, 'J': 5, 'Z': 5}","{'Q': 8, 'R': 5, 'S': 3, 'T': 3, 'H': 5, 'M': 3}","{'Y': 3, 'A': 3, 'B': 1, 'D': 1, 'E': 1, 'G': 3, 'I': 1, 'K': 3, 'L': 1, 'N': 1, 'O': 1, 'U': 3, 'V': 1, 'W': 1, 'X': 1}"
INV-ZZ-5692485,SCH-ZZ-3158405,ZZ,ZZ20240508PNQBOM3772.0,3772.0,BAe 146,05/08/2024,2024-05-08 02:35:00,2024-05-08 09:59:00,PNQ,BOM,91.0,100,52,-39,48,9,18,27,36,10,5,4,5,22,11,7,11,30,16,11,14,40,21,15,19,"{'F': 5, 'P': 4}","{'C': 7, 'J': 5, 'Z': 5}","{'Q': 8, 'R': 5, 'S': 3, 'T': 3, 'H': 5, 'M': 3}","{'Y': 3, 'A': 3, 'B': 1, 'D': 1, 'E': 1, 'G': 3, 'I': 1, 'K': 3, 'L': 1, 'N': 1, 'O': 1, 'U': 3, 'V': 1, 'W': 1, 'X': 1}"
INV-ZZ-6038346,SCH-ZZ-3158405,ZZ,ZZ20240509PNQBOM3772.0,3772.0,BAe 146,05/09/2024,2024-05-09 02:35:00,2024-05-09 09:59:00,PNQ,BOM,91.0,102,51,-40,51,9,18,27,36,10,5,4,5,20,10,8,10,30,15,12,15,43,21,15,22,"{'F': 5, 'P': 4}","{'C': 7, 'J': 5, 'Z': 5}","{'Q': 8, 'R': 5, 'S': 3, 'T': 3, 'H': 5, 'M': 3}","{'Y': 3, 'A': 3, 'B': 1, 'D': 1, 'E': 1, 'G': 3, 'I': 1, 'K': 3, 'L': 1, 'N': 1, 'O': 1, 'U': 3, 'V': 1, 'W': 1, 'X': 1}"
INV-ZZ-7332475,SCH-ZZ-3158405,ZZ,ZZ20240510PNQBOM3772.0,3772.0,BAe 146,05/10/2024,2024-05-10 02:35:00,2024-05-10 09:59:00,PNQ,BOM,91.0,108,62,-29,46,9,18,27,36,10,6,3,4,21,12,6,9,31,18,9,13,43,25,11,18,"{'F': 5, 'P': 4}","{'C': 7, 'J': 5, 'Z': 5}","{'Q': 8, 'R': 5, 'S': 3, 'T': 3, 'H': 5, 'M': 3}","{'Y': 3, 'A': 3, 'B': 1, 'D': 1, 'E': 1, 'G': 3, 'I': 1, 'K': 3, 'L': 1, 'N': 1, 'O': 1, 'U': 3, 'V': 1, 'W': 1, 'X': 1}"
INV-ZZ-4365648,SCH-ZZ-3158405,ZZ,ZZ20240512PNQBOM3772.0,3772.0,BAe 146,05/12/2024,2024-05-12 02:35:00,2024-05-12 09:59:00,PNQ,BOM,91.0,106,55,-36,51,9,18,27,36,10,5,4,5,20,10,8,10,31,16,11,15,40,21,15,19,"{'F': 5, 'P': 4}","{'C': 7, 'J': 5, 'Z': 5}","{'Q': 8, 'R': 5, 'S': 3, 'T': 3, 'H': 5, 'M': 3}","{'Y': 3, 'A': 3, 'B': 1, 'D': 1, 'E': 1, 'G': 3, 'I': 1, 'K': 3, 'L': 1, 'N': 1, 'O': 1, 'U': 3, 'V': 1, 'W': 1, 'X': 1}"
INV-ZZ-2564852,SCH-ZZ-3158405,ZZ,ZZ20240513PNQBOM3772.0,3772.0,BAe 146,05/13/2024,2024-05-13 02:35:00,2024-05-13 09:59:00,PNQ,BOM,91.0,102,54,-37,48,9,18,27,36,11,6,3,5,21,11,7,10,32,17,10,15,43,23,13,20,"{'F': 5, 'P': 4}","{'C': 7, 'J': 5, 'Z': 5}","{'Q': 8, 'R': 5, 'S': 3, 'T': 3, 'H': 5, 'M': 3}","{'Y': 3, 'A': 3, 'B': 1, 'D': 1, 'E': 1, 'G': 3, 'I': 1, 'K': 3, 'L': 1, 'N': 1, 'O': 1, 'U': 3, 'V': 1, 'W': 1, 'X': 1}"
INV-ZZ-5119777,SCH-ZZ-3158405,ZZ,ZZ20240515PNQBOM3772.0,3772.0,BAe 146,05/15/2024,2024-05-15 02:35:00,2024-05-15 09:59:00,PNQ,BOM,91.0,104,58,-33,46,9,18,27,36,10,6,3,4,20,11,7,9,32,18,9,14,43,24,12,19,"{'F': 5, 'P': 4}","{'C': 7, 'J': 5, 'Z': 5}","{'Q': 8, 'R': 5, 'S': 3, 'T': 3, 'H': 5, 'M': 3}","{'Y': 3, 'A': 3, 'B': 1, 'D': 1, 'E': 1, 'G': 3, 'I': 1, 'K': 3, 'L': 1, 'N': 1, 'O': 1, 'U': 3, 'V': 1, 'W': 1, 'X': 1}"
INV-ZZ-8626133,SCH-ZZ-3158405,ZZ,ZZ20240516PNQBOM3772.0,3772.0,BAe 146,05/16/2024,2024-05-16 02:35:00,2024-05-16 09:59:00,PNQ,BOM,91.0,108,57,-34,51,9,18,27,36,10,5,4,5,22,12,6,10,32,17,10,15,40,21,15,19,"{'F': 5, 'P': 4}","{'C': 7, 'J': 5, 'Z': 5}","{'Q': 8, 'R': 5, 'S': 3, 'T': 3, 'H': 5, 'M': 3}","{'Y': 3, 'A': 3, 'B': 1, 'D': 1, 'E': 1, 'G': 3, 'I': 1, 'K': 3, 'L': 1, 'N': 1, 'O': 1, 'U': 3, 'V': 1, 'W': 1, 'X': 1}"
INV-ZZ-3967264,SCH-ZZ-3158405,ZZ,ZZ20240517PNQBOM3772.0,3772.0,BAe 146,05/17/2024,2024-05-17 02:35:00,2024-05-17 09:59:00,PNQ,BOM,91.0,105,57,-34,48,9,18,27,36,11,6,3,5,22,12,6,10,31,17,10,14,43,23,13,20,"{'F': 5, 'P': 4}","{'C': 7, 'J': 5, 'Z': 5}","{'Q': 8, 'R': 5, 'S': 3, 'T': 3, 'H': 5, 'M': 3}","{'Y': 3, 'A': 3, 'B': 1, 'D': 1, 'E': 1, 'G': 3, 'I': 1, 'K': 3, 'L': 1, 'N': 1, 'O': 1, 'U': 3, 'V': 1, 'W': 1, 'X': 1}"
INV-ZZ-8194012,SCH-ZZ-3158405,ZZ,ZZ20240519PNQBOM3772.0,3772.0,BAe 146,05/19/2024,2024-05-19 02:35:00,2024-05-19 09:59:00,PNQ,BOM,91.0,102,55,-36,47,9,18,27,36,11,6,3,5,20,11,7,9,31,17,10,14,42,23,13,19,"{'F': 5, 'P': 4}","{'C': 7, 'J': 5, 'Z': 5}","{'Q': 8, 'R': 5, 'S': 3, 'T': 3, 'H': 5, 'M': 3}","{'Y': 3, 'A': 3, 'B': 1, 'D': 1, 'E': 1, 'G': 3, 'I': 1, 'K': 3, 'L': 1, 'N': 1, 'O': 1, 'U': 3, 'V': 1, 'W': 1, 'X': 1}"
INV-ZZ-5875053,SCH-ZZ-3158405,ZZ,ZZ20240520PNQBOM3772.0,3772.0,BAe 146,05/20/2024,2024-05-20 02:35:00,2024-05-20 09:59:00,PNQ,BOM,91.0,102,54,-37,48,9,18,27,36,10,5,4,5,20,11,7,9,31,16,11,15,42,22,14,20,"{'F': 5, 'P': 4}","{'C': 7, 'J': 5, 'Z': 5}","{'Q': 8, 'R': 5, 'S': 3, 'T': 3, 'H': 5, 'M': 3}","{'Y': 3, 'A': 3, 'B': 1, 'D': 1, 'E': 1, 'G': 3, 'I': 1, 'K': 3, 'L': 1, 'N': 1, 'O': 1, 'U': 3, 'V': 1, 'W': 1, 'X': 1}"
INV-ZZ-3554528,SCH-ZZ-3158405,ZZ,ZZ20240522PNQBOM3772.0,3772.0,BAe 146,05/22/2024,2024-05-22 02:35:00,2024-05-22 09:59:00,PNQ,BOM,91.0,108,54,-37,54,9,18,27,36,10,5,4,5,21,11,7,10,31,16,11,15,41,21,15,20,"{'F': 5, 'P': 4}","{'C': 7, 'J': 5, 'Z': 5}","{'Q': 8, 'R': 5, 'S': 3, 'T': 3, 'H': 5, 'M': 3}","{'Y': 3, 'A': 3, 'B': 1, 'D': 1, 'E': 1, 'G': 3, 'I': 1, 'K': 3, 'L': 1, 'N': 1, 'O': 1, 'U': 3, 'V': 1, 'W': 1, 'X': 1}"
INV-ZZ-5249649,SCH-ZZ-3158405,ZZ,ZZ20240523PNQBOM3772.0,3772.0,BAe 146,05/23/2024,2024-05-23 02:35:00,2024-05-23 09:59:00,PNQ,BOM,91.0,103,48,-43,55,9,18,27,36,10,5,4,5,21,10,8,11,32,15,12,17,43,20,16,23,"{'F': 5, 'P': 4}","{'C': 7, 'J': 5, 'Z': 5}","{'Q': 8, 'R': 5, 'S': 3, 'T': 3, 'H': 5, 'M': 3}","{'Y': 3, 'A': 3, 'B': 1, 'D': 1, 'E': 1, 'G': 3, 'I': 1, 'K': 3, 'L': 1, 'N': 1, 'O': 1, 'U': 3, 'V': 1, 'W': 1, 'X': 1}"
INV-ZZ-6417805,SCH-ZZ-3158405,ZZ,ZZ20240524PNQBOM3772.0,3772.0,BAe 146,05/24/2024,2024-05-24 02:35:00,2024-05-24 09:59:00,PNQ,BOM,91.0,101,54,-37,47,9,18,27,36,10,5,4,5,21,11,7,10,30,16,11,14,41,22,14,19,"{'F': 5, 'P': 4}","{'C': 7, 'J': 5, 'Z': 5}","{'Q': 8, 'R': 5, 'S': 3, 'T': 3, 'H': 5, 'M': 3}","{'Y': 3, 'A': 3, 'B': 1, 'D': 1, 'E': 1, 'G': 3, 'I': 1, 'K': 3, 'L': 1, 'N': 1, 'O': 1, 'U': 3, 'V': 1, 'W': 1, 'X': 1}"
INV-ZZ-2017203,SCH-ZZ-3158405,ZZ,ZZ20240526PNQBOM3772.0,3772.0,BAe 146,05/26/2024,2024-05-26 02:35:00,2024-05-26 09:59:00,PNQ,BOM,91.0,102,54,-37,48,9,18,27,36,10,5,4,5,21,11,7,10,30,16,11,14,41,22,14,19,"{'F': 5, 'P': 4}","{'C': 7, 'J': 5, 'Z': 5}","{'Q': 8, 'R': 5, 'S': 3, 'T': 3, 'H': 5, 'M': 3}","{'Y': 3, 'A': 3, 'B': 1, 'D': 1, 'E': 1, 'G': 3, 'I': 1, 'K': 3, 'L': 1, 'N': 1, 'O': 1, 'U': 3, 'V': 1, 'W': 1, 'X': 1}"
INV-ZZ-8290962,SCH-ZZ-3158405,ZZ,ZZ20240527PNQBOM3772.0,3772.0,BAe 146,05/27/2024,2024-05-27 02:35:00,2024-05-27 09:59:00,PNQ,BOM,91.0,101,47,-44,54,9,18,27,36,11,5,4,6,20,9,9,11,30,14,13,16,42,19,17,23,"{'F': 5, 'P': 4}","{'C': 7, 'J': 5, 'Z': 5}","{'Q': 8, 'R': 5, 'S': 3, 'T': 3, 'H': 5, 'M': 3}","{'Y': 3, 'A': 3, 'B': 1, 'D': 1, 'E': 1, 'G': 3, 'I': 1, 'K': 3, 'L': 1, 'N': 1, 'O': 1, 'U': 3, 'V': 1, 'W': 1, 'X': 1}"
INV-ZZ-2034266,SCH-ZZ-3158405,ZZ,ZZ20240529PNQBOM3772.0,3772.0,BAe 146,05/29/2024,2024-05-29 02:35:00,2024-05-29 09:59:00,PNQ,BOM,91.0,101,49,-42,52,9,18,27,36,10,5,4,5,20,10,8,10,32,16,11,16,42,20,16,22,"{'F': 5, 'P': 4}","{'C': 7, 'J': 5, 'Z': 5}","{'Q': 8, 'R': 5, 'S': 3, 'T': 3, 'H': 5, 'M': 3}","{'Y': 3, 'A': 3, 'B': 1, 'D': 1, 'E': 1, 'G': 3, 'I': 1, 'K': 3, 'L': 1, 'N': 1, 'O': 1, 'U': 3, 'V': 1, 'W': 1, 'X': 1}"
INV-ZZ-5255117,SCH-ZZ-3158405,ZZ,ZZ20240530PNQBOM3772.0,3772.0,BAe 146,05/30/2024,2024-05-30 02:35:00,2024-05-30 09:59:00,PNQ,BOM,91.0,106,53,-38,53,9,18,27,36,10,5,4,5,20,10,8,10,32,16,11,16,40,20,16,20,"{'F': 5, 'P': 4}","{'C': 7, 'J': 5, 'Z': 5}","{'Q': 8, 'R': 5, 'S': 3, 'T': 3, 'H': 5, 'M': 3}","{'Y': 3, 'A': 3, 'B': 1, 'D': 1, 'E': 1, 'G': 3, 'I': 1, 'K': 3, 'L': 1, 'N': 1, 'O': 1, 'U': 3, 'V': 1, 'W': 1, 'X': 1}"
INV-ZZ-5982679,SCH-ZZ-3158405,ZZ,ZZ20240531PNQBOM3772.0,3772.0,BAe 146,05/31/2024,2024-05-31 02:35:00,2024-05-31 09:59:00,PNQ,BOM,91.0,105,48,-43,57,9,18,27,36,10,5,4,5,21,10,8,11,32,14,13,18,43,19,17,24,"{'F': 5, 'P': 4}","{'C': 7, 'J': 5, 'Z': 5}","{'Q': 8, 'R': 5, 'S': 3, 'T': 3, 'H': 5, 'M': 3}","{'Y': 3, 'A': 3, 'B': 1, 'D': 1, 'E': 1, 'G': 3, 'I': 1, 'K': 3, 'L': 1, 'N': 1, 'O': 1, 'U': 3, 'V': 1, 'W': 1, 'X': 1}"
INV-ZZ-5687769,SCH-ZZ-3158405,ZZ,ZZ20240602PNQBOM3772.0,3772.0,BAe 146,06/02/2024,2024-06-02 02:35:00,2024-06-02 09:59:00,PNQ,BOM,91.0,105,52,-39,53,9,18,27,36,11,5,4,6,20,10,8,10,31,15,12,16,41,20,16,21,"{'F': 5, 'P': 4}","{'C': 7, 'J': 5, 'Z': 5}","{'Q': 8, 'R': 5, 'S': 3, 'T': 3, 'H': 5, 'M': 3}","{'Y': 3, 'A': 3, 'B': 1, 'D': 1, 'E': 1, 'G': 3, 'I': 1, 'K': 3, 'L': 1, 'N': 1, 'O': 1, 'U': 3, 'V': 1, 'W': 1, 'X': 1}"
INV-ZZ-8511673,SCH-ZZ-3158405,ZZ,ZZ20240603PNQBOM3772.0,3772.0,BAe 146,06/03/2024,2024-06-03 02:35:00,2024-06-03 09:59:00,PNQ,BOM,91.0,102,46,-45,56,9,18,27,36,10,5,4,5,21,10,8,11,31,14,13,17,43,19,17,24,"{'F': 5, 'P': 4}","{'C': 7, 'J': 5, 'Z': 5}","{'Q': 8, 'R': 5, 'S': 3, 'T': 3, 'H': 5, 'M': 3}","{'Y': 3, 'A': 3, 'B': 1, 'D': 1, 'E': 1, 'G': 3, 'I': 1, 'K': 3, 'L': 1, 'N': 1, 'O': 1, 'U': 3, 'V': 1, 'W': 1, 'X': 1}"
INV-ZZ-1260068,SCH-ZZ-3158405,ZZ,ZZ20240605PNQBOM3772.0,3772.0,BAe 146,06/05/2024,2024-06-05 02:35:00,2024-06-05 09:59:00,PNQ,BOM,91.0,105,53,-38,52,9,18,27,36,11,6,3,5,21,11,7,10,30,15,12,15,41,21,15,20,"{'F': 5, 'P': 4}","{'C': 7, 'J': 5, 'Z': 5}","{'Q': 8, 'R': 5, 'S': 3, 'T': 3, 'H': 5, 'M': 3}","{'Y': 3, 'A': 3, 'B': 1, 'D': 1, 'E': 1, 'G': 3, 'I': 1, 'K': 3, 'L': 1, 'N': 1, 'O': 1, 'U': 3, 'V': 1, 'W': 1, 'X': 1}"
INV-ZZ-4924634,SCH-ZZ-3158405,ZZ,ZZ20240606PNQBOM3772.0,3772.0,BAe 146,06/06/2024,2024-06-06 02:35:00,2024-06-06 09:59:00,PNQ,BOM,91.0,106,46,-45,60,9,18,27,36,10,4,5,6,21,9,9,12,32,14,13,18,43,19,17,24,"{'F': 5, 'P': 4}","{'C': 7, 'J': 5, 'Z': 5}","{'Q': 8, 'R': 5, 'S': 3, 'T': 3, 'H': 5, 'M': 3}","{'Y': 3, 'A': 3, 'B': 1, 'D': 1, 'E': 1, 'G': 3, 'I': 1, 'K': 3, 'L': 1, 'N': 1, 'O': 1, 'U': 3, 'V': 1, 'W': 1, 'X': 1}"
INV-ZZ-7915465,SCH-ZZ-3158405,ZZ,ZZ20240607PNQBOM3772.0,3772.0,BAe 146,06/07/2024,2024-06-07 02:35:00,2024-06-07 09:59:00,PNQ,BOM,91.0,107,52,-39,55,9,18,27,36,11,5,4,6,22,11,7,11,31,15,12,16,42,20,16,22,"{'F': 5, 'P': 4}","{'C': 7, 'J': 5, 'Z': 5}","{'Q': 8, 'R': 5, 'S': 3, 'T': 3, 'H': 5, 'M': 3}","{'Y': 3, 'A': 3, 'B': 1, 'D': 1, 'E': 1, 'G': 3, 'I': 1, 'K': 3, 'L': 1, 'N': 1, 'O': 1, 'U': 3, 'V': 1, 'W': 1, 'X': 1}"
INV-ZZ-4452541,SCH-ZZ-3158405,ZZ,ZZ20240609PNQBOM3772.0,3772.0,BAe 146,06/09/2024,2024-06-09 02:35:00,2024-06-09 09:59:00,PNQ,BOM,91.0,106,52,-39,54,9,18,27,36,10,5,4,5,21,10,8,11,32,16,11,16,43,21,15,22,"{'F': 5, 'P': 4}","{'C': 7, 'J': 5, 'Z': 5}","{'Q': 8, 'R': 5, 'S': 3, 'T': 3, 'H': 5, 'M': 3}","{'Y': 3, 'A': 3, 'B': 1, 'D': 1, 'E': 1, 'G': 3, 'I': 1, 'K': 3, 'L': 1, 'N': 1, 'O': 1, 'U': 3, 'V': 1, 'W': 1, 'X': 1}"
INV-ZZ-2662290,SCH-ZZ-3158405,ZZ,ZZ20240610PNQBOM3772.0,3772.0,BAe 146,06/10/2024,2024-06-10 02:35:00,2024-06-10 09:59:00,PNQ,BOM,91.0,104,46,-45,58,9,18,27,36,10,4,5,6,20,9,9,11,31,14,13,17,42,19,17,23,"{'F': 5, 'P': 4}","{'C': 7, 'J': 5, 'Z': 5}","{'Q': 8, 'R': 5, 'S': 3, 'T': 3, 'H': 5, 'M': 3}","{'Y': 3, 'A': 3, 'B': 1, 'D': 1, 'E': 1, 'G': 3, 'I': 1, 'K': 3, 'L': 1, 'N': 1, 'O': 1, 'U': 3, 'V': 1, 'W': 1, 'X': 1}"
INV-ZZ-6222897,SCH-ZZ-3930555,ZZ,ZZ20240412JAILKO4478.0,4478.0,Airbus A321-200,04/12/2024,2024-04-12 01:47:00,2024-04-12 19:45:00,JAI,LKO,200.0,220,141,-59,79,20,40,60,80,23,15,5,8,47,30,10,17,67,43,17,24,93,60,20,33,"{'F': 12, 'P': 8}","{'C': 16, 'J': 12, 'Z': 12}","{'Q': 18, 'R': 12, 'S': 6, 'T': 6, 'H': 12, 'M': 6}","{'Y': 6, 'A': 6, 'B': 3, 'D': 3, 'E': 3, 'G': 6, 'I': 3, 'K': 6, 'L': 3, 'N': 3, 'O': 3, 'U': 6, 'V': 3, 'W': 3, 'X': 3}"
INV-ZZ-6428032,SCH-ZZ-3930555,ZZ,ZZ20240415JAILKO4478.0,4478.0,Airbus A321-200,04/15/2024,2024-04-15 01:47:00,2024-04-15 19:45:00,JAI,LKO,200.0,238,144,-56,94,20,40,60,80,24,15,5,9,47,28,12,19,72,44,16,28,93,56,24,37,"{'F': 12, 'P': 8}","{'C': 16, 'J': 12, 'Z': 12}","{'Q': 18, 'R': 12, 'S': 6, 'T': 6, 'H': 12, 'M': 6}","{'Y': 6, 'A': 6, 'B': 3, 'D': 3, 'E': 3, 'G': 6, 'I': 3, 'K': 6, 'L': 3, 'N': 3, 'O': 3, 'U': 6, 'V': 3, 'W': 3, 'X': 3}"
INV-ZZ-7799468,SCH-ZZ-3930555,ZZ,ZZ20240419JAILKO4478.0,4478.0,Airbus A321-200,04/19/2024,2024-04-19 01:47:00,2024-04-19 19:45:00,JAI,LKO,200.0,239,143,-57,96,20,40,60,80,23,14,6,9,47,28,12,19,67,40,20,27,91,54,26,37,"{'F': 12, 'P': 8}","{'C': 16, 'J': 12, 'Z': 12}","{'Q': 18, 'R': 12, 'S': 6, 'T': 6, 'H': 12, 'M': 6}","{'Y': 6, 'A': 6, 'B': 3, 'D': 3, 'E': 3, 'G': 6, 'I': 3, 'K': 6, 'L': 3, 'N': 3, 'O': 3, 'U': 6, 'V': 3, 'W': 3, 'X': 3}"
INV-ZZ-7260164,SCH-ZZ-3930555,ZZ,ZZ20240422JAILKO4478.0,4478.0,Airbus A321-200,04/22/2024,2024-04-22 01:47:00,2024-04-22 19:45:00,JAI,LKO,200.0,220,125,-75,95,20,40,60,80,24,14,6,10,47,27,13,20,67,38,22,29,91,52,28,39,"{'F': 12, 'P': 8}","{'C': 16, 'J': 12, 'Z': 12}","{'Q': 18, 'R': 12, 'S': 6, 'T': 6, 'H': 12, 'M': 6}","{'Y': 6, 'A': 6, 'B': 3, 'D': 3, 'E': 3, 'G': 6, 'I': 3, 'K': 6, 'L': 3, 'N': 3, 'O': 3, 'U': 6, 'V': 3, 'W': 3, 'X': 3}"
INV-ZZ-9112042,SCH-ZZ-3930555,ZZ,ZZ20240426JAILKO4478.0,4478.0,Airbus A321-200,04/26/2024,2024-04-26 01:47:00,2024-04-26 19:45:00,JAI,LKO,200.0,236,130,-70,106,20,40,60,80,22,12,8,10,45,25,15,20,69,38,22,31,89,49,31,40,"{'F': 12, 'P': 8}","{'C': 16, 'J': 12, 'Z': 12}","{'Q': 18, 'R': 12, 'S': 6, 'T': 6, 'H': 12, 'M': 6}","{'Y': 6, 'A': 6, 'B': 3, 'D': 3, 'E': 3, 'G': 6, 'I': 3, 'K': 6, 'L': 3, 'N': 3, 'O': 3, 'U': 6, 'V': 3, 'W': 3, 'X': 3}"
INV-ZZ-8333447,SCH-ZZ-3930555,ZZ,ZZ20240429JAILKO4478.0,4478.0,Airbus A321-200,04/29/2024,2024-04-29 01:47:00,2024-04-29 19:45:00,JAI,LKO,200.0,220,117,-83,103,20,40,60,80,24,13,7,11,47,25,15,22,69,37,23,32,93,50,30,43,"{'F': 12, 'P': 8}","{'C': 16, 'J': 12, 'Z': 12}","{'Q': 18, 'R': 12, 'S': 6, 'T': 6, 'H': 12, 'M': 6}","{'Y': 6, 'A': 6, 'B': 3, 'D': 3, 'E': 3, 'G': 6, 'I': 3, 'K': 6, 'L': 3, 'N': 3, 'O': 3, 'U': 6, 'V': 3, 'W': 3, 'X': 3}"
INV-ZZ-1168864,SCH-ZZ-3930555,ZZ,ZZ20240503JAILKO4478.0,4478.0,Airbus A321-200,05/03/2024,2024-05-03 01:47:00,2024-05-03 19:45:00,JAI,LKO,200.0,221,130,-70,91,20,40,60,80,23,14,6,9,46,27,13,19,71,42,18,29,92,54,26,38,"{'F': 12, 'P': 8}","{'C': 16, 'J': 12, 'Z': 12}","{'Q': 18, 'R': 12, 'S': 6, 'T': 6, 'H': 12, 'M': 6}","{'Y': 6, 'A': 6, 'B': 3, 'D': 3, 'E': 3, 'G': 6, 'I': 3, 'K': 6, 'L': 3, 'N': 3, 'O': 3, 'U': 6, 'V': 3, 'W': 3, 'X': 3}"
INV-ZZ-9909265,SCH-ZZ-3930555,ZZ,ZZ20240506JAILKO4478.0,4478.0,Airbus A321-200,05/06/2024,2024-05-06 01:47:00,2024-05-06 19:45:00,JAI,LKO,200.0,237,128,-72,109,20,40,60,80,23,12,8,11,47,25,15,22,70,38,22,32,89,48,32,41,"{'F': 12, 'P': 8}","{'C': 16, 'J': 12, 'Z': 12}","{'Q': 18, 'R': 12, 'S': 6, 'T': 6, 'H': 12, 'M': 6}","{'Y': 6, 'A': 6, 'B': 3, 'D': 3, 'E': 3, 'G': 6, 'I': 3, 'K': 6, 'L': 3, 'N': 3, 'O': 3, 'U': 6, 'V': 3, 'W': 3, 'X': 3}"
INV-ZZ-3862434,SCH-ZZ-3930555,ZZ,ZZ20240510JAILKO4478.0,4478.0,Airbus A321-200,05/10/2024,2024-05-10 01:47:00,2024-05-10 19:45:00,JAI,LKO,200.0,236,123,-77,113,20,40,60,80,24,13,7,11,47,25,15,22,67,35,25,32,91,47,33,44,"{'F': 12, 'P': 8}","{'C': 16, 'J': 12, 'Z': 12}","{'Q': 18, 'R': 12, 'S': 6, 'T': 6, 'H': 12, 'M': 6}","{'Y': 6, 'A': 6, 'B': 3, 'D': 3, 'E': 3, 'G': 6, 'I': 3, 'K': 6, 'L': 3, 'N': 3, 'O': 3, 'U': 6, 'V': 3, 'W': 3, 'X': 3}"
INV-ZZ-4820206,SCH-ZZ-3930555,ZZ,ZZ20240513JAILKO4478.0,4478.0,Airbus A321-200,05/13/2024,2024-05-13 01:47:00,2024-05-13 19:45:00,JAI,LKO,200.0,231,122,-78,109,20,40,60,80,22,12,8,10,46,24,16,22,71,37,23,34,91,48,32,43,"{'F': 12, 'P': 8}","{'C': 16, 'J': 12, 'Z': 12}","{'Q': 18, 'R': 12, 'S': 6, 'T': 6, 'H': 12, 'M': 6}","{'Y': 6, 'A': 6, 'B': 3, 'D': 3, 'E': 3, 'G': 6, 'I': 3, 'K': 6, 'L': 3, 'N': 3, 'O': 3, 'U': 6, 'V': 3, 'W': 3, 'X': 3}"
INV-ZZ-8382616,SCH-ZZ-3930555,ZZ,ZZ20240517JAILKO4478.0,4478.0,Airbus A321-200,05/17/2024,2024-05-17 01:47:00,2024-05-17 19:45:00,JAI,LKO,200.0,230,120,-80,110,20,40,60,80,23,12,8,11,46,24,16,22,69,36,24,33,93,48,32,45,"{'F': 12, 'P': 8}","{'C': 16, 'J': 12, 'Z': 12}","{'Q': 18, 'R': 12, 'S': 6, 'T': 6, 'H': 12, 'M': 6}","{'Y': 6, 'A': 6, 'B': 3, 'D': 3, 'E': 3, 'G': 6, 'I': 3, 'K': 6, 'L': 3, 'N': 3, 'O': 3, 'U': 6, 'V': 3, 'W': 3, 'X': 3}"
INV-ZZ-7770967,SCH-ZZ-3930555,ZZ,ZZ20240520JAILKO4478.0,4478.0,Airbus A321-200,05/20/2024,2024-05-20 01:47:00,2024-05-20 19:45:00,JAI,LKO,200.0,225,118,-82,107,20,40,60,80,24,13,7,11,44,23,17,21,70,37,23,33,88,46,34,42,"{'F': 12, 'P': 8}","{'C': 16, 'J': 12, 'Z': 12}","{'Q': 18, 'R': 12, 'S': 6, 'T': 6, 'H': 12, 'M': 6}","{'Y': 6, 'A': 6, 'B': 3, 'D': 3, 'E': 3, 'G': 6, 'I': 3, 'K': 6, 'L': 3, 'N': 3, 'O': 3, 'U': 6, 'V': 3, 'W': 3, 'X': 3}"
INV-ZZ-9188114,SCH-ZZ-3930555,ZZ,ZZ20240524JAILKO4478.0,4478.0,Airbus A321-200,05/24/2024,2024-05-24 01:47:00,2024-05-24 19:45:00,JAI,LKO,200.0,230,118,-82,112,20,40,60,80,23,12,8,11,47,24,16,23,67,34,26,33,95,49,31,46,"{'F': 12, 'P': 8}","{'C': 16, 'J': 12, 'Z': 12}","{'Q': 18, 'R': 12, 'S': 6, 'T': 6, 'H': 12, 'M': 6}","{'Y': 6, 'A': 6, 'B': 3, 'D': 3, 'E': 3, 'G': 6, 'I': 3, 'K': 6, 'L': 3, 'N': 3, 'O': 3, 'U': 6, 'V': 3, 'W': 3, 'X': 3}"
INV-ZZ-8331935,SCH-ZZ-6755803,ZZ,ZZ20240502IDRHYD3455.0,3455.0,Boeing 777,05/02/2024,2024-05-02 03:41:00,2024-05-03 01:59:00,IDR,HYD,425.0,487,281,-144,206,42,85,127,170,47,27,15,20,98,57,28,41,143,83,44,60,197,114,56,83,"{'F': 25, 'P': 17}","{'C': 34, 'J': 26, 'Z': 26}","{'Q': 38, 'R': 25, 'S': 13, 'T': 13, 'H': 25, 'M': 13}","{'Y': 13, 'A': 13, 'B': 6, 'D': 6, 'E': 6, 'G': 13, 'I': 6, 'K': 13, 'L': 6, 'N': 6, 'O': 6, 'U': 13, 'V': 6, 'W': 6, 'X': 6}"
INV-ZZ-1798944,SCH-ZZ-6755803,ZZ,ZZ20240504IDRHYD3455.0,3455.0,Boeing 777,05/04/2024,2024-05-04 03:41:00,2024-05-05 01:59:00,IDR,HYD,425.0,469,256,-169,213,42,85,127,170,46,25,17,21,95,52,33,43,149,81,46,68,199,109,61,90,"{'F': 25, 'P': 17}","{'C': 34, 'J': 26, 'Z': 26}","{'Q': 38, 'R': 25, 'S': 13, 'T': 13, 'H': 25, 'M': 13}","{'Y': 13, 'A': 13, 'B': 6, 'D': 6, 'E': 6, 'G': 13, 'I': 6, 'K': 13, 'L': 6, 'N': 6, 'O': 6, 'U': 13, 'V': 6, 'W': 6, 'X': 6}"
INV-ZZ-2615332,SCH-ZZ-6755803,ZZ,ZZ20240507IDRHYD3455.0,3455.0,Boeing 777,05/07/2024,2024-05-07 03:41:00,2024-05-08 01:59:00,IDR,HYD,425.0,476,246,-179,230,42,85,127,170,48,25,17,23,98,51,34,47,147,76,51,71,201,104,66,97,"{'F': 25, 'P': 17}","{'C': 34, 'J': 26, 'Z': 26}","{'Q': 38, 'R': 25, 'S': 13, 'T': 13, 'H': 25, 'M': 13}","{'Y': 13, 'A': 13, 'B': 6, 'D': 6, 'E': 6, 'G': 13, 'I': 6, 'K': 13, 'L': 6, 'N': 6, 'O': 6, 'U': 13, 'V': 6, 'W': 6, 'X': 6}"
INV-ZZ-4698923,SCH-ZZ-6755803,ZZ,ZZ20240509IDRHYD3455.0,3455.0,Boeing 777,05/09/2024,2024-05-09 03:41:00,2024-05-10 01:59:00,IDR,HYD,425.0,498,282,-143,216,42,85,127,170,49,28,14,21,97,55,30,42,150,85,42,65,192,109,61,83,"{'F': 25, 'P': 17}","{'C': 34, 'J': 26, 'Z': 26}","{'Q': 38, 'R': 25, 'S': 13, 'T': 13, 'H': 25, 'M': 13}","{'Y': 13, 'A': 13, 'B': 6, 'D': 6, 'E': 6, 'G': 13, 'I': 6, 'K': 13, 'L': 6, 'N': 6, 'O': 6, 'U': 13, 'V': 6, 'W': 6, 'X': 6}"
INV-ZZ-7767976,SCH-ZZ-6755803,ZZ,ZZ20240511IDRHYD3455.0,3455.0,Boeing 777,05/11/2024,2024-05-11 03:41:00,2024-05-12 01:59:00,IDR,HYD,425.0,477,268,-157,209,42,85,127,170,49,27,15,22,96,54,31,42,143,80,47,63,191,107,63,84,"{'F': 25, 'P': 17}","{'C': 34, 'J': 26, 'Z': 26}","{'Q': 38, 'R': 25, 'S': 13, 'T': 13, 'H': 25, 'M': 13}","{'Y': 13, 'A': 13, 'B': 6, 'D': 6, 'E': 6, 'G': 13, 'I': 6, 'K': 13, 'L': 6, 'N': 6, 'O': 6, 'U': 13, 'V': 6, 'W': 6, 'X': 6}"
INV-ZZ-2287756,SCH-ZZ-6755803,ZZ,ZZ20240514IDRHYD3455.0,3455.0,Boeing 777,05/14/2024,2024-05-14 03:41:00,2024-05-15 01:59:00,IDR,HYD,425.0,474,245,-180,229,42,85,127,170,50,26,16,24,98,51,34,47,148,77,50,71,199,103,67,96,"{'F': 25, 'P': 17}","{'C': 34, 'J': 26, 'Z': 26}","{'Q': 38, 'R': 25, 'S': 13, 'T': 13, 'H': 25, 'M': 13}","{'Y': 13, 'A': 13, 'B': 6, 'D': 6, 'E': 6, 'G': 13, 'I': 6, 'K': 13, 'L': 6, 'N': 6, 'O': 6, 'U': 13, 'V': 6, 'W': 6, 'X': 6}"
INV-ZZ-4196048,SCH-ZZ-6755803,ZZ,ZZ20240516IDRHYD3455.0,3455.0,Boeing 777,05/16/2024,2024-05-16 03:41:00,2024-05-17 01:59:00,IDR,HYD,425.0,494,277,-148,217,42,85,127,170,50,28,14,22,95,53,32,42,140,79,48,61,194,109,61,85,"{'F': 25, 'P': 17}","{'C': 34, 'J': 26, 'Z': 26}","{'Q': 38, 'R': 25, 'S': 13, 'T': 13, 'H': 25, 'M': 13}","{'Y': 13, 'A': 13, 'B': 6, 'D': 6, 'E': 6, 'G': 13, 'I': 6, 'K': 13, 'L': 6, 'N': 6, 'O': 6, 'U': 13, 'V': 6, 'W': 6, 'X': 6}"
INV-ZZ-9877723,SCH-ZZ-6755803,ZZ,ZZ20240518IDRHYD3455.0,3455.0,Boeing 777,05/18/2024,2024-05-18 03:41:00,2024-05-19 01:59:00,IDR,HYD,425.0,487,259,-166,228,42,85,127,170,47,25,17,22,102,54,31,48,144,77,50,67,191,102,68,89,"{'F': 25, 'P': 17}","{'C': 34, 'J': 26, 'Z': 26}","{'Q': 38, 'R': 25, 'S': 13, 'T': 13, 'H': 25, 'M': 13}","{'Y': 13, 'A': 13, 'B': 6, 'D': 6, 'E': 6, 'G': 13, 'I': 6, 'K': 13, 'L': 6, 'N': 6, 'O': 6, 'U': 13, 'V': 6, 'W': 6, 'X': 6}"
INV-ZZ-5420790,SCH-ZZ-6755803,ZZ,ZZ20240521IDRHYD3455.0,3455.0,Boeing 777,05/21/2024,2024-05-21 03:41:00,2024-05-22 01:59:00,IDR,HYD,425.0,487,227,-198,260,42,85,127,170,47,22,20,25,102,48,37,54,149,69,58,80,191,89,81,102,"{'F': 25, 'P': 17}","{'C': 34, 'J': 26, 'Z': 26}","{'Q': 38, 'R': 25, 'S': 13, 'T': 13, 'H': 25, 'M': 13}","{'Y': 13, 'A': 13, 'B': 6, 'D': 6, 'E': 6, 'G': 13, 'I': 6, 'K': 13, 'L': 6, 'N': 6, 'O': 6, 'U': 13, 'V': 6, 'W': 6, 'X': 6}"
INV-ZZ-9084035,SCH-ZZ-6755803,ZZ,ZZ20240523IDRHYD3455.0,3455.0,Boeing 777,05/23/2024,2024-05-23 03:41:00,2024-05-24 01:59:00,IDR,HYD,425.0,498,237,-188,261,42,85,127,170,48,23,19,25,101,48,37,53,149,71,56,78,200,95,75,105,"{'F': 25, 'P': 17}","{'C': 34, 'J': 26, 'Z': 26}","{'Q': 38, 'R': 25, 'S': 13, 'T': 13, 'H': 25, 'M': 13}","{'Y': 13, 'A': 13, 'B': 6, 'D': 6, 'E': 6, 'G': 13, 'I': 6, 'K': 13, 'L': 6, 'N': 6, 'O': 6, 'U': 13, 'V': 6, 'W': 6, 'X': 6}"
INV-ZZ-5239878,SCH-ZZ-6755803,ZZ,ZZ20240525IDRHYD3455.0,3455.0,Boeing 777,05/25/2024,2024-05-25 03:41:00,2024-05-26 01:59:00,IDR,HYD,425.0,499,267,-158,232,42,85,127,170,48,26,16,22,99,53,32,46,141,75,52,66,202,108,62,94,"{'F': 25, 'P': 17}","{'C': 34, 'J': 26, 'Z': 26}","{'Q': 38, 'R': 25, 'S': 13, 'T': 13, 'H': 25, 'M': 13}","{'Y': 13, 'A': 13, 'B': 6, 'D': 6, 'E': 6, 'G': 13, 'I': 6, 'K': 13, 'L': 6, 'N': 6, 'O': 6, 'U': 13, 'V': 6, 'W': 6, 'X': 6}"
INV-ZZ-3577065,SCH-ZZ-6755803,ZZ,ZZ20240528IDRHYD3455.0,3455.0,Boeing 777,05/28/2024,2024-05-28 03:41:00,2024-05-29 01:59:00,IDR,HYD,425.0,481,233,-192,248,42,85,127,170,47,23,19,24,97,47,38,50,140,68,59,72,204,99,71,105,"{'F': 25, 'P': 17}","{'C': 34, 'J': 26, 'Z': 26}","{'Q': 38, 'R': 25, 'S': 13, 'T': 13, 'H': 25, 'M': 13}","{'Y': 13, 'A': 13, 'B': 6, 'D': 6, 'E': 6, 'G': 13, 'I': 6, 'K': 13, 'L': 6, 'N': 6, 'O': 6, 'U': 13, 'V': 6, 'W': 6, 'X': 6}"
INV-ZZ-7350302,SCH-ZZ-6755803,ZZ,ZZ20240530IDRHYD3455.0,3455.0,Boeing 777,05/30/2024,2024-05-30 03:41:00,2024-05-31 01:59:00,IDR,HYD,425.0,493,225,-200,268,42,85,127,170,48,22,20,26,95,43,42,52,152,69,58,83,202,92,78,110,"{'F': 25, 'P': 17}","{'C': 34, 'J': 26, 'Z': 26}","{'Q': 38, 'R': 25, 'S': 13, 'T': 13, 'H': 25, 'M': 13}","{'Y': 13, 'A': 13, 'B': 6, 'D': 6, 'E': 6, 'G': 13, 'I': 6, 'K': 13, 'L': 6, 'N': 6, 'O': 6, 'U': 13, 'V': 6, 'W': 6, 'X': 6}"
INV-ZZ-9441041,SCH-ZZ-6755803,ZZ,ZZ20240601IDRHYD3455.0,3455.0,Boeing 777,06/01/2024,2024-06-01 03:41:00,2024-06-02 01:59:00,IDR,HYD,425.0,471,242,-183,229,42,85,127,170,48,25,17,23,99,51,34,48,145,75,52,70,193,99,71,94,"{'F': 25, 'P': 17}","{'C': 34, 'J': 26, 'Z': 26}","{'Q': 38, 'R': 25, 'S': 13, 'T': 13, 'H': 25, 'M': 13}","{'Y': 13, 'A': 13, 'B': 6, 'D': 6, 'E': 6, 'G': 13, 'I': 6, 'K': 13, 'L': 6, 'N': 6, 'O': 6, 'U': 13, 'V': 6, 'W': 6, 'X': 6}"
INV-ZZ-3872802,SCH-ZZ-6755803,ZZ,ZZ20240604IDRHYD3455.0,3455.0,Boeing 777,06/04/2024,2024-06-04 03:41:00,2024-06-05 01:59:00,IDR,HYD,425.0,499,223,-202,276,42,85,127,170,49,22,20,27,98,44,41,54,142,63,64,79,192,86,84,106,"{'F': 25, 'P': 17}","{'C': 34, 'J': 26, 'Z': 26}","{'Q': 38, 'R': 25, 'S': 13, 'T': 13, 'H': 25, 'M': 13}","{'Y': 13, 'A': 13, 'B': 6, 'D': 6, 'E': 6, 'G': 13, 'I': 6, 'K': 13, 'L': 6, 'N': 6, 'O': 6, 'U': 13, 'V': 6, 'W': 6, 'X': 6}"
INV-ZZ-7207268,SCH-ZZ-6755803,ZZ,ZZ20240606IDRHYD3455.0,3455.0,Boeing 777,06/06/2024,2024-06-06 03:41:00,2024-06-07 01:59:00,IDR,HYD,425.0,490,231,-194,259,42,85,127,170,47,22,20,25,98,46,39,52,149,70,57,79,188,89,81,99,"{'F': 25, 'P': 17}","{'C': 34, 'J': 26, 'Z': 26}","{'Q': 38, 'R': 25, 'S': 13, 'T': 13, 'H': 25, 'M': 13}","{'Y': 13, 'A': 13, 'B': 6, 'D': 6, 'E': 6, 'G': 13, 'I': 6, 'K': 13, 'L': 6, 'N': 6, 'O': 6, 'U': 13, 'V': 6, 'W': 6, 'X': 6}"
INV-ZZ-8816275,SCH-ZZ-6755803,ZZ,ZZ20240608IDRHYD3455.0,3455.0,Boeing 777,06/08/2024,2024-06-08 03:41:00,2024-06-09 01:59:00,IDR,HYD,425.0,495,222,-203,273,42,85,127,170,47,21,21,26,95,43,42,52,149,67,60,82,194,87,83,107,"{'F': 25, 'P': 17}","{'C': 34, 'J': 26, 'Z': 26}","{'Q': 38, 'R': 25, 'S': 13, 'T': 13, 'H': 25, 'M': 13}","{'Y': 13, 'A': 13, 'B': 6, 'D': 6, 'E': 6, 'G': 13, 'I': 6, 'K': 13, 'L': 6, 'N': 6, 'O': 6, 'U': 13, 'V': 6, 'W': 6, 'X': 6}"
INV-ZZ-5569586,SCH-ZZ-6755803,ZZ,ZZ20240611IDRHYD3455.0,3455.0,Boeing 777,06/11/2024,2024-06-11 03:41:00,2024-06-12 01:59:00,IDR,HYD,425.0,496,230,-195,266,42,85,127,170,50,23,19,27,101,47,38,54,149,69,58,80,196,91,79,105,"{'F': 25, 'P': 17}","{'C': 34, 'J': 26, 'Z': 26}","{'Q': 38, 'R': 25, 'S': 13, 'T': 13, 'H': 25, 'M': 13}","{'Y': 13, 'A': 13, 'B': 6, 'D': 6, 'E': 6, 'G': 13, 'I': 6, 'K': 13, 'L': 6, 'N': 6, 'O': 6, 'U': 13, 'V': 6, 'W': 6, 'X': 6}"
INV-ZZ-8519614,SCH-ZZ-6755803,ZZ,ZZ20240613IDRHYD3455.0,3455.0,Boeing 777,06/13/2024,2024-06-13 03:41:00,2024-06-14 01:59:00,IDR,HYD,425.0,473,212,-213,261,42,85,127,170,49,22,20,27,96,43,42,53,148,66,61,82,187,84,86,103,"{'F': 25, 'P': 17}","{'C': 34, 'J': 26, 'Z': 26}","{'Q': 38, 'R': 25, 'S': 13, 'T': 13, 'H': 25, 'M': 13}","{'Y': 13, 'A': 13, 'B': 6, 'D': 6, 'E': 6, 'G': 13, 'I': 6, 'K': 13, 'L': 6, 'N': 6, 'O': 6, 'U': 13, 'V': 6, 'W': 6, 'X': 6}"
INV-ZZ-4067773,SCH-ZZ-6755803,ZZ,ZZ20240615IDRHYD3455.0,3455.0,Boeing 777,06/15/2024,2024-06-15 03:41:00,2024-06-16 01:59:00,IDR,HYD,425.0,485,221,-204,264,42,85,127,170,50,23,19,27,97,44,41,53,143,65,62,78,197,90,80,107,"{'F': 25, 'P': 17}","{'C': 34, 'J': 26, 'Z': 26}","{'Q': 38, 'R': 25, 'S': 13, 'T': 13, 'H': 25, 'M': 13}","{'Y': 13, 'A': 13, 'B': 6, 'D': 6, 'E': 6, 'G': 13, 'I': 6, 'K': 13, 'L': 6, 'N': 6, 'O': 6, 'U': 13, 'V': 6, 'W': 6, 'X': 6}"
INV-ZZ-6720664,SCH-ZZ-9315418,ZZ,ZZ20240515HYDIDR4830.0,4830.0,Boeing 767,05/15/2024,2024-05-15 05:19:00,2024-05-15 16:04:00,HYD,IDR,278.0,331,176,-102,155,27,55,83,111,30,16,11,14,63,33,22,30,94,50,33,44,128,68,43,60,"{'F': 16, 'P': 11}","{'C': 22, 'J': 16, 'Z': 16}","{'Q': 25, 'R': 17, 'S': 8, 'T': 8, 'H': 17, 'M': 8}","{'Y': 8, 'A': 8, 'B': 4, 'D': 4, 'E': 4, 'G': 8, 'I': 4, 'K': 8, 'L': 4, 'N': 4, 'O': 4, 'U': 8, 'V': 4, 'W': 4, 'X': 4}"
INV-ZZ-3080467,SCH-ZZ-9315418,ZZ,ZZ20240517HYDIDR4830.0,4830.0,Boeing 767,05/17/2024,2024-05-17 05:19:00,2024-05-17 16:04:00,HYD,IDR,278.0,321,160,-118,161,27,55,83,111,30,15,12,15,66,33,22,33,96,48,35,48,129,64,47,65,"{'F': 16, 'P': 11}","{'C': 22, 'J': 16, 'Z': 16}","{'Q': 25, 'R': 17, 'S': 8, 'T': 8, 'H': 17, 'M': 8}","{'Y': 8, 'A': 8, 'B': 4, 'D': 4, 'E': 4, 'G': 8, 'I': 4, 'K': 8, 'L': 4, 'N': 4, 'O': 4, 'U': 8, 'V': 4, 'W': 4, 'X': 4}"
INV-ZZ-1775500,SCH-ZZ-9315418,ZZ,ZZ20240518HYDIDR4830.0,4830.0,Boeing 767,05/18/2024,2024-05-18 05:19:00,2024-05-18 16:04:00,HYD,IDR,278.0,306,146,-132,160,27,55,83,111,32,15,12,17,65,31,24,34,95,45,38,50,123,59,52,64,"{'F': 16, 'P': 11}","{'C': 22, 'J': 16, 'Z': 16}","{'Q': 25, 'R': 17, 'S': 8, 'T': 8, 'H': 17, 'M': 8}","{'Y': 8, 'A': 8, 'B': 4, 'D': 4, 'E': 4, 'G': 8, 'I': 4, 'K': 8, 'L': 4, 'N': 4, 'O': 4, 'U': 8, 'V': 4, 'W': 4, 'X': 4}"
INV-ZZ-7751790,SCH-ZZ-9315418,ZZ,ZZ20240520HYDIDR4830.0,4830.0,Boeing 767,05/20/2024,2024-05-20 05:19:00,2024-05-20 16:04:00,HYD,IDR,278.0,311,146,-132,165,27,55,83,111,32,15,12,17,64,30,25,34,92,43,40,49,132,62,49,70,"{'F': 16, 'P': 11}","{'C': 22, 'J': 16, 'Z': 16}","{'Q': 25, 'R': 17, 'S': 8, 'T': 8, 'H': 17, 'M': 8}","{'Y': 8, 'A': 8, 'B': 4, 'D': 4, 'E': 4, 'G': 8, 'I': 4, 'K': 8, 'L': 4, 'N': 4, 'O': 4, 'U': 8, 'V': 4, 'W': 4, 'X': 4}"
INV-ZZ-3643481,SCH-ZZ-9315418,ZZ,ZZ20240522HYDIDR4830.0,4830.0,Boeing 767,05/22/2024,2024-05-22 05:19:00,2024-05-22 16:04:00,HYD,IDR,278.0,318,153,-125,165,27,55,83,111,31,15,12,16,61,29,26,32,94,45,38,49,133,64,47,69,"{'F': 16, 'P': 11}","{'C': 22, 'J': 16, 'Z': 16}","{'Q': 25, 'R': 17, 'S': 8, 'T': 8, 'H': 17, 'M': 8}","{'Y': 8, 'A': 8, 'B': 4, 'D': 4, 'E': 4, 'G': 8, 'I': 4, 'K': 8, 'L': 4, 'N': 4, 'O': 4, 'U': 8, 'V': 4, 'W': 4, 'X': 4}"
INV-ZZ-3899938,SCH-ZZ-9315418,ZZ,ZZ20240524HYDIDR4830.0,4830.0,Boeing 767,05/24/2024,2024-05-24 05:19:00,2024-05-24 16:04:00,HYD,IDR,278.0,322,170,-108,152,27,55,83,111,32,17,10,15,62,33,22,29,91,48,35,43,132,70,41,62,"{'F': 16, 'P': 11}","{'C': 22, 'J': 16, 'Z': 16}","{'Q': 25, 'R': 17, 'S': 8, 'T': 8, 'H': 17, 'M': 8}","{'Y': 8, 'A': 8, 'B': 4, 'D': 4, 'E': 4, 'G': 8, 'I': 4, 'K': 8, 'L': 4, 'N': 4, 'O': 4, 'U': 8, 'V': 4, 'W': 4, 'X': 4}"
INV-ZZ-2506368,SCH-ZZ-9315418,ZZ,ZZ20240525HYDIDR4830.0,4830.0,Boeing 767,05/25/2024,2024-05-25 05:19:00,2024-05-25 16:04:00,HYD,IDR,278.0,317,164,-114,153,27,55,83,111,30,15,12,15,61,32,23,29,96,50,33,46,122,63,48,59,"{'F': 16, 'P': 11}","{'C': 22, 'J': 16, 'Z': 16}","{'Q': 25, 'R': 17, 'S': 8, 'T': 8, 'H': 17, 'M': 8}","{'Y': 8, 'A': 8, 'B': 4, 'D': 4, 'E': 4, 'G': 8, 'I': 4, 'K': 8, 'L': 4, 'N': 4, 'O': 4, 'U': 8, 'V': 4, 'W': 4, 'X': 4}"
INV-ZZ-1377262,SCH-ZZ-9315418,ZZ,ZZ20240527HYDIDR4830.0,4830.0,Boeing 767,05/27/2024,2024-05-27 05:19:00,2024-05-27 16:04:00,HYD,IDR,278.0,330,163,-115,167,27,55,83,111,30,15,12,15,63,31,24,32,95,47,36,48,133,66,45,67,"{'F': 16, 'P': 11}","{'C': 22, 'J': 16, 'Z': 16}","{'Q': 25, 'R': 17, 'S': 8, 'T': 8, 'H': 17, 'M': 8}","{'Y': 8, 'A': 8, 'B': 4, 'D': 4, 'E': 4, 'G': 8, 'I': 4, 'K': 8, 'L': 4, 'N': 4, 'O': 4, 'U': 8, 'V': 4, 'W': 4, 'X': 4}"
INV-ZZ-8406042,SCH-ZZ-9315418,ZZ,ZZ20240529HYDIDR4830.0,4830.0,Boeing 767,05/29/2024,2024-05-29 05:19:00,2024-05-29 16:04:00,HYD,IDR,278.0,322,161,-117,161,27,55,83,111,31,15,12,16,61,30,25,31,92,46,37,46,132,66,45,66,"{'F': 16, 'P': 11}","{'C': 22, 'J': 16, 'Z': 16}","{'Q': 25, 'R': 17, 'S': 8, 'T': 8, 'H': 17, 'M': 8}","{'Y': 8, 'A': 8, 'B': 4, 'D': 4, 'E': 4, 'G': 8, 'I': 4, 'K': 8, 'L': 4, 'N': 4, 'O': 4, 'U': 8, 'V': 4, 'W': 4, 'X': 4}"
INV-ZZ-2620425,SCH-ZZ-9315418,ZZ,ZZ20240531HYDIDR4830.0,4830.0,Boeing 767,05/31/2024,2024-05-31 05:19:00,2024-05-31 16:04:00,HYD,IDR,278.0,327,148,-130,179,27,55,83,111,31,14,13,17,64,29,26,35,94,43,40,51,123,56,55,67,"{'F': 16, 'P': 11}","{'C': 22, 'J': 16, 'Z': 16}","{'Q': 25, 'R': 17, 'S': 8, 'T': 8, 'H': 17, 'M': 8}","{'Y': 8, 'A': 8, 'B': 4, 'D': 4, 'E': 4, 'G': 8, 'I': 4, 'K': 8, 'L': 4, 'N': 4, 'O': 4, 'U': 8, 'V': 4, 'W': 4, 'X': 4}"
INV-ZZ-3313187,SCH-ZZ-9315418,ZZ,ZZ20240601HYDIDR4830.0,4830.0,Boeing 767,06/01/2024,2024-06-01 05:19:00,2024-06-01 16:04:00,HYD,IDR,278.0,323,165,-113,158,27,55,83,111,30,15,12,15,64,33,22,31,93,48,35,45,130,67,44,63,"{'F': 16, 'P': 11}","{'C': 22, 'J': 16, 'Z': 16}","{'Q': 25, 'R': 17, 'S': 8, 'T': 8, 'H': 17, 'M': 8}","{'Y': 8, 'A': 8, 'B': 4, 'D': 4, 'E': 4, 'G': 8, 'I': 4, 'K': 8, 'L': 4, 'N': 4, 'O': 4, 'U': 8, 'V': 4, 'W': 4, 'X': 4}"
INV-ZZ-2708419,SCH-ZZ-9315418,ZZ,ZZ20240603HYDIDR4830.0,4830.0,Boeing 767,06/03/2024,2024-06-03 05:19:00,2024-06-03 16:04:00,HYD,IDR,278.0,318,146,-132,172,27,55,83,111,32,15,12,17,62,29,26,33,97,45,38,52,127,58,53,69,"{'F': 16, 'P': 11}","{'C': 22, 'J': 16, 'Z': 16}","{'Q': 25, 'R': 17, 'S': 8, 'T': 8, 'H': 17, 'M': 8}","{'Y': 8, 'A': 8, 'B': 4, 'D': 4, 'E': 4, 'G': 8, 'I': 4, 'K': 8, 'L': 4, 'N': 4, 'O': 4, 'U': 8, 'V': 4, 'W': 4, 'X': 4}"
INV-ZZ-1072764,SCH-ZZ-9315418,ZZ,ZZ20240605HYDIDR4830.0,4830.0,Boeing 767,06/05/2024,2024-06-05 05:19:00,2024-06-05 16:04:00,HYD,IDR,278.0,323,147,-131,176,27,55,83,111,32,15,12,17,63,29,26,34,97,44,39,53,123,56,55,67,"{'F': 16, 'P': 11}","{'C': 22, 'J': 16, 'Z': 16}","{'Q': 25, 'R': 17, 'S': 8, 'T': 8, 'H': 17, 'M': 8}","{'Y': 8, 'A': 8, 'B': 4, 'D': 4, 'E': 4, 'G': 8, 'I': 4, 'K': 8, 'L': 4, 'N': 4, 'O': 4, 'U': 8, 'V': 4, 'W': 4, 'X': 4}"
INV-ZZ-2878641,SCH-ZZ-9315418,ZZ,ZZ20240607HYDIDR4830.0,4830.0,Boeing 767,06/07/2024,2024-06-07 05:19:00,2024-06-07 16:04:00,HYD,IDR,278.0,312,137,-141,175,27,55,83,111,30,13,14,17,63,28,27,35,93,41,42,52,130,57,54,73,"{'F': 16, 'P': 11}","{'C': 22, 'J': 16, 'Z': 16}","{'Q': 25, 'R': 17, 'S': 8, 'T': 8, 'H': 17, 'M': 8}","{'Y': 8, 'A': 8, 'B': 4, 'D': 4, 'E': 4, 'G': 8, 'I': 4, 'K': 8, 'L': 4, 'N': 4, 'O': 4, 'U': 8, 'V': 4, 'W': 4, 'X': 4}"
INV-ZZ-9697499,SCH-ZZ-9315418,ZZ,ZZ20240608HYDIDR4830.0,4830.0,Boeing 767,06/08/2024,2024-06-08 05:19:00,2024-06-08 16:04:00,HYD,IDR,278.0,318,141,-137,177,27,55,83,111,31,14,13,17,65,29,26,36,98,43,40,55,127,56,55,71,"{'F': 16, 'P': 11}","{'C': 22, 'J': 16, 'Z': 16}","{'Q': 25, 'R': 17, 'S': 8, 'T': 8, 'H': 17, 'M': 8}","{'Y': 8, 'A': 8, 'B': 4, 'D': 4, 'E': 4, 'G': 8, 'I': 4, 'K': 8, 'L': 4, 'N': 4, 'O': 4, 'U': 8, 'V': 4, 'W': 4, 'X': 4}"
INV-ZZ-9462372,SCH-ZZ-9315418,ZZ,ZZ20240610HYDIDR4830.0,4830.0,Boeing 767,06/10/2024,2024-06-10 05:19:00,2024-06-10 16:04:00,HYD,IDR,278.0,314,145,-133,169,27,55,83,111,30,14,13,16,64,29,26,35,91,42,41,49,129,59,52,70,"{'F': 16, 'P': 11}","{'C': 22, 'J': 16, 'Z': 16}","{'Q': 25, 'R': 17, 'S': 8, 'T': 8, 'H': 17, 'M': 8}","{'Y': 8, 'A': 8, 'B': 4, 'D': 4, 'E': 4, 'G': 8, 'I': 4, 'K': 8, 'L': 4, 'N': 4, 'O': 4, 'U': 8, 'V': 4, 'W': 4, 'X': 4}"
INV-ZZ-6670395,SCH-ZZ-9315418,ZZ,ZZ20240612HYDIDR4830.0,4830.0,Boeing 767,06/12/2024,2024-06-12 05:19:00,2024-06-12 16:04:00,HYD,IDR,278.0,329,137,-141,192,27,55,83,111,32,13,14,19,64,27,28,37,93,39,44,54,122,51,60,71,"{'F': 16, 'P': 11}","{'C': 22, 'J': 16, 'Z': 16}","{'Q': 25, 'R': 17, 'S': 8, 'T': 8, 'H': 17, 'M': 8}","{'Y': 8, 'A': 8, 'B': 4, 'D': 4, 'E': 4, 'G': 8, 'I': 4, 'K': 8, 'L': 4, 'N': 4, 'O': 4, 'U': 8, 'V': 4, 'W': 4, 'X': 4}"
INV-ZZ-7226365,SCH-ZZ-9315418,ZZ,ZZ20240614HYDIDR4830.0,4830.0,Boeing 767,06/14/2024,2024-06-14 05:19:00,2024-06-14 16:04:00,HYD,IDR,278.0,327,140,-138,187,27,55,83,111,31,13,14,18,65,28,27,37,92,40,43,52,130,56,55,74,"{'F': 16, 'P': 11}","{'C': 22, 'J': 16, 'Z': 16}","{'Q': 25, 'R': 17, 'S': 8, 'T': 8, 'H': 17, 'M': 8}","{'Y': 8, 'A': 8, 'B': 4, 'D': 4, 'E': 4, 'G': 8, 'I': 4, 'K': 8, 'L': 4, 'N': 4, 'O': 4, 'U': 8, 'V': 4, 'W': 4, 'X': 4}"
INV-ZZ-4485967,SCH-ZZ-9315418,ZZ,ZZ20240615HYDIDR4830.0,4830.0,Boeing 767,06/15/2024,2024-06-15 05:19:00,2024-06-15 16:04:00,HYD,IDR,278.0,314,148,-130,166,27,55,83,111,31,15,12,16,63,30,25,33,97,46,37,51,133,63,48,70,"{'F': 16, 'P': 11}","{'C': 22, 'J': 16, 'Z': 16}","{'Q': 25, 'R': 17, 'S': 8, 'T': 8, 'H': 17, 'M': 8}","{'Y': 8, 'A': 8, 'B': 4, 'D': 4, 'E': 4, 'G': 8, 'I': 4, 'K': 8, 'L': 4, 'N': 4, 'O': 4, 'U': 8, 'V': 4, 'W': 4, 'X': 4}"
INV-ZZ-9367944,SCH-ZZ-9315418,ZZ,ZZ20240617HYDIDR4830.0,4830.0,Boeing 767,06/17/2024,2024-06-17 05:19:00,2024-06-17 16:04:00,HYD,IDR,278.0,319,146,-132,173,27,55,83,111,32,15,12,17,62,28,27,34,97,44,39,53,124,57,54,67,"{'F': 16, 'P': 11}","{'C': 22, 'J': 16, 'Z': 16}","{'Q': 25, 'R': 17, 'S': 8, 'T': 8, 'H': 17, 'M': 8}","{'Y': 8, 'A': 8, 'B': 4, 'D': 4, 'E': 4, 'G': 8, 'I': 4, 'K': 8, 'L': 4, 'N': 4, 'O': 4, 'U': 8, 'V': 4, 'W': 4, 'X': 4}"
INV-ZZ-1801151,SCH-ZZ-9315418,ZZ,ZZ20240619HYDIDR4830.0,4830.0,Boeing 767,06/19/2024,2024-06-19 05:19:00,2024-06-19 16:04:00,HYD,IDR,278.0,325,141,-137,184,27,55,83,111,31,13,14,18,61,27,28,34,96,42,41,54,123,54,57,69,"{'F': 16, 'P': 11}","{'C': 22, 'J': 16, 'Z': 16}","{'Q': 25, 'R': 17, 'S': 8, 'T': 8, 'H': 17, 'M': 8}","{'Y': 8, 'A': 8, 'B': 4, 'D': 4, 'E': 4, 'G': 8, 'I': 4, 'K': 8, 'L': 4, 'N': 4, 'O': 4, 'U': 8, 'V': 4, 'W': 4, 'X': 4}"
INV-ZZ-4249667,SCH-ZZ-9315418,ZZ,ZZ20240621HYDIDR4830.0,4830.0,Boeing 767,06/21/2024,2024-06-21 05:19:00,2024-06-21 16:04:00,HYD,IDR,278.0,311,131,-147,180,27,55,83,111,31,13,14,18,62,26,29,36,94,40,43,54,124,52,59,72,"{'F': 16, 'P': 11}","{'C': 22, 'J': 16, 'Z': 16}","{'Q': 25, 'R': 17, 'S': 8, 'T': 8, 'H': 17, 'M': 8}","{'Y': 8, 'A': 8, 'B': 4, 'D': 4, 'E': 4, 'G': 8, 'I': 4, 'K': 8, 'L': 4, 'N': 4, 'O': 4, 'U': 8, 'V': 4, 'W': 4, 'X': 4}"
INV-ZZ-8212018,SCH-ZZ-9315418,ZZ,ZZ20240622HYDIDR4830.0,4830.0,Boeing 767,06/22/2024,2024-06-22 05:19:00,2024-06-22 16:04:00,HYD,IDR,278.0,308,139,-139,169,27,55,83,111,32,14,13,18,66,30,25,36,94,43,40,51,123,56,55,67,"{'F': 16, 'P': 11}","{'C': 22, 'J': 16, 'Z': 16}","{'Q': 25, 'R': 17, 'S': 8, 'T': 8, 'H': 17, 'M': 8}","{'Y': 8, 'A': 8, 'B': 4, 'D': 4, 'E': 4, 'G': 8, 'I': 4, 'K': 8, 'L': 4, 'N': 4, 'O': 4, 'U': 8, 'V': 4, 'W': 4, 'X': 4}"
INV-ZZ-3805888,SCH-ZZ-9315418,ZZ,ZZ20240624HYDIDR4830.0,4830.0,Boeing 767,06/24/2024,2024-06-24 05:19:00,2024-06-24 16:04:00,HYD,IDR,278.0,318,136,-142,182,27,55,83,111,31,13,14,18,63,27,28,36,95,41,42,54,126,54,57,72,"{'F': 16, 'P': 11}","{'C': 22, 'J': 16, 'Z': 16}","{'Q': 25, 'R': 17, 'S': 8, 'T': 8, 'H': 17, 'M': 8}","{'Y': 8, 'A': 8, 'B': 4, 'D': 4, 'E': 4, 'G': 8, 'I': 4, 'K': 8, 'L': 4, 'N': 4, 'O': 4, 'U': 8, 'V': 4, 'W': 4, 'X': 4}"
INV-ZZ-5455074,SCH-ZZ-9315418,ZZ,ZZ20240626HYDIDR4830.0,4830.0,Boeing 767,06/26/2024,2024-06-26 05:19:00,2024-06-26 16:04:00,HYD,IDR,278.0,319,133,-145,186,27,55,83,111,32,13,14,19,65,27,28,38,97,40,43,57,131,55,56,76,"{'F': 16, 'P': 11}","{'C': 22, 'J': 16, 'Z': 16}","{'Q': 25, 'R': 17, 'S': 8, 'T': 8, 'H': 17, 'M': 8}","{'Y': 8, 'A': 8, 'B': 4, 'D': 4, 'E': 4, 'G': 8, 'I': 4, 'K': 8, 'L': 4, 'N': 4, 'O': 4, 'U': 8, 'V': 4, 'W': 4, 'X': 4}"
INV-ZZ-9414256,SCH-ZZ-9315418,ZZ,ZZ20240628HYDIDR4830.0,4830.0,Boeing 767,06/28/2024,2024-06-28 05:19:00,2024-06-28 16:04:00,HYD,IDR,278.0,322,123,-155,199,27,55,83,111,30,11,16,19,63,24,31,39,97,37,46,60,133,51,60,82,"{'F': 16, 'P': 11}","{'C': 22, 'J': 16, 'Z': 16}","{'Q': 25, 'R': 17, 'S': 8, 'T': 8, 'H': 17, 'M': 8}","{'Y': 8, 'A': 8, 'B': 4, 'D': 4, 'E': 4, 'G': 8, 'I': 4, 'K': 8, 'L': 4, 'N': 4, 'O': 4, 'U': 8, 'V': 4, 'W': 4, 'X': 4}"
INV-ZZ-5526073,SCH-ZZ-9315418,ZZ,ZZ20240629HYDIDR4830.0,4830.0,Boeing 767,06/29/2024,2024-06-29 05:19:00,2024-06-29 16:04:00,HYD,IDR,278.0,322,135,-143,187,27,55,83,111,32,13,14,19,65,27,28,38,93,39,44,54,130,54,57,76,"{'F': 16, 'P': 11}","{'C': 22, 'J': 16, 'Z': 16}","{'Q': 25, 'R': 17, 'S': 8, 'T': 8, 'H': 17, 'M': 8}","{'Y': 8, 'A': 8, 'B': 4, 'D': 4, 'E': 4, 'G': 8, 'I': 4, 'K': 8, 'L': 4, 'N': 4, 'O': 4, 'U': 8, 'V': 4, 'W': 4, 'X': 4}"
INV-ZZ-1103211,SCH-ZZ-6536717,ZZ,ZZ20240405GAUBOM2526.0,2526.0,Boeing 717,04/05/2024,2024-04-05 15:59:00,2024-04-06 05:45:00,GAU,BOM,100.0,119,69,-31,50,10,20,30,40,11,6,4,5,23,13,7,10,33,19,11,14,45,26,14,19,"{'F': 6, 'P': 4}","{'C': 8, 'J': 6, 'Z': 6}","{'Q': 9, 'R': 6, 'S': 3, 'T': 3, 'H': 6, 'M': 3}","{'Y': 3, 'A': 3, 'B': 2, 'D': 2, 'E': 2, 'G': 3, 'I': 2, 'K': 3, 'L': 2, 'N': 2, 'O': 2, 'U': 3, 'V': 2, 'W': 2, 'X': 2}"
INV-ZZ-2471440,SCH-ZZ-6536717,ZZ,ZZ20240408GAUBOM2526.0,2526.0,Boeing 717,04/08/2024,2024-04-08 15:59:00,2024-04-09 05:45:00,GAU,BOM,100.0,118,76,-24,42,10,20,30,40,12,8,2,4,24,16,4,8,33,21,9,12,45,29,11,16,"{'F': 6, 'P': 4}","{'C': 8, 'J': 6, 'Z': 6}","{'Q': 9, 'R': 6, 'S': 3, 'T': 3, 'H': 6, 'M': 3}","{'Y': 3, 'A': 3, 'B': 2, 'D': 2, 'E': 2, 'G': 3, 'I': 2, 'K': 3, 'L': 2, 'N': 2, 'O': 2, 'U': 3, 'V': 2, 'W': 2, 'X': 2}"
INV-ZZ-2239263,SCH-ZZ-6536717,ZZ,ZZ20240409GAUBOM2526.0,2526.0,Boeing 717,04/09/2024,2024-04-09 15:59:00,2024-04-10 05:45:00,GAU,BOM,100.0,118,72,-28,46,10,20,30,40,12,7,3,5,22,13,7,9,35,21,9,14,48,29,11,19,"{'F': 6, 'P': 4}","{'C': 8, 'J': 6, 'Z': 6}","{'Q': 9, 'R': 6, 'S': 3, 'T': 3, 'H': 6, 'M': 3}","{'Y': 3, 'A': 3, 'B': 2, 'D': 2, 'E': 2, 'G': 3, 'I': 2, 'K': 3, 'L': 2, 'N': 2, 'O': 2, 'U': 3, 'V': 2, 'W': 2, 'X': 2}"
INV-ZZ-3255905,SCH-ZZ-6536717,ZZ,ZZ20240412GAUBOM2526.0,2526.0,Boeing 717,04/12/2024,2024-04-12 15:59:00,2024-04-13 05:45:00,GAU,BOM,100.0,113,73,-27,40,10,20,30,40,12,8,2,4,24,16,4,8,34,22,8,12,47,31,9,16,"{'F': 6, 'P': 4}","{'C': 8, 'J': 6, 'Z': 6}","{'Q': 9, 'R': 6, 'S': 3, 'T': 3, 'H': 6, 'M': 3}","{'Y': 3, 'A': 3, 'B': 2, 'D': 2, 'E': 2, 'G': 3, 'I': 2, 'K': 3, 'L': 2, 'N': 2, 'O': 2, 'U': 3, 'V': 2, 'W': 2, 'X': 2}"
INV-ZZ-8404087,SCH-ZZ-6536717,ZZ,ZZ20240415GAUBOM2526.0,2526.0,Boeing 717,04/15/2024,2024-04-15 15:59:00,2024-04-16 05:45:00,GAU,BOM,100.0,114,63,-37,51,10,20,30,40,11,6,4,5,23,13,7,10,33,18,12,15,47,26,14,21,"{'F': 6, 'P': 4}","{'C': 8, 'J': 6, 'Z': 6}","{'Q': 9, 'R': 6, 'S': 3, 'T': 3, 'H': 6, 'M': 3}","{'Y': 3, 'A': 3, 'B': 2, 'D': 2, 'E': 2, 'G': 3, 'I': 2, 'K': 3, 'L': 2, 'N': 2, 'O': 2, 'U': 3, 'V': 2, 'W': 2, 'X': 2}"
INV-ZZ-7499978,SCH-ZZ-6536717,ZZ,ZZ20240416GAUBOM2526.0,2526.0,Boeing 717,04/16/2024,2024-04-16 15:59:00,2024-04-17 05:45:00,GAU,BOM,100.0,112,67,-33,45,10,20,30,40,11,7,3,4,22,13,7,9,36,21,9,15,45,27,13,18,"{'F': 6, 'P': 4}","{'C': 8, 'J': 6, 'Z': 6}","{'Q': 9, 'R': 6, 'S': 3, 'T': 3, 'H': 6, 'M': 3}","{'Y': 3, 'A': 3, 'B': 2, 'D': 2, 'E': 2, 'G': 3, 'I': 2, 'K': 3, 'L': 2, 'N': 2, 'O': 2, 'U': 3, 'V': 2, 'W': 2, 'X': 2}"
INV-ZZ-8229073,SCH-ZZ-6536717,ZZ,ZZ20240419GAUBOM2526.0,2526.0,Boeing 717,04/19/2024,2024-04-19 15:59:00,2024-04-20 05:45:00,GAU,BOM,100.0,117,68,-32,49,10,20,30,40,12,7,3,5,24,14,6,10,34,20,10,14,46,27,13,19,"{'F': 6, 'P': 4}","{'C': 8, 'J': 6, 'Z': 6}","{'Q': 9, 'R': 6, 'S': 3, 'T': 3, 'H': 6, 'M': 3}","{'Y': 3, 'A': 3, 'B': 2, 'D': 2, 'E': 2, 'G': 3, 'I': 2, 'K': 3, 'L': 2, 'N': 2, 'O': 2, 'U': 3, 'V': 2, 'W': 2, 'X': 2}"
INV-ZZ-8421237,SCH-ZZ-6536717,ZZ,ZZ20240422GAUBOM2526.0,2526.0,Boeing 717,04/22/2024,2024-04-22 15:59:00,2024-04-23 05:45:00,GAU,BOM,100.0,116,72,-28,44,10,20,30,40,11,7,3,4,23,14,6,9,35,22,8,13,47,29,11,18,"{'F': 6, 'P': 4}","{'C': 8, 'J': 6, 'Z': 6}","{'Q': 9, 'R': 6, 'S': 3, 'T': 3, 'H': 6, 'M': 3}","{'Y': 3, 'A': 3, 'B': 2, 'D': 2, 'E': 2, 'G': 3, 'I': 2, 'K': 3, 'L': 2, 'N': 2, 'O': 2, 'U': 3, 'V': 2, 'W': 2, 'X': 2}"
INV-ZZ-9740489,SCH-ZZ-6536717,ZZ,ZZ20240423GAUBOM2526.0,2526.0,Boeing 717,04/23/2024,2024-04-23 15:59:00,2024-04-24 05:45:00,GAU,BOM,100.0,117,70,-30,47,10,20,30,40,11,7,3,4,24,14,6,10,34,20,10,14,45,27,13,18,"{'F': 6, 'P': 4}","{'C': 8, 'J': 6, 'Z': 6}","{'Q': 9, 'R': 6, 'S': 3, 'T': 3, 'H': 6, 'M': 3}","{'Y': 3, 'A': 3, 'B': 2, 'D': 2, 'E': 2, 'G': 3, 'I': 2, 'K': 3, 'L': 2, 'N': 2, 'O': 2, 'U': 3, 'V': 2, 'W': 2, 'X': 2}"
INV-ZZ-3292983,SCH-ZZ-6536717,ZZ,ZZ20240426GAUBOM2526.0,2526.0,Boeing 717,04/26/2024,2024-04-26 15:59:00,2024-04-27 05:45:00,GAU,BOM,100.0,110,66,-34,44,10,20,30,40,12,7,3,5,23,14,6,9,34,20,10,14,47,28,12,19,"{'F': 6, 'P': 4}","{'C': 8, 'J': 6, 'Z': 6}","{'Q': 9, 'R': 6, 'S': 3, 'T': 3, 'H': 6, 'M': 3}","{'Y': 3, 'A': 3, 'B': 2, 'D': 2, 'E': 2, 'G': 3, 'I': 2, 'K': 3, 'L': 2, 'N': 2, 'O': 2, 'U': 3, 'V': 2, 'W': 2, 'X': 2}"
INV-ZZ-9876650,SCH-ZZ-6536717,ZZ,ZZ20240429GAUBOM2526.0,2526.0,Boeing 717,04/29/2024,2024-04-29 15:59:00,2024-04-30 05:45:00,GAU,BOM,100.0,110,58,-42,52,10,20,30,40,12,6,4,6,22,12,8,10,35,19,11,16,48,25,15,23,"{'F': 6, 'P': 4}","{'C': 8, 'J': 6, 'Z': 6}","{'Q': 9, 'R': 6, 'S': 3, 'T': 3, 'H': 6, 'M': 3}","{'Y': 3, 'A': 3, 'B': 2, 'D': 2, 'E': 2, 'G': 3, 'I': 2, 'K': 3, 'L': 2, 'N': 2, 'O': 2, 'U': 3, 'V': 2, 'W': 2, 'X': 2}"
INV-ZZ-5215949,SCH-ZZ-6536717,ZZ,ZZ20240430GAUBOM2526.0,2526.0,Boeing 717,04/30/2024,2024-04-30 15:59:00,2024-05-01 05:45:00,GAU,BOM,100.0,118,63,-37,55,10,20,30,40,12,6,4,6,24,13,7,11,36,19,11,17,47,25,15,22,"{'F': 6, 'P': 4}","{'C': 8, 'J': 6, 'Z': 6}","{'Q': 9, 'R': 6, 'S': 3, 'T': 3, 'H': 6, 'M': 3}","{'Y': 3, 'A': 3, 'B': 2, 'D': 2, 'E': 2, 'G': 3, 'I': 2, 'K': 3, 'L': 2, 'N': 2, 'O': 2, 'U': 3, 'V': 2, 'W': 2, 'X': 2}"
INV-ZZ-1587974,SCH-ZZ-6536717,ZZ,ZZ20240503GAUBOM2526.0,2526.0,Boeing 717,05/03/2024,2024-05-03 15:59:00,2024-05-04 05:45:00,GAU,BOM,100.0,115,64,-36,51,10,20,30,40,11,6,4,5,23,13,7,10,35,19,11,16,45,25,15,20,"{'F': 6, 'P': 4}","{'C': 8, 'J': 6, 'Z': 6}","{'Q': 9, 'R': 6, 'S': 3, 'T': 3, 'H': 6, 'M': 3}","{'Y': 3, 'A': 3, 'B': 2, 'D': 2, 'E': 2, 'G': 3, 'I': 2, 'K': 3, 'L': 2, 'N': 2, 'O': 2, 'U': 3, 'V': 2, 'W': 2, 'X': 2}"
INV-ZZ-6627057,SCH-ZZ-6536717,ZZ,ZZ20240506GAUBOM2526.0,2526.0,Boeing 717,05/06/2024,2024-05-06 15:59:00,2024-05-07 05:45:00,GAU,BOM,100.0,116,63,-37,53,10,20,30,40,11,6,4,5,23,12,8,11,34,18,12,16,44,24,16,20,"{'F': 6, 'P': 4}","{'C': 8, 'J': 6, 'Z': 6}","{'Q': 9, 'R': 6, 'S': 3, 'T': 3, 'H': 6, 'M': 3}","{'Y': 3, 'A': 3, 'B': 2, 'D': 2, 'E': 2, 'G': 3, 'I': 2, 'K': 3, 'L': 2, 'N': 2, 'O': 2, 'U': 3, 'V': 2, 'W': 2, 'X': 2}"
INV-ZZ-8299450,SCH-ZZ-6536717,ZZ,ZZ20240507GAUBOM2526.0,2526.0,Boeing 717,05/07/2024,2024-05-07 15:59:00,2024-05-08 05:45:00,GAU,BOM,100.0,111,65,-35,46,10,20,30,40,12,7,3,5,24,14,6,10,35,21,9,14,45,26,14,19,"{'F': 6, 'P': 4}","{'C': 8, 'J': 6, 'Z': 6}","{'Q': 9, 'R': 6, 'S': 3, 'T': 3, 'H': 6, 'M': 3}","{'Y': 3, 'A': 3, 'B': 2, 'D': 2, 'E': 2, 'G': 3, 'I': 2, 'K': 3, 'L': 2, 'N': 2, 'O': 2, 'U': 3, 'V': 2, 'W': 2, 'X': 2}"
INV-ZZ-7314058,SCH-ZZ-6536717,ZZ,ZZ20240510GAUBOM2526.0,2526.0,Boeing 717,05/10/2024,2024-05-10 15:59:00,2024-05-11 05:45:00,GAU,BOM,100.0,116,60,-40,56,10,20,30,40,12,6,4,6,23,12,8,11,35,18,12,17,48,25,15,23,"{'F': 6, 'P': 4}","{'C': 8, 'J': 6, 'Z': 6}","{'Q': 9, 'R': 6, 'S': 3, 'T': 3, 'H': 6, 'M': 3}","{'Y': 3, 'A': 3, 'B': 2, 'D': 2, 'E': 2, 'G': 3, 'I': 2, 'K': 3, 'L': 2, 'N': 2, 'O': 2, 'U': 3, 'V': 2, 'W': 2, 'X': 2}"
INV-ZZ-2570209,SCH-ZZ-6536717,ZZ,ZZ20240513GAUBOM2526.0,2526.0,Boeing 717,05/13/2024,2024-05-13 15:59:00,2024-05-14 05:45:00,GAU,BOM,100.0,117,57,-43,60,10,20,30,40,11,5,5,6,24,12,8,12,35,17,13,18,46,22,18,24,"{'F': 6, 'P': 4}","{'C': 8, 'J': 6, 'Z': 6}","{'Q': 9, 'R': 6, 'S': 3, 'T': 3, 'H': 6, 'M': 3}","{'Y': 3, 'A': 3, 'B': 2, 'D': 2, 'E': 2, 'G': 3, 'I': 2, 'K': 3, 'L': 2, 'N': 2, 'O': 2, 'U': 3, 'V': 2, 'W': 2, 'X': 2}"
INV-ZZ-1634738,SCH-ZZ-6536717,ZZ,ZZ20240514GAUBOM2526.0,2526.0,Boeing 717,05/14/2024,2024-05-14 15:59:00,2024-05-15 05:45:00,GAU,BOM,100.0,113,63,-37,50,10,20,30,40,12,7,3,5,24,13,7,11,35,20,10,15,46,26,14,20,"{'F': 6, 'P': 4}","{'C': 8, 'J': 6, 'Z': 6}","{'Q': 9, 'R': 6, 'S': 3, 'T': 3, 'H': 6, 'M': 3}","{'Y': 3, 'A': 3, 'B': 2, 'D': 2, 'E': 2, 'G': 3, 'I': 2, 'K': 3, 'L': 2, 'N': 2, 'O': 2, 'U': 3, 'V': 2, 'W': 2, 'X': 2}"
INV-ZZ-6595918,SCH-ZZ-6536717,ZZ,ZZ20240517GAUBOM2526.0,2526.0,Boeing 717,05/17/2024,2024-05-17 15:59:00,2024-05-18 05:45:00,GAU,BOM,100.0,118,57,-43,61,10,20,30,40,11,5,5,6,23,11,9,12,35,17,13,18,46,22,18,24,"{'F': 6, 'P': 4}","{'C': 8, 'J': 6, 'Z': 6}","{'Q': 9, 'R': 6, 'S': 3, 'T': 3, 'H': 6, 'M': 3}","{'Y': 3, 'A': 3, 'B': 2, 'D': 2, 'E': 2, 'G': 3, 'I': 2, 'K': 3, 'L': 2, 'N': 2, 'O': 2, 'U': 3, 'V': 2, 'W': 2, 'X': 2}"
INV-ZZ-6369973,SCH-ZZ-4441798,ZZ,ZZ20240515JAIBLR3140.0,3140.0,Boeing 787,05/15/2024,2024-05-15 14:02:00,2024-05-15 21:32:00,JAI,BLR,270.0,313,160,-110,153,27,54,81,108,32,16,11,16,61,31,23,30,94,48,33,46,127,65,43,62,"{'F': 16, 'P': 11}","{'C': 22, 'J': 16, 'Z': 16}","{'Q': 24, 'R': 16, 'S': 8, 'T': 8, 'H': 16, 'M': 8}","{'Y': 8, 'A': 8, 'B': 4, 'D': 4, 'E': 4, 'G': 8, 'I': 4, 'K': 8, 'L': 4, 'N': 4, 'O': 4, 'U': 8, 'V': 4, 'W': 4, 'X': 4}"
INV-ZZ-9921202,SCH-ZZ-4441798,ZZ,ZZ20240516JAIBLR3140.0,3140.0,Boeing 787,05/16/2024,2024-05-16 14:02:00,2024-05-16 21:32:00,JAI,BLR,270.0,311,161,-109,150,27,54,81,108,31,16,11,15,62,32,22,30,95,49,32,46,124,64,44,60,"{'F': 16, 'P': 11}","{'C': 22, 'J': 16, 'Z': 16}","{'Q': 24, 'R': 16, 'S': 8, 'T': 8, 'H': 16, 'M': 8}","{'Y': 8, 'A': 8, 'B': 4, 'D': 4, 'E': 4, 'G': 8, 'I': 4, 'K': 8, 'L': 4, 'N': 4, 'O': 4, 'U': 8, 'V': 4, 'W': 4, 'X': 4}"
INV-ZZ-8392108,SCH-ZZ-4441798,ZZ,ZZ20240519JAIBLR3140.0,3140.0,Boeing 787,05/19/2024,2024-05-19 14:02:00,2024-05-19 21:32:00,JAI,BLR,270.0,303,144,-126,159,27,54,81,108,31,15,12,16,64,30,24,34,95,45,36,50,124,59,49,65,"{'F': 16, 'P': 11}","{'C': 22, 'J': 16, 'Z': 16}","{'Q': 24, 'R': 16, 'S': 8, 'T': 8, 'H': 16, 'M': 8}","{'Y': 8, 'A': 8, 'B': 4, 'D': 4, 'E': 4, 'G': 8, 'I': 4, 'K': 8, 'L': 4, 'N': 4, 'O': 4, 'U': 8, 'V': 4, 'W': 4, 'X': 4}"
INV-ZZ-3258274,SCH-ZZ-4441798,ZZ,ZZ20240520JAIBLR3140.0,3140.0,Boeing 787,05/20/2024,2024-05-20 14:02:00,2024-05-20 21:32:00,JAI,BLR,270.0,318,168,-102,150,27,54,81,108,31,16,11,15,61,32,22,29,90,48,33,42,124,66,42,58,"{'F': 16, 'P': 11}","{'C': 22, 'J': 16, 'Z': 16}","{'Q': 24, 'R': 16, 'S': 8, 'T': 8, 'H': 16, 'M': 8}","{'Y': 8, 'A': 8, 'B': 4, 'D': 4, 'E': 4, 'G': 8, 'I': 4, 'K': 8, 'L': 4, 'N': 4, 'O': 4, 'U': 8, 'V': 4, 'W': 4, 'X': 4}"
INV-ZZ-7988790,SCH-ZZ-4441798,ZZ,ZZ20240522JAIBLR3140.0,3140.0,Boeing 787,05/22/2024,2024-05-22 14:02:00,2024-05-22 21:32:00,JAI,BLR,270.0,319,168,-102,151,27,54,81,108,31,16,11,15,62,33,21,29,93,49,32,44,121,64,44,57,"{'F': 16, 'P': 11}","{'C': 22, 'J': 16, 'Z': 16}","{'Q': 24, 'R': 16, 'S': 8, 'T': 8, 'H': 16, 'M': 8}","{'Y': 8, 'A': 8, 'B': 4, 'D': 4, 'E': 4, 'G': 8, 'I': 4, 'K': 8, 'L': 4, 'N': 4, 'O': 4, 'U': 8, 'V': 4, 'W': 4, 'X': 4}"
INV-ZZ-4912252,SCH-ZZ-4441798,ZZ,ZZ20240523JAIBLR3140.0,3140.0,Boeing 787,05/23/2024,2024-05-23 14:02:00,2024-05-23 21:32:00,JAI,BLR,270.0,301,151,-119,150,27,54,81,108,30,15,12,15,61,31,23,30,94,47,34,47,124,62,46,62,"{'F': 16, 'P': 11}","{'C': 22, 'J': 16, 'Z': 16}","{'Q': 24, 'R': 16, 'S': 8, 'T': 8, 'H': 16, 'M': 8}","{'Y': 8, 'A': 8, 'B': 4, 'D': 4, 'E': 4, 'G': 8, 'I': 4, 'K': 8, 'L': 4, 'N': 4, 'O': 4, 'U': 8, 'V': 4, 'W': 4, 'X': 4}"
INV-ZZ-2947228,SCH-ZZ-4441798,ZZ,ZZ20240526JAIBLR3140.0,3140.0,Boeing 787,05/26/2024,2024-05-26 14:02:00,2024-05-26 21:32:00,JAI,BLR,270.0,310,165,-105,145,27,54,81,108,32,17,10,15,60,32,22,28,93,50,31,43,121,65,43,56,"{'F': 16, 'P': 11}","{'C': 22, 'J': 16, 'Z': 16}","{'Q': 24, 'R': 16, 'S': 8, 'T': 8, 'H': 16, 'M': 8}","{'Y': 8, 'A': 8, 'B': 4, 'D': 4, 'E': 4, 'G': 8, 'I': 4, 'K': 8, 'L': 4, 'N': 4, 'O': 4, 'U': 8, 'V': 4, 'W': 4, 'X': 4}"
INV-ZZ-3607698,SCH-ZZ-4441798,ZZ,ZZ20240527JAIBLR3140.0,3140.0,Boeing 787,05/27/2024,2024-05-27 14:02:00,2024-05-27 21:32:00,JAI,BLR,270.0,314,157,-113,157,27,54,81,108,32,16,11,16,63,31,23,32,90,45,36,45,122,61,47,61,"{'F': 16, 'P': 11}","{'C': 22, 'J': 16, 'Z': 16}","{'Q': 24, 'R': 16, 'S': 8, 'T': 8, 'H': 16, 'M': 8}","{'Y': 8, 'A': 8, 'B': 4, 'D': 4, 'E': 4, 'G': 8, 'I': 4, 'K': 8, 'L': 4, 'N': 4, 'O': 4, 'U': 8, 'V': 4, 'W': 4, 'X': 4}"
INV-ZZ-9639797,SCH-ZZ-4441798,ZZ,ZZ20240529JAIBLR3140.0,3140.0,Boeing 787,05/29/2024,2024-05-29 14:02:00,2024-05-29 21:32:00,JAI,BLR,270.0,320,164,-106,156,27,54,81,108,30,15,12,15,64,33,21,31,96,49,32,47,126,64,44,62,"{'F': 16, 'P': 11}","{'C': 22, 'J': 16, 'Z': 16}","{'Q': 24, 'R': 16, 'S': 8, 'T': 8, 'H': 16, 'M': 8}","{'Y': 8, 'A': 8, 'B': 4, 'D': 4, 'E': 4, 'G': 8, 'I': 4, 'K': 8, 'L': 4, 'N': 4, 'O': 4, 'U': 8, 'V': 4, 'W': 4, 'X': 4}"
INV-ZZ-5081062,SCH-ZZ-4441798,ZZ,ZZ20240530JAIBLR3140.0,3140.0,Boeing 787,05/30/2024,2024-05-30 14:02:00,2024-05-30 21:32:00,JAI,BLR,270.0,321,145,-125,176,27,54,81,108,31,14,13,17,65,29,25,36,93,42,39,51,125,56,52,69,"{'F': 16, 'P': 11}","{'C': 22, 'J': 16, 'Z': 16}","{'Q': 24, 'R': 16, 'S': 8, 'T': 8, 'H': 16, 'M': 8}","{'Y': 8, 'A': 8, 'B': 4, 'D': 4, 'E': 4, 'G': 8, 'I': 4, 'K': 8, 'L': 4, 'N': 4, 'O': 4, 'U': 8, 'V': 4, 'W': 4, 'X': 4}"
INV-ZZ-4277493,SCH-ZZ-4441798,ZZ,ZZ20240602JAIBLR3140.0,3140.0,Boeing 787,06/02/2024,2024-06-02 14:02:00,2024-06-02 21:32:00,JAI,BLR,270.0,311,150,-120,160,27,54,81,108,32,15,12,17,62,30,24,32,97,47,34,50,129,62,46,67,"{'F': 16, 'P': 11}","{'C': 22, 'J': 16, 'Z': 16}","{'Q': 24, 'R': 16, 'S': 8, 'T': 8, 'H': 16, 'M': 8}","{'Y': 8, 'A': 8, 'B': 4, 'D': 4, 'E': 4, 'G': 8, 'I': 4, 'K': 8, 'L': 4, 'N': 4, 'O': 4, 'U': 8, 'V': 4, 'W': 4, 'X': 4}"
INV-ZZ-5267365,SCH-ZZ-4441798,ZZ,ZZ20240603JAIBLR3140.0,3140.0,Boeing 787,06/03/2024,2024-06-03 14:02:00,2024-06-03 21:32:00,JAI,BLR,270.0,320,145,-125,175,27,54,81,108,31,14,13,17,60,27,27,33,95,43,38,52,127,58,50,69,"{'F': 16, 'P': 11}","{'C': 22, 'J': 16, 'Z': 16}","{'Q': 24, 'R': 16, 'S': 8, 'T': 8, 'H': 16, 'M': 8}","{'Y': 8, 'A': 8, 'B': 4, 'D': 4, 'E': 4, 'G': 8, 'I': 4, 'K': 8, 'L': 4, 'N': 4, 'O': 4, 'U': 8, 'V': 4, 'W': 4, 'X': 4}"
INV-ZZ-8866631,SCH-ZZ-4441798,ZZ,ZZ20240605JAIBLR3140.0,3140.0,Boeing 787,06/05/2024,2024-06-05 14:02:00,2024-06-05 21:32:00,JAI,BLR,270.0,304,146,-124,158,27,54,81,108,31,15,12,16,62,30,24,32,95,46,35,49,120,58,50,62,"{'F': 16, 'P': 11}","{'C': 22, 'J': 16, 'Z': 16}","{'Q': 24, 'R': 16, 'S': 8, 'T': 8, 'H': 16, 'M': 8}","{'Y': 8, 'A': 8, 'B': 4, 'D': 4, 'E': 4, 'G': 8, 'I': 4, 'K': 8, 'L': 4, 'N': 4, 'O': 4, 'U': 8, 'V': 4, 'W': 4, 'X': 4}"
INV-ZZ-6826035,SCH-ZZ-4441798,ZZ,ZZ20240606JAIBLR3140.0,3140.0,Boeing 787,06/06/2024,2024-06-06 14:02:00,2024-06-06 21:32:00,JAI,BLR,270.0,318,142,-128,176,27,54,81,108,32,14,13,18,65,29,25,36,92,41,40,51,126,56,52,70,"{'F': 16, 'P': 11}","{'C': 22, 'J': 16, 'Z': 16}","{'Q': 24, 'R': 16, 'S': 8, 'T': 8, 'H': 16, 'M': 8}","{'Y': 8, 'A': 8, 'B': 4, 'D': 4, 'E': 4, 'G': 8, 'I': 4, 'K': 8, 'L': 4, 'N': 4, 'O': 4, 'U': 8, 'V': 4, 'W': 4, 'X': 4}"
INV-ZZ-3949370,SCH-ZZ-4441798,ZZ,ZZ20240609JAIBLR3140.0,3140.0,Boeing 787,06/09/2024,2024-06-09 14:02:00,2024-06-09 21:32:00,JAI,BLR,270.0,299,137,-133,162,27,54,81,108,31,14,13,17,63,29,25,34,95,44,37,51,120,55,53,65,"{'F': 16, 'P': 11}","{'C': 22, 'J': 16, 'Z': 16}","{'Q': 24, 'R': 16, 'S': 8, 'T': 8, 'H': 16, 'M': 8}","{'Y': 8, 'A': 8, 'B': 4, 'D': 4, 'E': 4, 'G': 8, 'I': 4, 'K': 8, 'L': 4, 'N': 4, 'O': 4, 'U': 8, 'V': 4, 'W': 4, 'X': 4}"
INV-ZZ-4313370,SCH-ZZ-4441798,ZZ,ZZ20240610JAIBLR3140.0,3140.0,Boeing 787,06/10/2024,2024-06-10 14:02:00,2024-06-10 21:32:00,JAI,BLR,270.0,315,143,-127,172,27,54,81,108,31,14,13,17,61,28,26,33,94,43,38,51,125,57,51,68,"{'F': 16, 'P': 11}","{'C': 22, 'J': 16, 'Z': 16}","{'Q': 24, 'R': 16, 'S': 8, 'T': 8, 'H': 16, 'M': 8}","{'Y': 8, 'A': 8, 'B': 4, 'D': 4, 'E': 4, 'G': 8, 'I': 4, 'K': 8, 'L': 4, 'N': 4, 'O': 4, 'U': 8, 'V': 4, 'W': 4, 'X': 4}"
INV-ZZ-3054272,SCH-ZZ-4441798,ZZ,ZZ20240612JAIBLR3140.0,3140.0,Boeing 787,06/12/2024,2024-06-12 14:02:00,2024-06-12 21:32:00,JAI,BLR,270.0,304,129,-141,175,27,54,81,108,31,13,14,18,64,27,27,37,96,41,40,55,122,52,56,70,"{'F': 16, 'P': 11}","{'C': 22, 'J': 16, 'Z': 16}","{'Q': 24, 'R': 16, 'S': 8, 'T': 8, 'H': 16, 'M': 8}","{'Y': 8, 'A': 8, 'B': 4, 'D': 4, 'E': 4, 'G': 8, 'I': 4, 'K': 8, 'L': 4, 'N': 4, 'O': 4, 'U': 8, 'V': 4, 'W': 4, 'X': 4}"
INV-ZZ-5745796,SCH-ZZ-4441798,ZZ,ZZ20240613JAIBLR3140.0,3140.0,Boeing 787,06/13/2024,2024-06-13 14:02:00,2024-06-13 21:32:00,JAI,BLR,270.0,322,150,-120,172,27,54,81,108,30,14,13,16,64,30,24,34,93,43,38,50,122,57,51,65,"{'F': 16, 'P': 11}","{'C': 22, 'J': 16, 'Z': 16}","{'Q': 24, 'R': 16, 'S': 8, 'T': 8, 'H': 16, 'M': 8}","{'Y': 8, 'A': 8, 'B': 4, 'D': 4, 'E': 4, 'G': 8, 'I': 4, 'K': 8, 'L': 4, 'N': 4, 'O': 4, 'U': 8, 'V': 4, 'W': 4, 'X': 4}"
INV-ZZ-4692448,SCH-ZZ-4441798,ZZ,ZZ20240616JAIBLR3140.0,3140.0,Boeing 787,06/16/2024,2024-06-16 14:02:00,2024-06-16 21:32:00,JAI,BLR,270.0,315,138,-132,177,27,54,81,108,30,13,14,17,62,27,27,35,94,41,40,53,123,54,54,69,"{'F': 16, 'P': 11}","{'C': 22, 'J': 16, 'Z': 16}","{'Q': 24, 'R': 16, 'S': 8, 'T': 8, 'H': 16, 'M': 8}","{'Y': 8, 'A': 8, 'B': 4, 'D': 4, 'E': 4, 'G': 8, 'I': 4, 'K': 8, 'L': 4, 'N': 4, 'O': 4, 'U': 8, 'V': 4, 'W': 4, 'X': 4}"
INV-ZZ-2471713,SCH-ZZ-4441798,ZZ,ZZ20240617JAIBLR3140.0,3140.0,Boeing 787,06/17/2024,2024-06-17 14:02:00,2024-06-17 21:32:00,JAI,BLR,270.0,311,133,-137,178,27,54,81,108,30,13,14,17,61,26,28,35,92,39,42,53,126,54,54,72,"{'F': 16, 'P': 11}","{'C': 22, 'J': 16, 'Z': 16}","{'Q': 24, 'R': 16, 'S': 8, 'T': 8, 'H': 16, 'M': 8}","{'Y': 8, 'A': 8, 'B': 4, 'D': 4, 'E': 4, 'G': 8, 'I': 4, 'K': 8, 'L': 4, 'N': 4, 'O': 4, 'U': 8, 'V': 4, 'W': 4, 'X': 4}"
INV-ZZ-9253491,SCH-ZZ-4441798,ZZ,ZZ20240619JAIBLR3140.0,3140.0,Boeing 787,06/19/2024,2024-06-19 14:02:00,2024-06-19 21:32:00,JAI,BLR,270.0,311,131,-139,180,27,54,81,108,31,13,14,18,62,26,28,36,94,40,41,54,123,52,56,71,"{'F': 16, 'P': 11}","{'C': 22, 'J': 16, 'Z': 16}","{'Q': 24, 'R': 16, 'S': 8, 'T': 8, 'H': 16, 'M': 8}","{'Y': 8, 'A': 8, 'B': 4, 'D': 4, 'E': 4, 'G': 8, 'I': 4, 'K': 8, 'L': 4, 'N': 4, 'O': 4, 'U': 8, 'V': 4, 'W': 4, 'X': 4}"
INV-ZZ-8632613,SCH-ZZ-4441798,ZZ,ZZ20240620JAIBLR3140.0,3140.0,Boeing 787,06/20/2024,2024-06-20 14:02:00,2024-06-20 21:32:00,JAI,BLR,270.0,322,139,-131,183,27,54,81,108,31,13,14,18,60,26,28,34,96,41,40,55,124,53,55,71,"{'F': 16, 'P': 11}","{'C': 22, 'J': 16, 'Z': 16}","{'Q': 24, 'R': 16, 'S': 8, 'T': 8, 'H': 16, 'M': 8}","{'Y': 8, 'A': 8, 'B': 4, 'D': 4, 'E': 4, 'G': 8, 'I': 4, 'K': 8, 'L': 4, 'N': 4, 'O': 4, 'U': 8, 'V': 4, 'W': 4, 'X': 4}"
INV-ZZ-8713255,SCH-ZZ-4441798,ZZ,ZZ20240623JAIBLR3140.0,3140.0,Boeing 787,06/23/2024,2024-06-23 14:02:00,2024-06-23 21:32:00,JAI,BLR,270.0,320,128,-142,192,27,54,81,108,30,12,15,18,60,24,30,36,92,37,44,55,124,50,58,74,"{'F': 16, 'P': 11}","{'C': 22, 'J': 16, 'Z': 16}","{'Q': 24, 'R': 16, 'S': 8, 'T': 8, 'H': 16, 'M': 8}","{'Y': 8, 'A': 8, 'B': 4, 'D': 4, 'E': 4, 'G': 8, 'I': 4, 'K': 8, 'L': 4, 'N': 4, 'O': 4, 'U': 8, 'V': 4, 'W': 4, 'X': 4}"
INV-ZZ-6232210,SCH-ZZ-4441798,ZZ,ZZ20240624JAIBLR3140.0,3140.0,Boeing 787,06/24/2024,2024-06-24 14:02:00,2024-06-24 21:32:00,JAI,BLR,270.0,302,137,-133,165,27,54,81,108,32,15,12,17,64,29,25,35,90,41,40,49,129,58,50,71,"{'F': 16, 'P': 11}","{'C': 22, 'J': 16, 'Z': 16}","{'Q': 24, 'R': 16, 'S': 8, 'T': 8, 'H': 16, 'M': 8}","{'Y': 8, 'A': 8, 'B': 4, 'D': 4, 'E': 4, 'G': 8, 'I': 4, 'K': 8, 'L': 4, 'N': 4, 'O': 4, 'U': 8, 'V': 4, 'W': 4, 'X': 4}"
INV-ZZ-3975929,SCH-ZZ-4441798,ZZ,ZZ20240626JAIBLR3140.0,3140.0,Boeing 787,06/26/2024,2024-06-26 14:02:00,2024-06-26 21:32:00,JAI,BLR,270.0,314,120,-150,194,27,54,81,108,31,12,15,19,64,25,29,39,95,36,45,59,122,47,61,75,"{'F': 16, 'P': 11}","{'C': 22, 'J': 16, 'Z': 16}","{'Q': 24, 'R': 16, 'S': 8, 'T': 8, 'H': 16, 'M': 8}","{'Y': 8, 'A': 8, 'B': 4, 'D': 4, 'E': 4, 'G': 8, 'I': 4, 'K': 8, 'L': 4, 'N': 4, 'O': 4, 'U': 8, 'V': 4, 'W': 4, 'X': 4}"
INV-ZZ-8574263,SCH-ZZ-4441798,ZZ,ZZ20240627JAIBLR3140.0,3140.0,Boeing 787,06/27/2024,2024-06-27 14:02:00,2024-06-27 21:32:00,JAI,BLR,270.0,304,128,-142,176,27,54,81,108,32,13,14,19,62,26,28,36,97,41,40,56,122,51,57,71,"{'F': 16, 'P': 11}","{'C': 22, 'J': 16, 'Z': 16}","{'Q': 24, 'R': 16, 'S': 8, 'T': 8, 'H': 16, 'M': 8}","{'Y': 8, 'A': 8, 'B': 4, 'D': 4, 'E': 4, 'G': 8, 'I': 4, 'K': 8, 'L': 4, 'N': 4, 'O': 4, 'U': 8, 'V': 4, 'W': 4, 'X': 4}"
INV-ZZ-3174758,SCH-ZZ-2312688,ZZ,ZZ20240406MAATRV4122.0,4122.0,Boeing 787,04/06/2024,2024-04-06 19:54:00,2024-04-07 02:05:00,MAA,TRV,270.0,303,187,-83,116,27,54,81,108,31,19,8,12,63,39,15,24,90,56,25,34,122,75,33,47,"{'F': 16, 'P': 11}","{'C': 22, 'J': 16, 'Z': 16}","{'Q': 24, 'R': 16, 'S': 8, 'T': 8, 'H': 16, 'M': 8}","{'Y': 8, 'A': 8, 'B': 4, 'D': 4, 'E': 4, 'G': 8, 'I': 4, 'K': 8, 'L': 4, 'N': 4, 'O': 4, 'U': 8, 'V': 4, 'W': 4, 'X': 4}"
INV-ZZ-9584146,SCH-ZZ-2312688,ZZ,ZZ20240410MAATRV4122.0,4122.0,Boeing 787,04/10/2024,2024-04-10 19:54:00,2024-04-11 02:05:00,MAA,TRV,270.0,322,196,-74,126,27,54,81,108,31,19,8,12,61,37,17,24,96,58,23,38,121,74,34,47,"{'F': 16, 'P': 11}","{'C': 22, 'J': 16, 'Z': 16}","{'Q': 24, 'R': 16, 'S': 8, 'T': 8, 'H': 16, 'M': 8}","{'Y': 8, 'A': 8, 'B': 4, 'D': 4, 'E': 4, 'G': 8, 'I': 4, 'K': 8, 'L': 4, 'N': 4, 'O': 4, 'U': 8, 'V': 4, 'W': 4, 'X': 4}"
INV-ZZ-5293019,SCH-ZZ-2312688,ZZ,ZZ20240412MAATRV4122.0,4122.0,Boeing 787,04/12/2024,2024-04-12 19:54:00,2024-04-13 02:05:00,MAA,TRV,270.0,314,188,-82,126,27,54,81,108,32,19,8,13,61,37,17,24,97,58,23,39,125,75,33,50,"{'F': 16, 'P': 11}","{'C': 22, 'J': 16, 'Z': 16}","{'Q': 24, 'R': 16, 'S': 8, 'T': 8, 'H': 16, 'M': 8}","{'Y': 8, 'A': 8, 'B': 4, 'D': 4, 'E': 4, 'G': 8, 'I': 4, 'K': 8, 'L': 4, 'N': 4, 'O': 4, 'U': 8, 'V': 4, 'W': 4, 'X': 4}"
INV-ZZ-4858723,SCH-ZZ-2312688,ZZ,ZZ20240413MAATRV4122.0,4122.0,Boeing 787,04/13/2024,2024-04-13 19:54:00,2024-04-14 02:05:00,MAA,TRV,270.0,303,186,-84,117,27,54,81,108,30,18,9,12,64,39,15,25,96,59,22,37,127,78,30,49,"{'F': 16, 'P': 11}","{'C': 22, 'J': 16, 'Z': 16}","{'Q': 24, 'R': 16, 'S': 8, 'T': 8, 'H': 16, 'M': 8}","{'Y': 8, 'A': 8, 'B': 4, 'D': 4, 'E': 4, 'G': 8, 'I': 4, 'K': 8, 'L': 4, 'N': 4, 'O': 4, 'U': 8, 'V': 4, 'W': 4, 'X': 4}"
INV-ZZ-7122012,SCH-ZZ-2312688,ZZ,ZZ20240417MAATRV4122.0,4122.0,Boeing 787,04/17/2024,2024-04-17 19:54:00,2024-04-18 02:05:00,MAA,TRV,270.0,302,180,-90,122,27,54,81,108,32,19,8,13,62,37,17,25,90,54,27,36,127,76,32,51,"{'F': 16, 'P': 11}","{'C': 22, 'J': 16, 'Z': 16}","{'Q': 24, 'R': 16, 'S': 8, 'T': 8, 'H': 16, 'M': 8}","{'Y': 8, 'A': 8, 'B': 4, 'D': 4, 'E': 4, 'G': 8, 'I': 4, 'K': 8, 'L': 4, 'N': 4, 'O': 4, 'U': 8, 'V': 4, 'W': 4, 'X': 4}"
INV-ZZ-7743686,SCH-ZZ-2312688,ZZ,ZZ20240419MAATRV4122.0,4122.0,Boeing 787,04/19/2024,2024-04-19 19:54:00,2024-04-20 02:05:00,MAA,TRV,270.0,319,182,-88,137,27,54,81,108,31,18,9,13,62,35,19,27,90,51,30,39,121,69,39,52,"{'F': 16, 'P': 11}","{'C': 22, 'J': 16, 'Z': 16}","{'Q': 24, 'R': 16, 'S': 8, 'T': 8, 'H': 16, 'M': 8}","{'Y': 8, 'A': 8, 'B': 4, 'D': 4, 'E': 4, 'G': 8, 'I': 4, 'K': 8, 'L': 4, 'N': 4, 'O': 4, 'U': 8, 'V': 4, 'W': 4, 'X': 4}"
INV-ZZ-4213535,SCH-ZZ-2312688,ZZ,ZZ20240420MAATRV4122.0,4122.0,Boeing 787,04/20/2024,2024-04-20 19:54:00,2024-04-21 02:05:00,MAA,TRV,270.0,300,172,-98,128,27,54,81,108,31,18,9,13,61,35,19,26,97,55,26,42,121,69,39,52,"{'F': 16, 'P': 11}","{'C': 22, 'J': 16, 'Z': 16}","{'Q': 24, 'R': 16, 'S': 8, 'T': 8, 'H': 16, 'M': 8}","{'Y': 8, 'A': 8, 'B': 4, 'D': 4, 'E': 4, 'G': 8, 'I': 4, 'K': 8, 'L': 4, 'N': 4, 'O': 4, 'U': 8, 'V': 4, 'W': 4, 'X': 4}"
INV-ZZ-3958478,SCH-ZZ-2312688,ZZ,ZZ20240424MAATRV4122.0,4122.0,Boeing 787,04/24/2024,2024-04-24 19:54:00,2024-04-25 02:05:00,MAA,TRV,270.0,310,176,-94,134,27,54,81,108,31,18,9,13,62,35,19,27,96,55,26,41,127,72,36,55,"{'F': 16, 'P': 11}","{'C': 22, 'J': 16, 'Z': 16}","{'Q': 24, 'R': 16, 'S': 8, 'T': 8, 'H': 16, 'M': 8}","{'Y': 8, 'A': 8, 'B': 4, 'D': 4, 'E': 4, 'G': 8, 'I': 4, 'K': 8, 'L': 4, 'N': 4, 'O': 4, 'U': 8, 'V': 4, 'W': 4, 'X': 4}"
INV-ZZ-7592815,SCH-ZZ-2312688,ZZ,ZZ20240426MAATRV4122.0,4122.0,Boeing 787,04/26/2024,2024-04-26 19:54:00,2024-04-27 02:05:00,MAA,TRV,270.0,307,170,-100,137,27,54,81,108,30,17,10,13,62,34,20,28,92,51,30,41,120,67,41,53,"{'F': 16, 'P': 11}","{'C': 22, 'J': 16, 'Z': 16}","{'Q': 24, 'R': 16, 'S': 8, 'T': 8, 'H': 16, 'M': 8}","{'Y': 8, 'A': 8, 'B': 4, 'D': 4, 'E': 4, 'G': 8, 'I': 4, 'K': 8, 'L': 4, 'N': 4, 'O': 4, 'U': 8, 'V': 4, 'W': 4, 'X': 4}"
INV-ZZ-5874545,SCH-ZZ-2312688,ZZ,ZZ20240427MAATRV4122.0,4122.0,Boeing 787,04/27/2024,2024-04-27 19:54:00,2024-04-28 02:05:00,MAA,TRV,270.0,312,191,-79,121,27,54,81,108,30,18,9,12,64,39,15,25,97,59,22,38,123,75,33,48,"{'F': 16, 'P': 11}","{'C': 22, 'J': 16, 'Z': 16}","{'Q': 24, 'R': 16, 'S': 8, 'T': 8, 'H': 16, 'M': 8}","{'Y': 8, 'A': 8, 'B': 4, 'D': 4, 'E': 4, 'G': 8, 'I': 4, 'K': 8, 'L': 4, 'N': 4, 'O': 4, 'U': 8, 'V': 4, 'W': 4, 'X': 4}"
INV-ZZ-1261435,SCH-ZZ-2312688,ZZ,ZZ20240501MAATRV4122.0,4122.0,Boeing 787,05/01/2024,2024-05-01 19:54:00,2024-05-02 02:05:00,MAA,TRV,270.0,298,179,-91,119,27,54,81,108,31,19,8,12,61,37,17,24,93,56,25,37,123,74,34,49,"{'F': 16, 'P': 11}","{'C': 22, 'J': 16, 'Z': 16}","{'Q': 24, 'R': 16, 'S': 8, 'T': 8, 'H': 16, 'M': 8}","{'Y': 8, 'A': 8, 'B': 4, 'D': 4, 'E': 4, 'G': 8, 'I': 4, 'K': 8, 'L': 4, 'N': 4, 'O': 4, 'U': 8, 'V': 4, 'W': 4, 'X': 4}"
INV-ZZ-4746908,SCH-ZZ-2312688,ZZ,ZZ20240503MAATRV4122.0,4122.0,Boeing 787,05/03/2024,2024-05-03 19:54:00,2024-05-04 02:05:00,MAA,TRV,270.0,317,173,-97,144,27,54,81,108,32,17,10,15,61,33,21,28,91,50,31,41,127,69,39,58,"{'F': 16, 'P': 11}","{'C': 22, 'J': 16, 'Z': 16}","{'Q': 24, 'R': 16, 'S': 8, 'T': 8, 'H': 16, 'M': 8}","{'Y': 8, 'A': 8, 'B': 4, 'D': 4, 'E': 4, 'G': 8, 'I': 4, 'K': 8, 'L': 4, 'N': 4, 'O': 4, 'U': 8, 'V': 4, 'W': 4, 'X': 4}"
INV-ZZ-2376568,SCH-ZZ-2312688,ZZ,ZZ20240504MAATRV4122.0,4122.0,Boeing 787,05/04/2024,2024-05-04 19:54:00,2024-05-05 02:05:00,MAA,TRV,270.0,309,164,-106,145,27,54,81,108,30,16,11,14,64,34,20,30,95,51,30,44,124,66,42,58,"{'F': 16, 'P': 11}","{'C': 22, 'J': 16, 'Z': 16}","{'Q': 24, 'R': 16, 'S': 8, 'T': 8, 'H': 16, 'M': 8}","{'Y': 8, 'A': 8, 'B': 4, 'D': 4, 'E': 4, 'G': 8, 'I': 4, 'K': 8, 'L': 4, 'N': 4, 'O': 4, 'U': 8, 'V': 4, 'W': 4, 'X': 4}"
INV-ZZ-4468533,SCH-ZZ-2312688,ZZ,ZZ20240508MAATRV4122.0,4122.0,Boeing 787,05/08/2024,2024-05-08 19:54:00,2024-05-09 02:05:00,MAA,TRV,270.0,323,188,-82,135,27,54,81,108,32,19,8,13,61,36,18,25,94,55,26,39,129,75,33,54,"{'F': 16, 'P': 11}","{'C': 22, 'J': 16, 'Z': 16}","{'Q': 24, 'R': 16, 'S': 8, 'T': 8, 'H': 16, 'M': 8}","{'Y': 8, 'A': 8, 'B': 4, 'D': 4, 'E': 4, 'G': 8, 'I': 4, 'K': 8, 'L': 4, 'N': 4, 'O': 4, 'U': 8, 'V': 4, 'W': 4, 'X': 4}"
INV-ZZ-8784018,SCH-ZZ-2312688,ZZ,ZZ20240510MAATRV4122.0,4122.0,Boeing 787,05/10/2024,2024-05-10 19:54:00,2024-05-11 02:05:00,MAA,TRV,270.0,299,154,-116,145,27,54,81,108,32,16,11,16,60,31,23,29,94,48,33,46,128,66,42,62,"{'F': 16, 'P': 11}","{'C': 22, 'J': 16, 'Z': 16}","{'Q': 24, 'R': 16, 'S': 8, 'T': 8, 'H': 16, 'M': 8}","{'Y': 8, 'A': 8, 'B': 4, 'D': 4, 'E': 4, 'G': 8, 'I': 4, 'K': 8, 'L': 4, 'N': 4, 'O': 4, 'U': 8, 'V': 4, 'W': 4, 'X': 4}"
INV-ZZ-3068509,SCH-ZZ-2312688,ZZ,ZZ20240511MAATRV4122.0,4122.0,Boeing 787,05/11/2024,2024-05-11 19:54:00,2024-05-12 02:05:00,MAA,TRV,270.0,317,159,-111,158,27,54,81,108,32,16,11,16,60,30,24,30,94,47,34,47,120,60,48,60,"{'F': 16, 'P': 11}","{'C': 22, 'J': 16, 'Z': 16}","{'Q': 24, 'R': 16, 'S': 8, 'T': 8, 'H': 16, 'M': 8}","{'Y': 8, 'A': 8, 'B': 4, 'D': 4, 'E': 4, 'G': 8, 'I': 4, 'K': 8, 'L': 4, 'N': 4, 'O': 4, 'U': 8, 'V': 4, 'W': 4, 'X': 4}"
INV-ZZ-9050292,SCH-ZZ-2312688,ZZ,ZZ20240515MAATRV4122.0,4122.0,Boeing 787,05/15/2024,2024-05-15 19:54:00,2024-05-16 02:05:00,MAA,TRV,270.0,303,164,-106,139,27,54,81,108,30,16,11,14,60,32,22,28,95,51,30,44,119,64,44,55,"{'F': 16, 'P': 11}","{'C': 22, 'J': 16, 'Z': 16}","{'Q': 24, 'R': 16, 'S': 8, 'T': 8, 'H': 16, 'M': 8}","{'Y': 8, 'A': 8, 'B': 4, 'D': 4, 'E': 4, 'G': 8, 'I': 4, 'K': 8, 'L': 4, 'N': 4, 'O': 4, 'U': 8, 'V': 4, 'W': 4, 'X': 4}"
INV-ZZ-7325383,SCH-ZZ-2312688,ZZ,ZZ20240517MAATRV4122.0,4122.0,Boeing 787,05/17/2024,2024-05-17 19:54:00,2024-05-18 02:05:00,MAA,TRV,270.0,323,177,-93,146,27,54,81,108,32,18,9,14,64,35,19,29,96,53,28,43,128,70,38,58,"{'F': 16, 'P': 11}","{'C': 22, 'J': 16, 'Z': 16}","{'Q': 24, 'R': 16, 'S': 8, 'T': 8, 'H': 16, 'M': 8}","{'Y': 8, 'A': 8, 'B': 4, 'D': 4, 'E': 4, 'G': 8, 'I': 4, 'K': 8, 'L': 4, 'N': 4, 'O': 4, 'U': 8, 'V': 4, 'W': 4, 'X': 4}"
INV-ZZ-6336000,SCH-ZZ-2312688,ZZ,ZZ20240518MAATRV4122.0,4122.0,Boeing 787,05/18/2024,2024-05-18 19:54:00,2024-05-19 02:05:00,MAA,TRV,270.0,320,169,-101,151,27,54,81,108,30,16,11,14,61,32,22,29,93,49,32,44,129,68,40,61,"{'F': 16, 'P': 11}","{'C': 22, 'J': 16, 'Z': 16}","{'Q': 24, 'R': 16, 'S': 8, 'T': 8, 'H': 16, 'M': 8}","{'Y': 8, 'A': 8, 'B': 4, 'D': 4, 'E': 4, 'G': 8, 'I': 4, 'K': 8, 'L': 4, 'N': 4, 'O': 4, 'U': 8, 'V': 4, 'W': 4, 'X': 4}"
INV-ZZ-6311588,SCH-ZZ-3527980,ZZ,ZZ20240505CJBHYD2679.0,2679.0,Boeing 787,05/05/2024,2024-05-05 08:36:00,2024-05-05 22:45:00,CJB,HYD,270.0,303,166,-104,137,27,54,81,108,30,16,11,14,62,34,20,28,93,51,30,42,122,67,41,55,"{'F': 16, 'P': 11}","{'C': 22, 'J': 16, 'Z': 16}","{'Q': 24, 'R': 16, 'S': 8, 'T': 8, 'H': 16, 'M': 8}","{'Y': 8, 'A': 8, 'B': 4, 'D': 4, 'E': 4, 'G': 8, 'I': 4, 'K': 8, 'L': 4, 'N': 4, 'O': 4, 'U': 8, 'V': 4, 'W': 4, 'X': 4}"
INV-ZZ-1653905,SCH-ZZ-3527980,ZZ,ZZ20240506CJBHYD2679.0,2679.0,Boeing 787,05/06/2024,2024-05-06 08:36:00,2024-05-06 22:45:00,CJB,HYD,270.0,321,165,-105,156,27,54,81,108,31,16,11,15,60,31,23,29,93,48,33,45,127,65,43,62,"{'F': 16, 'P': 11}","{'C': 22, 'J': 16, 'Z': 16}","{'Q': 24, 'R': 16, 'S': 8, 'T': 8, 'H': 16, 'M': 8}","{'Y': 8, 'A': 8, 'B': 4, 'D': 4, 'E': 4, 'G': 8, 'I': 4, 'K': 8, 'L': 4, 'N': 4, 'O': 4, 'U': 8, 'V': 4, 'W': 4, 'X': 4}"
INV-ZZ-9529197,SCH-ZZ-3527980,ZZ,ZZ20240507CJBHYD2679.0,2679.0,Boeing 787,05/07/2024,2024-05-07 08:36:00,2024-05-07 22:45:00,CJB,HYD,270.0,306,169,-101,137,27,54,81,108,31,17,10,14,61,34,20,27,97,54,27,43,128,71,37,57,"{'F': 16, 'P': 11}","{'C': 22, 'J': 16, 'Z': 16}","{'Q': 24, 'R': 16, 'S': 8, 'T': 8, 'H': 16, 'M': 8}","{'Y': 8, 'A': 8, 'B': 4, 'D': 4, 'E': 4, 'G': 8, 'I': 4, 'K': 8, 'L': 4, 'N': 4, 'O': 4, 'U': 8, 'V': 4, 'W': 4, 'X': 4}"
INV-ZZ-4940381,SCH-ZZ-3527980,ZZ,ZZ20240509CJBHYD2679.0,2679.0,Boeing 787,05/09/2024,2024-05-09 08:36:00,2024-05-09 22:45:00,CJB,HYD,270.0,321,173,-97,148,27,54,81,108,30,16,11,14,60,32,22,28,95,51,30,44,125,68,40,57,"{'F': 16, 'P': 11}","{'C': 22, 'J': 16, 'Z': 16}","{'Q': 24, 'R': 16, 'S': 8, 'T': 8, 'H': 16, 'M': 8}","{'Y': 8, 'A': 8, 'B': 4, 'D': 4, 'E': 4, 'G': 8, 'I': 4, 'K': 8, 'L': 4, 'N': 4, 'O': 4, 'U': 8, 'V': 4, 'W': 4, 'X': 4}"
INV-ZZ-4414765,SCH-ZZ-3527980,ZZ,ZZ20240511CJBHYD2679.0,2679.0,Boeing 787,05/11/2024,2024-05-11 08:36:00,2024-05-11 22:45:00,CJB,HYD,270.0,321,181,-89,140,27,54,81,108,32,18,9,14,61,34,20,27,95,54,27,41,124,70,38,54,"{'F': 16, 'P': 11}","{'C': 22, 'J': 16, 'Z': 16}","{'Q': 24, 'R': 16, 'S': 8, 'T': 8, 'H': 16, 'M': 8}","{'Y': 8, 'A': 8, 'B': 4, 'D': 4, 'E': 4, 'G': 8, 'I': 4, 'K': 8, 'L': 4, 'N': 4, 'O': 4, 'U': 8, 'V': 4, 'W': 4, 'X': 4}"
INV-ZZ-5981556,SCH-ZZ-3527980,ZZ,ZZ20240512CJBHYD2679.0,2679.0,Boeing 787,05/12/2024,2024-05-12 08:36:00,2024-05-12 22:45:00,CJB,HYD,270.0,320,182,-88,138,27,54,81,108,30,17,10,13,60,34,20,26,94,54,27,40,124,71,37,53,"{'F': 16, 'P': 11}","{'C': 22, 'J': 16, 'Z': 16}","{'Q': 24, 'R': 16, 'S': 8, 'T': 8, 'H': 16, 'M': 8}","{'Y': 8, 'A': 8, 'B': 4, 'D': 4, 'E': 4, 'G': 8, 'I': 4, 'K': 8, 'L': 4, 'N': 4, 'O': 4, 'U': 8, 'V': 4, 'W': 4, 'X': 4}"
INV-ZZ-5379020,SCH-ZZ-3527980,ZZ,ZZ20240513CJBHYD2679.0,2679.0,Boeing 787,05/13/2024,2024-05-13 08:36:00,2024-05-13 22:45:00,CJB,HYD,270.0,321,165,-105,156,27,54,81,108,31,16,11,15,63,32,22,31,92,47,34,45,123,63,45,60,"{'F': 16, 'P': 11}","{'C': 22, 'J': 16, 'Z': 16}","{'Q': 24, 'R': 16, 'S': 8, 'T': 8, 'H': 16, 'M': 8}","{'Y': 8, 'A': 8, 'B': 4, 'D': 4, 'E': 4, 'G': 8, 'I': 4, 'K': 8, 'L': 4, 'N': 4, 'O': 4, 'U': 8, 'V': 4, 'W': 4, 'X': 4}"
INV-ZZ-3576129,SCH-ZZ-3527980,ZZ,ZZ20240514CJBHYD2679.0,2679.0,Boeing 787,05/14/2024,2024-05-14 08:36:00,2024-05-14 22:45:00,CJB,HYD,270.0,305,163,-107,142,27,54,81,108,31,17,10,14,65,35,19,30,93,50,31,43,120,64,44,56,"{'F': 16, 'P': 11}","{'C': 22, 'J': 16, 'Z': 16}","{'Q': 24, 'R': 16, 'S': 8, 'T': 8, 'H': 16, 'M': 8}","{'Y': 8, 'A': 8, 'B': 4, 'D': 4, 'E': 4, 'G': 8, 'I': 4, 'K': 8, 'L': 4, 'N': 4, 'O': 4, 'U': 8, 'V': 4, 'W': 4, 'X': 4}"
INV-ZZ-9705594,SCH-ZZ-3527980,ZZ,ZZ20240516CJBHYD2679.0,2679.0,Boeing 787,05/16/2024,2024-05-16 08:36:00,2024-05-16 22:45:00,CJB,HYD,270.0,313,160,-110,153,27,54,81,108,32,16,11,16,64,33,21,31,93,48,33,45,129,66,42,63,"{'F': 16, 'P': 11}","{'C': 22, 'J': 16, 'Z': 16}","{'Q': 24, 'R': 16, 'S': 8, 'T': 8, 'H': 16, 'M': 8}","{'Y': 8, 'A': 8, 'B': 4, 'D': 4, 'E': 4, 'G': 8, 'I': 4, 'K': 8, 'L': 4, 'N': 4, 'O': 4, 'U': 8, 'V': 4, 'W': 4, 'X': 4}"
INV-ZZ-7917764,SCH-ZZ-3527980,ZZ,ZZ20240518CJBHYD2679.0,2679.0,Boeing 787,05/18/2024,2024-05-18 08:36:00,2024-05-18 22:45:00,CJB,HYD,270.0,323,164,-106,159,27,54,81,108,30,15,12,15,63,32,22,31,95,48,33,47,126,64,44,62,"{'F': 16, 'P': 11}","{'C': 22, 'J': 16, 'Z': 16}","{'Q': 24, 'R': 16, 'S': 8, 'T': 8, 'H': 16, 'M': 8}","{'Y': 8, 'A': 8, 'B': 4, 'D': 4, 'E': 4, 'G': 8, 'I': 4, 'K': 8, 'L': 4, 'N': 4, 'O': 4, 'U': 8, 'V': 4, 'W': 4, 'X': 4}"
INV-ZZ-1729586,SCH-ZZ-3527980,ZZ,ZZ20240519CJBHYD2679.0,2679.0,Boeing 787,05/19/2024,2024-05-19 08:36:00,2024-05-19 22:45:00,CJB,HYD,270.0,302,164,-106,138,27,54,81,108,31,17,10,14,63,34,20,29,91,49,32,42,120,65,43,55,"{'F': 16, 'P': 11}","{'C': 22, 'J': 16, 'Z': 16}","{'Q': 24, 'R': 16, 'S': 8, 'T': 8, 'H': 16, 'M': 8}","{'Y': 8, 'A': 8, 'B': 4, 'D': 4, 'E': 4, 'G': 8, 'I': 4, 'K': 8, 'L': 4, 'N': 4, 'O': 4, 'U': 8, 'V': 4, 'W': 4, 'X': 4}"
INV-ZZ-1911322,SCH-ZZ-3527980,ZZ,ZZ20240520CJBHYD2679.0,2679.0,Boeing 787,05/20/2024,2024-05-20 08:36:00,2024-05-20 22:45:00,CJB,HYD,270.0,305,159,-111,146,27,54,81,108,30,16,11,14,63,33,21,30,91,48,33,43,125,65,43,60,"{'F': 16, 'P': 11}","{'C': 22, 'J': 16, 'Z': 16}","{'Q': 24, 'R': 16, 'S': 8, 'T': 8, 'H': 16, 'M': 8}","{'Y': 8, 'A': 8, 'B': 4, 'D': 4, 'E': 4, 'G': 8, 'I': 4, 'K': 8, 'L': 4, 'N': 4, 'O': 4, 'U': 8, 'V': 4, 'W': 4, 'X': 4}"
INV-ZZ-7994737,SCH-ZZ-3527980,ZZ,ZZ20240521CJBHYD2679.0,2679.0,Boeing 787,05/21/2024,2024-05-21 08:36:00,2024-05-21 22:45:00,CJB,HYD,270.0,306,144,-126,162,27,54,81,108,32,15,12,17,63,30,24,33,92,43,38,49,122,57,51,65,"{'F': 16, 'P': 11}","{'C': 22, 'J': 16, 'Z': 16}","{'Q': 24, 'R': 16, 'S': 8, 'T': 8, 'H': 16, 'M': 8}","{'Y': 8, 'A': 8, 'B': 4, 'D': 4, 'E': 4, 'G': 8, 'I': 4, 'K': 8, 'L': 4, 'N': 4, 'O': 4, 'U': 8, 'V': 4, 'W': 4, 'X': 4}"
INV-ZZ-2206696,SCH-ZZ-3527980,ZZ,ZZ20240523CJBHYD2679.0,2679.0,Boeing 787,05/23/2024,2024-05-23 08:36:00,2024-05-23 22:45:00,CJB,HYD,270.0,307,151,-119,156,27,54,81,108,31,15,12,16,60,29,25,31,97,48,33,49,124,61,47,63,"{'F': 16, 'P': 11}","{'C': 22, 'J': 16, 'Z': 16}","{'Q': 24, 'R': 16, 'S': 8, 'T': 8, 'H': 16, 'M': 8}","{'Y': 8, 'A': 8, 'B': 4, 'D': 4, 'E': 4, 'G': 8, 'I': 4, 'K': 8, 'L': 4, 'N': 4, 'O': 4, 'U': 8, 'V': 4, 'W': 4, 'X': 4}"
INV-ZZ-2243152,SCH-ZZ-3527980,ZZ,ZZ20240525CJBHYD2679.0,2679.0,Boeing 787,05/25/2024,2024-05-25 08:36:00,2024-05-25 22:45:00,CJB,HYD,270.0,310,144,-126,166,27,54,81,108,31,14,13,17,63,29,25,34,95,44,37,51,125,58,50,67,"{'F': 16, 'P': 11}","{'C': 22, 'J': 16, 'Z': 16}","{'Q': 24, 'R': 16, 'S': 8, 'T': 8, 'H': 16, 'M': 8}","{'Y': 8, 'A': 8, 'B': 4, 'D': 4, 'E': 4, 'G': 8, 'I': 4, 'K': 8, 'L': 4, 'N': 4, 'O': 4, 'U': 8, 'V': 4, 'W': 4, 'X': 4}"
INV-ZZ-1124154,SCH-ZZ-3527980,ZZ,ZZ20240526CJBHYD2679.0,2679.0,Boeing 787,05/26/2024,2024-05-26 08:36:00,2024-05-26 22:45:00,CJB,HYD,270.0,300,150,-120,150,27,54,81,108,31,15,12,16,64,32,22,32,92,46,35,46,129,64,44,65,"{'F': 16, 'P': 11}","{'C': 22, 'J': 16, 'Z': 16}","{'Q': 24, 'R': 16, 'S': 8, 'T': 8, 'H': 16, 'M': 8}","{'Y': 8, 'A': 8, 'B': 4, 'D': 4, 'E': 4, 'G': 8, 'I': 4, 'K': 8, 'L': 4, 'N': 4, 'O': 4, 'U': 8, 'V': 4, 'W': 4, 'X': 4}"
INV-ZZ-5121945,SCH-ZZ-3527980,ZZ,ZZ20240527CJBHYD2679.0,2679.0,Boeing 787,05/27/2024,2024-05-27 08:36:00,2024-05-27 22:45:00,CJB,HYD,270.0,322,167,-103,155,27,54,81,108,31,16,11,15,62,32,22,30,96,50,31,46,127,66,42,61,"{'F': 16, 'P': 11}","{'C': 22, 'J': 16, 'Z': 16}","{'Q': 24, 'R': 16, 'S': 8, 'T': 8, 'H': 16, 'M': 8}","{'Y': 8, 'A': 8, 'B': 4, 'D': 4, 'E': 4, 'G': 8, 'I': 4, 'K': 8, 'L': 4, 'N': 4, 'O': 4, 'U': 8, 'V': 4, 'W': 4, 'X': 4}"
INV-ZZ-2629788,SCH-ZZ-3527980,ZZ,ZZ20240528CJBHYD2679.0,2679.0,Boeing 787,05/28/2024,2024-05-28 08:36:00,2024-05-28 22:45:00,CJB,HYD,270.0,315,164,-106,151,27,54,81,108,32,17,10,15,61,32,22,29,93,49,32,44,129,67,41,62,"{'F': 16, 'P': 11}","{'C': 22, 'J': 16, 'Z': 16}","{'Q': 24, 'R': 16, 'S': 8, 'T': 8, 'H': 16, 'M': 8}","{'Y': 8, 'A': 8, 'B': 4, 'D': 4, 'E': 4, 'G': 8, 'I': 4, 'K': 8, 'L': 4, 'N': 4, 'O': 4, 'U': 8, 'V': 4, 'W': 4, 'X': 4}"
INV-ZZ-3141563,SCH-ZZ-3527980,ZZ,ZZ20240530CJBHYD2679.0,2679.0,Boeing 787,05/30/2024,2024-05-30 08:36:00,2024-05-30 22:45:00,CJB,HYD,270.0,312,147,-123,165,27,54,81,108,32,15,12,17,63,30,24,33,90,42,39,48,128,60,48,68,"{'F': 16, 'P': 11}","{'C': 22, 'J': 16, 'Z': 16}","{'Q': 24, 'R': 16, 'S': 8, 'T': 8, 'H': 16, 'M': 8}","{'Y': 8, 'A': 8, 'B': 4, 'D': 4, 'E': 4, 'G': 8, 'I': 4, 'K': 8, 'L': 4, 'N': 4, 'O': 4, 'U': 8, 'V': 4, 'W': 4, 'X': 4}"
INV-ZZ-7191447,SCH-ZZ-3527980,ZZ,ZZ20240601CJBHYD2679.0,2679.0,Boeing 787,06/01/2024,2024-06-01 08:36:00,2024-06-01 22:45:00,CJB,HYD,270.0,322,154,-116,168,27,54,81,108,32,15,12,17,63,30,24,33,93,44,37,49,124,59,49,65,"{'F': 16, 'P': 11}","{'C': 22, 'J': 16, 'Z': 16}","{'Q': 24, 'R': 16, 'S': 8, 'T': 8, 'H': 16, 'M': 8}","{'Y': 8, 'A': 8, 'B': 4, 'D': 4, 'E': 4, 'G': 8, 'I': 4, 'K': 8, 'L': 4, 'N': 4, 'O': 4, 'U': 8, 'V': 4, 'W': 4, 'X': 4}"
INV-ZZ-4077867,SCH-ZZ-3527980,ZZ,ZZ20240602CJBHYD2679.0,2679.0,Boeing 787,06/02/2024,2024-06-02 08:36:00,2024-06-02 22:45:00,CJB,HYD,270.0,311,154,-116,157,27,54,81,108,31,15,12,16,61,30,24,31,94,47,34,47,125,62,46,63,"{'F': 16, 'P': 11}","{'C': 22, 'J': 16, 'Z': 16}","{'Q': 24, 'R': 16, 'S': 8, 'T': 8, 'H': 16, 'M': 8}","{'Y': 8, 'A': 8, 'B': 4, 'D': 4, 'E': 4, 'G': 8, 'I': 4, 'K': 8, 'L': 4, 'N': 4, 'O': 4, 'U': 8, 'V': 4, 'W': 4, 'X': 4}"
INV-ZZ-7285159,SCH-ZZ-3527980,ZZ,ZZ20240603CJBHYD2679.0,2679.0,Boeing 787,06/03/2024,2024-06-03 08:36:00,2024-06-03 22:45:00,CJB,HYD,270.0,311,140,-130,171,27,54,81,108,32,14,13,18,64,29,25,35,89,40,41,49,124,56,52,68,"{'F': 16, 'P': 11}","{'C': 22, 'J': 16, 'Z': 16}","{'Q': 24, 'R': 16, 'S': 8, 'T': 8, 'H': 16, 'M': 8}","{'Y': 8, 'A': 8, 'B': 4, 'D': 4, 'E': 4, 'G': 8, 'I': 4, 'K': 8, 'L': 4, 'N': 4, 'O': 4, 'U': 8, 'V': 4, 'W': 4, 'X': 4}"
INV-ZZ-7827244,SCH-ZZ-3527980,ZZ,ZZ20240604CJBHYD2679.0,2679.0,Boeing 787,06/04/2024,2024-06-04 08:36:00,2024-06-04 22:45:00,CJB,HYD,270.0,308,149,-121,159,27,54,81,108,32,15,12,17,62,30,24,32,94,45,36,49,120,58,50,62,"{'F': 16, 'P': 11}","{'C': 22, 'J': 16, 'Z': 16}","{'Q': 24, 'R': 16, 'S': 8, 'T': 8, 'H': 16, 'M': 8}","{'Y': 8, 'A': 8, 'B': 4, 'D': 4, 'E': 4, 'G': 8, 'I': 4, 'K': 8, 'L': 4, 'N': 4, 'O': 4, 'U': 8, 'V': 4, 'W': 4, 'X': 4}"
INV-ZZ-5933344,SCH-ZZ-3527980,ZZ,ZZ20240606CJBHYD2679.0,2679.0,Boeing 787,06/06/2024,2024-06-06 08:36:00,2024-06-06 22:45:00,CJB,HYD,270.0,315,153,-117,162,27,54,81,108,30,15,12,15,65,32,22,33,96,47,34,49,129,63,45,66,"{'F': 16, 'P': 11}","{'C': 22, 'J': 16, 'Z': 16}","{'Q': 24, 'R': 16, 'S': 8, 'T': 8, 'H': 16, 'M': 8}","{'Y': 8, 'A': 8, 'B': 4, 'D': 4, 'E': 4, 'G': 8, 'I': 4, 'K': 8, 'L': 4, 'N': 4, 'O': 4, 'U': 8, 'V': 4, 'W': 4, 'X': 4}"
INV-ZZ-8862834,SCH-ZZ-3527980,ZZ,ZZ20240608CJBHYD2679.0,2679.0,Boeing 787,06/08/2024,2024-06-08 08:36:00,2024-06-08 22:45:00,CJB,HYD,270.0,312,143,-127,169,27,54,81,108,32,15,12,17,61,28,26,33,90,41,40,49,124,57,51,67,"{'F': 16, 'P': 11}","{'C': 22, 'J': 16, 'Z': 16}","{'Q': 24, 'R': 16, 'S': 8, 'T': 8, 'H': 16, 'M': 8}","{'Y': 8, 'A': 8, 'B': 4, 'D': 4, 'E': 4, 'G': 8, 'I': 4, 'K': 8, 'L': 4, 'N': 4, 'O': 4, 'U': 8, 'V': 4, 'W': 4, 'X': 4}"
INV-ZZ-7243341,SCH-ZZ-3527980,ZZ,ZZ20240609CJBHYD2679.0,2679.0,Boeing 787,06/09/2024,2024-06-09 08:36:00,2024-06-09 22:45:00,CJB,HYD,270.0,309,136,-134,173,27,54,81,108,30,13,14,17,62,27,27,35,92,41,40,51,125,55,53,70,"{'F': 16, 'P': 11}","{'C': 22, 'J': 16, 'Z': 16}","{'Q': 24, 'R': 16, 'S': 8, 'T': 8, 'H': 16, 'M': 8}","{'Y': 8, 'A': 8, 'B': 4, 'D': 4, 'E': 4, 'G': 8, 'I': 4, 'K': 8, 'L': 4, 'N': 4, 'O': 4, 'U': 8, 'V': 4, 'W': 4, 'X': 4}"
INV-ZZ-1922362,SCH-ZZ-3527980,ZZ,ZZ20240610CJBHYD2679.0,2679.0,Boeing 787,06/10/2024,2024-06-10 08:36:00,2024-06-10 22:45:00,CJB,HYD,270.0,307,142,-128,165,27,54,81,108,31,14,13,17,64,30,24,34,91,42,39,49,126,58,50,68,"{'F': 16, 'P': 11}","{'C': 22, 'J': 16, 'Z': 16}","{'Q': 24, 'R': 16, 'S': 8, 'T': 8, 'H': 16, 'M': 8}","{'Y': 8, 'A': 8, 'B': 4, 'D': 4, 'E': 4, 'G': 8, 'I': 4, 'K': 8, 'L': 4, 'N': 4, 'O': 4, 'U': 8, 'V': 4, 'W': 4, 'X': 4}"
INV-ZZ-4053665,SCH-ZZ-3527980,ZZ,ZZ20240611CJBHYD2679.0,2679.0,Boeing 787,06/11/2024,2024-06-11 08:36:00,2024-06-11 22:45:00,CJB,HYD,270.0,313,146,-124,167,27,54,81,108,30,14,13,16,62,29,25,33,96,45,36,51,122,57,51,65,"{'F': 16, 'P': 11}","{'C': 22, 'J': 16, 'Z': 16}","{'Q': 24, 'R': 16, 'S': 8, 'T': 8, 'H': 16, 'M': 8}","{'Y': 8, 'A': 8, 'B': 4, 'D': 4, 'E': 4, 'G': 8, 'I': 4, 'K': 8, 'L': 4, 'N': 4, 'O': 4, 'U': 8, 'V': 4, 'W': 4, 'X': 4}"
INV-ZZ-7240735,SCH-ZZ-3527980,ZZ,ZZ20240613CJBHYD2679.0,2679.0,Boeing 787,06/13/2024,2024-06-13 08:36:00,2024-06-13 22:45:00,CJB,HYD,270.0,302,141,-129,161,27,54,81,108,31,15,12,16,61,29,25,32,97,45,36,52,128,60,48,68,"{'F': 16, 'P': 11}","{'C': 22, 'J': 16, 'Z': 16}","{'Q': 24, 'R': 16, 'S': 8, 'T': 8, 'H': 16, 'M': 8}","{'Y': 8, 'A': 8, 'B': 4, 'D': 4, 'E': 4, 'G': 8, 'I': 4, 'K': 8, 'L': 4, 'N': 4, 'O': 4, 'U': 8, 'V': 4, 'W': 4, 'X': 4}"
INV-ZZ-5364904,SCH-ZZ-3527980,ZZ,ZZ20240615CJBHYD2679.0,2679.0,Boeing 787,06/15/2024,2024-06-15 08:36:00,2024-06-15 22:45:00,CJB,HYD,270.0,303,137,-133,166,27,54,81,108,31,14,13,17,65,29,25,36,90,41,40,49,122,55,53,67,"{'F': 16, 'P': 11}","{'C': 22, 'J': 16, 'Z': 16}","{'Q': 24, 'R': 16, 'S': 8, 'T': 8, 'H': 16, 'M': 8}","{'Y': 8, 'A': 8, 'B': 4, 'D': 4, 'E': 4, 'G': 8, 'I': 4, 'K': 8, 'L': 4, 'N': 4, 'O': 4, 'U': 8, 'V': 4, 'W': 4, 'X': 4}"
INV-ZZ-5686902,SCH-ZZ-3527980,ZZ,ZZ20240616CJBHYD2679.0,2679.0,Boeing 787,06/16/2024,2024-06-16 08:36:00,2024-06-16 22:45:00,CJB,HYD,270.0,319,136,-134,183,27,54,81,108,32,14,13,18,61,26,28,35,96,41,40,55,121,52,56,69,"{'F': 16, 'P': 11}","{'C': 22, 'J': 16, 'Z': 16}","{'Q': 24, 'R': 16, 'S': 8, 'T': 8, 'H': 16, 'M': 8}","{'Y': 8, 'A': 8, 'B': 4, 'D': 4, 'E': 4, 'G': 8, 'I': 4, 'K': 8, 'L': 4, 'N': 4, 'O': 4, 'U': 8, 'V': 4, 'W': 4, 'X': 4}"
INV-ZZ-6565290,SCH-ZZ-3527980,ZZ,ZZ20240617CJBHYD2679.0,2679.0,Boeing 787,06/17/2024,2024-06-17 08:36:00,2024-06-17 22:45:00,CJB,HYD,270.0,306,125,-145,181,27,54,81,108,32,13,14,19,60,25,29,35,93,38,43,55,129,53,55,76,"{'F': 16, 'P': 11}","{'C': 22, 'J': 16, 'Z': 16}","{'Q': 24, 'R': 16, 'S': 8, 'T': 8, 'H': 16, 'M': 8}","{'Y': 8, 'A': 8, 'B': 4, 'D': 4, 'E': 4, 'G': 8, 'I': 4, 'K': 8, 'L': 4, 'N': 4, 'O': 4, 'U': 8, 'V': 4, 'W': 4, 'X': 4}"
INV-ZZ-2183817,SCH-ZZ-3527980,ZZ,ZZ20240618CJBHYD2679.0,2679.0,Boeing 787,06/18/2024,2024-06-18 08:36:00,2024-06-18 22:45:00,CJB,HYD,270.0,323,145,-125,178,27,54,81,108,32,14,13,18,65,29,25,36,95,43,38,52,126,57,51,69,"{'F': 16, 'P': 11}","{'C': 22, 'J': 16, 'Z': 16}","{'Q': 24, 'R': 16, 'S': 8, 'T': 8, 'H': 16, 'M': 8}","{'Y': 8, 'A': 8, 'B': 4, 'D': 4, 'E': 4, 'G': 8, 'I': 4, 'K': 8, 'L': 4, 'N': 4, 'O': 4, 'U': 8, 'V': 4, 'W': 4, 'X': 4}"
INV-ZZ-7380236,SCH-ZZ-7946326,ZZ,ZZ20240503PNQGAU3270.0,3270.0,Boeing 777,05/03/2024,2024-05-03 11:13:00,2024-05-03 13:53:00,PNQ,GAU,425.0,507,273,-152,234,42,85,127,170,49,26,16,23,97,52,33,45,147,79,48,68,191,103,67,88,"{'F': 25, 'P': 17}","{'C': 34, 'J': 26, 'Z': 26}","{'Q': 38, 'R': 25, 'S': 13, 'T': 13, 'H': 25, 'M': 13}","{'Y': 13, 'A': 13, 'B': 6, 'D': 6, 'E': 6, 'G': 13, 'I': 6, 'K': 13, 'L': 6, 'N': 6, 'O': 6, 'U': 13, 'V': 6, 'W': 6, 'X': 6}"
INV-ZZ-3140794,SCH-ZZ-7946326,ZZ,ZZ20240505PNQGAU3270.0,3270.0,Boeing 777,05/05/2024,2024-05-05 11:13:00,2024-05-05 13:53:00,PNQ,GAU,425.0,489,251,-174,238,42,85,127,170,48,25,17,23,94,48,37,46,143,73,54,70,192,98,72,94,"{'F': 25, 'P': 17}","{'C': 34, 'J': 26, 'Z': 26}","{'Q': 38, 'R': 25, 'S': 13, 'T': 13, 'H': 25, 'M': 13}","{'Y': 13, 'A': 13, 'B': 6, 'D': 6, 'E': 6, 'G': 13, 'I': 6, 'K': 13, 'L': 6, 'N': 6, 'O': 6, 'U': 13, 'V': 6, 'W': 6, 'X': 6}"
INV-ZZ-5556952,SCH-ZZ-7946326,ZZ,ZZ20240510PNQGAU3270.0,3270.0,Boeing 777,05/10/2024,2024-05-10 11:13:00,2024-05-10 13:53:00,PNQ,GAU,425.0,494,260,-165,234,42,85,127,170,47,25,17,22,96,51,34,45,147,77,50,70,195,103,67,92,"{'F': 25, 'P': 17}","{'C': 34, 'J': 26, 'Z': 26}","{'Q': 38, 'R': 25, 'S': 13, 'T': 13, 'H': 25, 'M': 13}","{'Y': 13, 'A': 13, 'B': 6, 'D': 6, 'E': 6, 'G': 13, 'I': 6, 'K': 13, 'L': 6, 'N': 6, 'O': 6, 'U': 13, 'V': 6, 'W': 6, 'X': 6}"
INV-ZZ-3055721,SCH-ZZ-7946326,ZZ,ZZ20240512PNQGAU3270.0,3270.0,Boeing 777,05/12/2024,2024-05-12 11:13:00,2024-05-12 13:53:00,PNQ,GAU,425.0,476,260,-165,216,42,85,127,170,47,26,16,21,94,51,34,43,143,78,49,65,194,106,64,88,"{'F': 25, 'P': 17}","{'C': 34, 'J': 26, 'Z': 26}","{'Q': 38, 'R': 25, 'S': 13, 'T': 13, 'H': 25, 'M': 13}","{'Y': 13, 'A': 13, 'B': 6, 'D': 6, 'E': 6, 'G': 13, 'I': 6, 'K': 13, 'L': 6, 'N': 6, 'O': 6, 'U': 13, 'V': 6, 'W': 6, 'X': 6}"
INV-ZZ-4332022,SCH-ZZ-7946326,ZZ,ZZ20240517PNQGAU3270.0,3270.0,Boeing 777,05/17/2024,2024-05-17 11:13:00,2024-05-17 13:53:00,PNQ,GAU,425.0,472,256,-169,216,42,85,127,170,49,27,15,22,95,52,33,43,141,77,50,64,193,105,65,88,"{'F': 25, 'P': 17}","{'C': 34, 'J': 26, 'Z': 26}","{'Q': 38, 'R': 25, 'S': 13, 'T': 13, 'H': 25, 'M': 13}","{'Y': 13, 'A': 13, 'B': 6, 'D': 6, 'E': 6, 'G': 13, 'I': 6, 'K': 13, 'L': 6, 'N': 6, 'O': 6, 'U': 13, 'V': 6, 'W': 6, 'X': 6}"
INV-ZZ-8750517,SCH-ZZ-7946326,ZZ,ZZ20240519PNQGAU3270.0,3270.0,Boeing 777,05/19/2024,2024-05-19 11:13:00,2024-05-19 13:53:00,PNQ,GAU,425.0,475,243,-182,232,42,85,127,170,48,25,17,23,98,50,35,48,151,77,50,74,202,103,67,99,"{'F': 25, 'P': 17}","{'C': 34, 'J': 26, 'Z': 26}","{'Q': 38, 'R': 25, 'S': 13, 'T': 13, 'H': 25, 'M': 13}","{'Y': 13, 'A': 13, 'B': 6, 'D': 6, 'E': 6, 'G': 13, 'I': 6, 'K': 13, 'L': 6, 'N': 6, 'O': 6, 'U': 13, 'V': 6, 'W': 6, 'X': 6}"
INV-ZZ-7534550,SCH-ZZ-7946326,ZZ,ZZ20240524PNQGAU3270.0,3270.0,Boeing 777,05/24/2024,2024-05-24 11:13:00,2024-05-24 13:53:00,PNQ,GAU,425.0,478,225,-200,253,42,85,127,170,48,23,19,25,95,45,40,50,147,69,58,78,198,93,77,105,"{'F': 25, 'P': 17}","{'C': 34, 'J': 26, 'Z': 26}","{'Q': 38, 'R': 25, 'S': 13, 'T': 13, 'H': 25, 'M': 13}","{'Y': 13, 'A': 13, 'B': 6, 'D': 6, 'E': 6, 'G': 13, 'I': 6, 'K': 13, 'L': 6, 'N': 6, 'O': 6, 'U': 13, 'V': 6, 'W': 6, 'X': 6}"
INV-ZZ-6708462,SCH-ZZ-7946326,ZZ,ZZ20240526PNQGAU3270.0,3270.0,Boeing 777,05/26/2024,2024-05-26 11:13:00,2024-05-26 13:53:00,PNQ,GAU,425.0,507,266,-159,241,42,85,127,170,46,24,18,22,101,53,32,48,146,77,50,69,187,98,72,89,"{'F': 25, 'P': 17}","{'C': 34, 'J': 26, 'Z': 26}","{'Q': 38, 'R': 25, 'S': 13, 'T': 13, 'H': 25, 'M': 13}","{'Y': 13, 'A': 13, 'B': 6, 'D': 6, 'E': 6, 'G': 13, 'I': 6, 'K': 13, 'L': 6, 'N': 6, 'O': 6, 'U': 13, 'V': 6, 'W': 6, 'X': 6}"
INV-ZZ-9133323,SCH-ZZ-7946326,ZZ,ZZ20240531PNQGAU3270.0,3270.0,Boeing 777,05/31/2024,2024-05-31 11:13:00,2024-05-31 13:53:00,PNQ,GAU,425.0,490,239,-186,251,42,85,127,170,47,23,19,24,97,47,38,50,148,72,55,76,201,98,72,103,"{'F': 25, 'P': 17}","{'C': 34, 'J': 26, 'Z': 26}","{'Q': 38, 'R': 25, 'S': 13, 'T': 13, 'H': 25, 'M': 13}","{'Y': 13, 'A': 13, 'B': 6, 'D': 6, 'E': 6, 'G': 13, 'I': 6, 'K': 13, 'L': 6, 'N': 6, 'O': 6, 'U': 13, 'V': 6, 'W': 6, 'X': 6}"
INV-ZZ-9898816,SCH-ZZ-7946326,ZZ,ZZ20240602PNQGAU3270.0,3270.0,Boeing 777,06/02/2024,2024-06-02 11:13:00,2024-06-02 13:53:00,PNQ,GAU,425.0,502,246,-179,256,42,85,127,170,49,24,18,25,94,46,39,48,151,74,53,77,198,97,73,101,"{'F': 25, 'P': 17}","{'C': 34, 'J': 26, 'Z': 26}","{'Q': 38, 'R': 25, 'S': 13, 'T': 13, 'H': 25, 'M': 13}","{'Y': 13, 'A': 13, 'B': 6, 'D': 6, 'E': 6, 'G': 13, 'I': 6, 'K': 13, 'L': 6, 'N': 6, 'O': 6, 'U': 13, 'V': 6, 'W': 6, 'X': 6}"
INV-ZZ-3182630,SCH-ZZ-7946326,ZZ,ZZ20240607PNQGAU3270.0,3270.0,Boeing 777,06/07/2024,2024-06-07 11:13:00,2024-06-07 13:53:00,PNQ,GAU,425.0,496,248,-177,248,42,85,127,170,49,24,18,25,94,47,38,47,151,75,52,76,197,98,72,99,"{'F': 25, 'P': 17}","{'C': 34, 'J': 26, 'Z': 26}","{'Q': 38, 'R': 25, 'S': 13, 'T': 13, 'H': 25, 'M': 13}","{'Y': 13, 'A': 13, 'B': 6, 'D': 6, 'E': 6, 'G': 13, 'I': 6, 'K': 13, 'L': 6, 'N': 6, 'O': 6, 'U': 13, 'V': 6, 'W': 6, 'X': 6}"
INV-ZZ-9361310,SCH-ZZ-7946326,ZZ,ZZ20240609PNQGAU3270.0,3270.0,Boeing 777,06/09/2024,2024-06-09 11:13:00,2024-06-09 13:53:00,PNQ,GAU,425.0,476,201,-224,275,42,85,127,170,48,20,22,28,100,42,43,58,141,59,68,82,203,86,84,117,"{'F': 25, 'P': 17}","{'C': 34, 'J': 26, 'Z': 26}","{'Q': 38, 'R': 25, 'S': 13, 'T': 13, 'H': 25, 'M': 13}","{'Y': 13, 'A': 13, 'B': 6, 'D': 6, 'E': 6, 'G': 13, 'I': 6, 'K': 13, 'L': 6, 'N': 6, 'O': 6, 'U': 13, 'V': 6, 'W': 6, 'X': 6}"
INV-ZZ-3979392,SCH-ZZ-7946326,ZZ,ZZ20240614PNQGAU3270.0,3270.0,Boeing 777,06/14/2024,2024-06-14 11:13:00,2024-06-14 13:53:00,PNQ,GAU,425.0,485,220,-205,265,42,85,127,170,50,23,19,27,97,44,41,53,145,66,61,79,198,90,80,108,"{'F': 25, 'P': 17}","{'C': 34, 'J': 26, 'Z': 26}","{'Q': 38, 'R': 25, 'S': 13, 'T': 13, 'H': 25, 'M': 13}","{'Y': 13, 'A': 13, 'B': 6, 'D': 6, 'E': 6, 'G': 13, 'I': 6, 'K': 13, 'L': 6, 'N': 6, 'O': 6, 'U': 13, 'V': 6, 'W': 6, 'X': 6}"
INV-ZZ-4262173,SCH-ZZ-7946326,ZZ,ZZ20240616PNQGAU3270.0,3270.0,Boeing 777,06/16/2024,2024-06-16 11:13:00,2024-06-16 13:53:00,PNQ,GAU,425.0,507,213,-212,294,42,85,127,170,47,20,22,27,98,41,44,57,151,63,64,88,193,81,89,112,"{'F': 25, 'P': 17}","{'C': 34, 'J': 26, 'Z': 26}","{'Q': 38, 'R': 25, 'S': 13, 'T': 13, 'H': 25, 'M': 13}","{'Y': 13, 'A': 13, 'B': 6, 'D': 6, 'E': 6, 'G': 13, 'I': 6, 'K': 13, 'L': 6, 'N': 6, 'O': 6, 'U': 13, 'V': 6, 'W': 6, 'X': 6}"
INV-ZZ-4828758,SCH-ZZ-2404944,ZZ,ZZ20240407PNQGAU4614.0,4614.0,Airbus A320-200,04/07/2024,2024-04-07 23:31:00,2024-04-08 23:12:00,PNQ,GAU,150.0,177,116,-34,61,15,30,45,60,18,12,3,6,35,23,7,12,54,35,10,19,69,45,15,24,"{'F': 9, 'P': 6}","{'C': 12, 'J': 9, 'Z': 9}","{'Q': 14, 'R': 9, 'S': 4, 'T': 4, 'H': 9, 'M': 4}","{'Y': 4, 'A': 4, 'B': 2, 'D': 2, 'E': 2, 'G': 4, 'I': 2, 'K': 4, 'L': 2, 'N': 2, 'O': 2, 'U': 4, 'V': 2, 'W': 2, 'X': 2}"
INV-ZZ-7480391,SCH-ZZ-2404944,ZZ,ZZ20240409PNQGAU4614.0,4614.0,Airbus A320-200,04/09/2024,2024-04-09 23:31:00,2024-04-10 23:12:00,PNQ,GAU,150.0,167,96,-54,71,15,30,45,60,18,10,5,8,35,20,10,15,51,29,16,22,70,40,20,30,"{'F': 9, 'P': 6}","{'C': 12, 'J': 9, 'Z': 9}","{'Q': 14, 'R': 9, 'S': 4, 'T': 4, 'H': 9, 'M': 4}","{'Y': 4, 'A': 4, 'B': 2, 'D': 2, 'E': 2, 'G': 4, 'I': 2, 'K': 4, 'L': 2, 'N': 2, 'O': 2, 'U': 4, 'V': 2, 'W': 2, 'X': 2}"
INV-ZZ-5828272,SCH-ZZ-2404944,ZZ,ZZ20240410PNQGAU4614.0,4614.0,Airbus A320-200,04/10/2024,2024-04-10 23:31:00,2024-04-11 23:12:00,PNQ,GAU,150.0,177,116,-34,61,15,30,45,60,17,11,4,6,34,22,8,12,50,33,12,17,69,45,15,24,"{'F': 9, 'P': 6}","{'C': 12, 'J': 9, 'Z': 9}","{'Q': 14, 'R': 9, 'S': 4, 'T': 4, 'H': 9, 'M': 4}","{'Y': 4, 'A': 4, 'B': 2, 'D': 2, 'E': 2, 'G': 4, 'I': 2, 'K': 4, 'L': 2, 'N': 2, 'O': 2, 'U': 4, 'V': 2, 'W': 2, 'X': 2}"
INV-ZZ-9604342,SCH-ZZ-2404944,ZZ,ZZ20240411PNQGAU4614.0,4614.0,Airbus A320-200,04/11/2024,2024-04-11 23:31:00,2024-04-12 23:12:00,PNQ,GAU,150.0,166,98,-52,68,15,30,45,60,18,11,4,7,34,20,10,14,50,30,15,20,72,43,17,29,"{'F': 9, 'P': 6}","{'C': 12, 'J': 9, 'Z': 9}","{'Q': 14, 'R': 9, 'S': 4, 'T': 4, 'H': 9, 'M': 4}","{'Y': 4, 'A': 4, 'B': 2, 'D': 2, 'E': 2, 'G': 4, 'I': 2, 'K': 4, 'L': 2, 'N': 2, 'O': 2, 'U': 4, 'V': 2, 'W': 2, 'X': 2}"
INV-ZZ-1008156,SCH-ZZ-2404944,ZZ,ZZ20240414PNQGAU4614.0,4614.0,Airbus A320-200,04/14/2024,2024-04-14 23:31:00,2024-04-15 23:12:00,PNQ,GAU,150.0,178,115,-35,63,15,30,45,60,18,12,3,6,35,23,7,12,53,34,11,19,72,47,13,25,"{'F': 9, 'P': 6}","{'C': 12, 'J': 9, 'Z': 9}","{'Q': 14, 'R': 9, 'S': 4, 'T': 4, 'H': 9, 'M': 4}","{'Y': 4, 'A': 4, 'B': 2, 'D': 2, 'E': 2, 'G': 4, 'I': 2, 'K': 4, 'L': 2, 'N': 2, 'O': 2, 'U': 4, 'V': 2, 'W': 2, 'X': 2}"
INV-ZZ-3225488,SCH-ZZ-2404944,ZZ,ZZ20240416PNQGAU4614.0,4614.0,Airbus A320-200,04/16/2024,2024-04-16 23:31:00,2024-04-17 23:12:00,PNQ,GAU,150.0,167,104,-46,63,15,30,45,60,18,11,4,7,35,22,8,13,54,34,11,20,70,43,17,27,"{'F': 9, 'P': 6}","{'C': 12, 'J': 9, 'Z': 9}","{'Q': 14, 'R': 9, 'S': 4, 'T': 4, 'H': 9, 'M': 4}","{'Y': 4, 'A': 4, 'B': 2, 'D': 2, 'E': 2, 'G': 4, 'I': 2, 'K': 4, 'L': 2, 'N': 2, 'O': 2, 'U': 4, 'V': 2, 'W': 2, 'X': 2}"
INV-ZZ-7199346,SCH-ZZ-2404944,ZZ,ZZ20240417PNQGAU4614.0,4614.0,Airbus A320-200,04/17/2024,2024-04-17 23:31:00,2024-04-18 23:12:00,PNQ,GAU,150.0,170,103,-47,67,15,30,45,60,18,11,4,7,35,21,9,14,52,31,14,21,66,40,20,26,"{'F': 9, 'P': 6}","{'C': 12, 'J': 9, 'Z': 9}","{'Q': 14, 'R': 9, 'S': 4, 'T': 4, 'H': 9, 'M': 4}","{'Y': 4, 'A': 4, 'B': 2, 'D': 2, 'E': 2, 'G': 4, 'I': 2, 'K': 4, 'L': 2, 'N': 2, 'O': 2, 'U': 4, 'V': 2, 'W': 2, 'X': 2}"
INV-ZZ-3676497,SCH-ZZ-2404944,ZZ,ZZ20240418PNQGAU4614.0,4614.0,Airbus A320-200,04/18/2024,2024-04-18 23:31:00,2024-04-19 23:12:00,PNQ,GAU,150.0,179,101,-49,78,15,30,45,60,17,10,5,7,33,19,11,14,53,30,15,23,70,40,20,30,"{'F': 9, 'P': 6}","{'C': 12, 'J': 9, 'Z': 9}","{'Q': 14, 'R': 9, 'S': 4, 'T': 4, 'H': 9, 'M': 4}","{'Y': 4, 'A': 4, 'B': 2, 'D': 2, 'E': 2, 'G': 4, 'I': 2, 'K': 4, 'L': 2, 'N': 2, 'O': 2, 'U': 4, 'V': 2, 'W': 2, 'X': 2}"
INV-ZZ-5131275,SCH-ZZ-2404944,ZZ,ZZ20240421PNQGAU4614.0,4614.0,Airbus A320-200,04/21/2024,2024-04-21 23:31:00,2024-04-22 23:12:00,PNQ,GAU,150.0,170,95,-55,75,15,30,45,60,17,10,5,7,35,20,10,15,51,29,16,22,70,39,21,31,"{'F': 9, 'P': 6}","{'C': 12, 'J': 9, 'Z': 9}","{'Q': 14, 'R': 9, 'S': 4, 'T': 4, 'H': 9, 'M': 4}","{'Y': 4, 'A': 4, 'B': 2, 'D': 2, 'E': 2, 'G': 4, 'I': 2, 'K': 4, 'L': 2, 'N': 2, 'O': 2, 'U': 4, 'V': 2, 'W': 2, 'X': 2}"
INV-ZZ-5945685,SCH-ZZ-2404944,ZZ,ZZ20240423PNQGAU4614.0,4614.0,Airbus A320-200,04/23/2024,2024-04-23 23:31:00,2024-04-24 23:12:00,PNQ,GAU,150.0,173,103,-47,70,15,30,45,60,17,10,5,7,35,21,9,14,54,32,13,22,70,42,18,28,"{'F': 9, 'P': 6}","{'C': 12, 'J': 9, 'Z': 9}","{'Q': 14, 'R': 9, 'S': 4, 'T': 4, 'H': 9, 'M': 4}","{'Y': 4, 'A': 4, 'B': 2, 'D': 2, 'E': 2, 'G': 4, 'I': 2, 'K': 4, 'L': 2, 'N': 2, 'O': 2, 'U': 4, 'V': 2, 'W': 2, 'X': 2}"
INV-ZZ-3851757,SCH-ZZ-2404944,ZZ,ZZ20240424PNQGAU4614.0,4614.0,Airbus A320-200,04/24/2024,2024-04-24 23:31:00,2024-04-25 23:12:00,PNQ,GAU,150.0,167,102,-48,65,15,30,45,60,17,10,5,7,34,21,9,13,50,31,14,19,68,42,18,26,"{'F': 9, 'P': 6}","{'C': 12, 'J': 9, 'Z': 9}","{'Q': 14, 'R': 9, 'S': 4, 'T': 4, 'H': 9, 'M': 4}","{'Y': 4, 'A': 4, 'B': 2, 'D': 2, 'E': 2, 'G': 4, 'I': 2, 'K': 4, 'L': 2, 'N': 2, 'O': 2, 'U': 4, 'V': 2, 'W': 2, 'X': 2}"
INV-ZZ-6068765,SCH-ZZ-2404944,ZZ,ZZ20240425PNQGAU4614.0,4614.0,Airbus A320-200,04/25/2024,2024-04-25 23:31:00,2024-04-26 23:12:00,PNQ,GAU,150.0,171,96,-54,75,15,30,45,60,18,10,5,8,33,18,12,15,52,29,16,23,72,40,20,32,"{'F': 9, 'P': 6}","{'C': 12, 'J': 9, 'Z': 9}","{'Q': 14, 'R': 9, 'S': 4, 'T': 4, 'H': 9, 'M': 4}","{'Y': 4, 'A': 4, 'B': 2, 'D': 2, 'E': 2, 'G': 4, 'I': 2, 'K': 4, 'L': 2, 'N': 2, 'O': 2, 'U': 4, 'V': 2, 'W': 2, 'X': 2}"
INV-ZZ-6117770,SCH-ZZ-2404944,ZZ,ZZ20240428PNQGAU4614.0,4614.0,Airbus A320-200,04/28/2024,2024-04-28 23:31:00,2024-04-29 23:12:00,PNQ,GAU,150.0,167,91,-59,76,15,30,45,60,17,9,6,8,33,18,12,15,50,27,18,23,69,38,22,31,"{'F': 9, 'P': 6}","{'C': 12, 'J': 9, 'Z': 9}","{'Q': 14, 'R': 9, 'S': 4, 'T': 4, 'H': 9, 'M': 4}","{'Y': 4, 'A': 4, 'B': 2, 'D': 2, 'E': 2, 'G': 4, 'I': 2, 'K': 4, 'L': 2, 'N': 2, 'O': 2, 'U': 4, 'V': 2, 'W': 2, 'X': 2}"
INV-ZZ-4392741,SCH-ZZ-2404944,ZZ,ZZ20240430PNQGAU4614.0,4614.0,Airbus A320-200,04/30/2024,2024-04-30 23:31:00,2024-05-01 23:12:00,PNQ,GAU,150.0,172,104,-46,68,15,30,45,60,17,10,5,7,35,21,9,14,50,30,15,20,71,43,17,28,"{'F': 9, 'P': 6}","{'C': 12, 'J': 9, 'Z': 9}","{'Q': 14, 'R': 9, 'S': 4, 'T': 4, 'H': 9, 'M': 4}","{'Y': 4, 'A': 4, 'B': 2, 'D': 2, 'E': 2, 'G': 4, 'I': 2, 'K': 4, 'L': 2, 'N': 2, 'O': 2, 'U': 4, 'V': 2, 'W': 2, 'X': 2}"
INV-ZZ-3182807,SCH-ZZ-2404944,ZZ,ZZ20240501PNQGAU4614.0,4614.0,Airbus A320-200,05/01/2024,2024-05-01 23:31:00,2024-05-02 23:12:00,PNQ,GAU,150.0,167,101,-49,66,15,30,45,60,18,11,4,7,34,20,10,14,51,31,14,20,67,40,20,27,"{'F': 9, 'P': 6}","{'C': 12, 'J': 9, 'Z': 9}","{'Q': 14, 'R': 9, 'S': 4, 'T': 4, 'H': 9, 'M': 4}","{'Y': 4, 'A': 4, 'B': 2, 'D': 2, 'E': 2, 'G': 4, 'I': 2, 'K': 4, 'L': 2, 'N': 2, 'O': 2, 'U': 4, 'V': 2, 'W': 2, 'X': 2}"
INV-ZZ-1154219,SCH-ZZ-2404944,ZZ,ZZ20240502PNQGAU4614.0,4614.0,Airbus A320-200,05/02/2024,2024-05-02 23:31:00,2024-05-03 23:12:00,PNQ,GAU,150.0,176,103,-47,73,15,30,45,60,18,11,4,7,33,19,11,14,50,29,16,21,68,40,20,28,"{'F': 9, 'P': 6}","{'C': 12, 'J': 9, 'Z': 9}","{'Q': 14, 'R': 9, 'S': 4, 'T': 4, 'H': 9, 'M': 4}","{'Y': 4, 'A': 4, 'B': 2, 'D': 2, 'E': 2, 'G': 4, 'I': 2, 'K': 4, 'L': 2, 'N': 2, 'O': 2, 'U': 4, 'V': 2, 'W': 2, 'X': 2}"
INV-ZZ-6403746,SCH-ZZ-2404944,ZZ,ZZ20240505PNQGAU4614.0,4614.0,Airbus A320-200,05/05/2024,2024-05-05 23:31:00,2024-05-06 23:12:00,PNQ,GAU,150.0,179,93,-57,86,15,30,45,60,18,9,6,9,35,18,12,17,51,27,18,24,71,37,23,34,"{'F': 9, 'P': 6}","{'C': 12, 'J': 9, 'Z': 9}","{'Q': 14, 'R': 9, 'S': 4, 'T': 4, 'H': 9, 'M': 4}","{'Y': 4, 'A': 4, 'B': 2, 'D': 2, 'E': 2, 'G': 4, 'I': 2, 'K': 4, 'L': 2, 'N': 2, 'O': 2, 'U': 4, 'V': 2, 'W': 2, 'X': 2}"
INV-ZZ-3660618,SCH-ZZ-2404944,ZZ,ZZ20240507PNQGAU4614.0,4614.0,Airbus A320-200,05/07/2024,2024-05-07 23:31:00,2024-05-08 23:12:00,PNQ,GAU,150.0,178,93,-57,85,15,30,45,60,17,9,6,8,36,19,11,17,50,26,19,24,70,36,24,34,"{'F': 9, 'P': 6}","{'C': 12, 'J': 9, 'Z': 9}","{'Q': 14, 'R': 9, 'S': 4, 'T': 4, 'H': 9, 'M': 4}","{'Y': 4, 'A': 4, 'B': 2, 'D': 2, 'E': 2, 'G': 4, 'I': 2, 'K': 4, 'L': 2, 'N': 2, 'O': 2, 'U': 4, 'V': 2, 'W': 2, 'X': 2}"
INV-ZZ-6506967,SCH-ZZ-2404944,ZZ,ZZ20240508PNQGAU4614.0,4614.0,Airbus A320-200,05/08/2024,2024-05-08 23:31:00,2024-05-09 23:12:00,PNQ,GAU,150.0,170,89,-61,81,15,30,45,60,17,9,6,8,35,18,12,17,50,26,19,24,67,35,25,32,"{'F': 9, 'P': 6}","{'C': 12, 'J': 9, 'Z': 9}","{'Q': 14, 'R': 9, 'S': 4, 'T': 4, 'H': 9, 'M': 4}","{'Y': 4, 'A': 4, 'B': 2, 'D': 2, 'E': 2, 'G': 4, 'I': 2, 'K': 4, 'L': 2, 'N': 2, 'O': 2, 'U': 4, 'V': 2, 'W': 2, 'X': 2}"
INV-ZZ-4720561,SCH-ZZ-2404944,ZZ,ZZ20240509PNQGAU4614.0,4614.0,Airbus A320-200,05/09/2024,2024-05-09 23:31:00,2024-05-10 23:12:00,PNQ,GAU,150.0,176,101,-49,75,15,30,45,60,17,10,5,7,35,20,10,15,51,29,16,22,68,39,21,29,"{'F': 9, 'P': 6}","{'C': 12, 'J': 9, 'Z': 9}","{'Q': 14, 'R': 9, 'S': 4, 'T': 4, 'H': 9, 'M': 4}","{'Y': 4, 'A': 4, 'B': 2, 'D': 2, 'E': 2, 'G': 4, 'I': 2, 'K': 4, 'L': 2, 'N': 2, 'O': 2, 'U': 4, 'V': 2, 'W': 2, 'X': 2}"
INV-ZZ-2975578,SCH-ZZ-2404944,ZZ,ZZ20240512PNQGAU4614.0,4614.0,Airbus A320-200,05/12/2024,2024-05-12 23:31:00,2024-05-13 23:12:00,PNQ,GAU,150.0,166,84,-66,82,15,30,45,60,18,9,6,9,33,17,13,16,51,26,19,25,70,36,24,34,"{'F': 9, 'P': 6}","{'C': 12, 'J': 9, 'Z': 9}","{'Q': 14, 'R': 9, 'S': 4, 'T': 4, 'H': 9, 'M': 4}","{'Y': 4, 'A': 4, 'B': 2, 'D': 2, 'E': 2, 'G': 4, 'I': 2, 'K': 4, 'L': 2, 'N': 2, 'O': 2, 'U': 4, 'V': 2, 'W': 2, 'X': 2}"
INV-ZZ-2775018,SCH-ZZ-2404944,ZZ,ZZ20240514PNQGAU4614.0,4614.0,Airbus A320-200,05/14/2024,2024-05-14 23:31:00,2024-05-15 23:12:00,PNQ,GAU,150.0,174,88,-62,86,15,30,45,60,17,9,6,8,34,17,13,17,51,26,19,25,69,35,25,34,"{'F': 9, 'P': 6}","{'C': 12, 'J': 9, 'Z': 9}","{'Q': 14, 'R': 9, 'S': 4, 'T': 4, 'H': 9, 'M': 4}","{'Y': 4, 'A': 4, 'B': 2, 'D': 2, 'E': 2, 'G': 4, 'I': 2, 'K': 4, 'L': 2, 'N': 2, 'O': 2, 'U': 4, 'V': 2, 'W': 2, 'X': 2}"
INV-ZZ-9555027,SCH-ZZ-2404944,ZZ,ZZ20240515PNQGAU4614.0,4614.0,Airbus A320-200,05/15/2024,2024-05-15 23:31:00,2024-05-16 23:12:00,PNQ,GAU,150.0,178,87,-63,91,15,30,45,60,18,9,6,9,35,17,13,18,53,26,19,27,69,34,26,35,"{'F': 9, 'P': 6}","{'C': 12, 'J': 9, 'Z': 9}","{'Q': 14, 'R': 9, 'S': 4, 'T': 4, 'H': 9, 'M': 4}","{'Y': 4, 'A': 4, 'B': 2, 'D': 2, 'E': 2, 'G': 4, 'I': 2, 'K': 4, 'L': 2, 'N': 2, 'O': 2, 'U': 4, 'V': 2, 'W': 2, 'X': 2}"
INV-ZZ-3800958,SCH-ZZ-2404944,ZZ,ZZ20240516PNQGAU4614.0,4614.0,Airbus A320-200,05/16/2024,2024-05-16 23:31:00,2024-05-17 23:12:00,PNQ,GAU,150.0,170,94,-56,76,15,30,45,60,17,9,6,8,33,18,12,15,50,28,17,22,71,39,21,32,"{'F': 9, 'P': 6}","{'C': 12, 'J': 9, 'Z': 9}","{'Q': 14, 'R': 9, 'S': 4, 'T': 4, 'H': 9, 'M': 4}","{'Y': 4, 'A': 4, 'B': 2, 'D': 2, 'E': 2, 'G': 4, 'I': 2, 'K': 4, 'L': 2, 'N': 2, 'O': 2, 'U': 4, 'V': 2, 'W': 2, 'X': 2}"
INV-ZZ-7143529,SCH-ZZ-2404944,ZZ,ZZ20240519PNQGAU4614.0,4614.0,Airbus A320-200,05/19/2024,2024-05-19 23:31:00,2024-05-20 23:12:00,PNQ,GAU,150.0,171,92,-58,79,15,30,45,60,17,9,6,8,34,18,12,16,52,28,17,24,66,36,24,30,"{'F': 9, 'P': 6}","{'C': 12, 'J': 9, 'Z': 9}","{'Q': 14, 'R': 9, 'S': 4, 'T': 4, 'H': 9, 'M': 4}","{'Y': 4, 'A': 4, 'B': 2, 'D': 2, 'E': 2, 'G': 4, 'I': 2, 'K': 4, 'L': 2, 'N': 2, 'O': 2, 'U': 4, 'V': 2, 'W': 2, 'X': 2}"
INV-ZZ-6059833,SCH-ZZ-1646787,ZZ,ZZ20240415GOIPNQ4429.0,4429.0,BAe 146,04/15/2024,2024-04-15 22:10:00,2024-04-16 08:41:00,GOI,PNQ,91.0,100,56,-35,44,9,18,27,36,10,6,3,4,21,12,6,9,32,18,9,14,41,23,13,18,"{'F': 5, 'P': 4}","{'C': 7, 'J': 5, 'Z': 5}","{'Q': 8, 'R': 5, 'S': 3, 'T': 3, 'H': 5, 'M': 3}","{'Y': 3, 'A': 3, 'B': 1, 'D': 1, 'E': 1, 'G': 3, 'I': 1, 'K': 3, 'L': 1, 'N': 1, 'O': 1, 'U': 3, 'V': 1, 'W': 1, 'X': 1}"
INV-ZZ-2930774,SCH-ZZ-1646787,ZZ,ZZ20240417GOIPNQ4429.0,4429.0,BAe 146,04/17/2024,2024-04-17 22:10:00,2024-04-18 08:41:00,GOI,PNQ,91.0,104,66,-25,38,9,18,27,36,10,6,3,4,20,13,5,7,31,20,7,11,40,25,11,15,"{'F': 5, 'P': 4}","{'C': 7, 'J': 5, 'Z': 5}","{'Q': 8, 'R': 5, 'S': 3, 'T': 3, 'H': 5, 'M': 3}","{'Y': 3, 'A': 3, 'B': 1, 'D': 1, 'E': 1, 'G': 3, 'I': 1, 'K': 3, 'L': 1, 'N': 1, 'O': 1, 'U': 3, 'V': 1, 'W': 1, 'X': 1}"
INV-ZZ-5703925,SCH-ZZ-1646787,ZZ,ZZ20240420GOIPNQ4429.0,4429.0,BAe 146,04/20/2024,2024-04-20 22:10:00,2024-04-21 08:41:00,GOI,PNQ,91.0,106,63,-28,43,9,18,27,36,10,6,3,4,20,12,6,8,32,19,8,13,41,24,12,17,"{'F': 5, 'P': 4}","{'C': 7, 'J': 5, 'Z': 5}","{'Q': 8, 'R': 5, 'S': 3, 'T': 3, 'H': 5, 'M': 3}","{'Y': 3, 'A': 3, 'B': 1, 'D': 1, 'E': 1, 'G': 3, 'I': 1, 'K': 3, 'L': 1, 'N': 1, 'O': 1, 'U': 3, 'V': 1, 'W': 1, 'X': 1}"
INV-ZZ-9637739,SCH-ZZ-1646787,ZZ,ZZ20240422GOIPNQ4429.0,4429.0,BAe 146,04/22/2024,2024-04-22 22:10:00,2024-04-23 08:41:00,GOI,PNQ,91.0,101,59,-32,42,9,18,27,36,10,6,3,4,20,12,6,8,32,19,8,13,43,25,11,18,"{'F': 5, 'P': 4}","{'C': 7, 'J': 5, 'Z': 5}","{'Q': 8, 'R': 5, 'S': 3, 'T': 3, 'H': 5, 'M': 3}","{'Y': 3, 'A': 3, 'B': 1, 'D': 1, 'E': 1, 'G': 3, 'I': 1, 'K': 3, 'L': 1, 'N': 1, 'O': 1, 'U': 3, 'V': 1, 'W': 1, 'X': 1}"
INV-ZZ-3549670,SCH-ZZ-1646787,ZZ,ZZ20240424GOIPNQ4429.0,4429.0,BAe 146,04/24/2024,2024-04-24 22:10:00,2024-04-25 08:41:00,GOI,PNQ,91.0,104,59,-32,45,9,18,27,36,10,6,3,4,20,11,7,9,30,17,10,13,41,23,13,18,"{'F': 5, 'P': 4}","{'C': 7, 'J': 5, 'Z': 5}","{'Q': 8, 'R': 5, 'S': 3, 'T': 3, 'H': 5, 'M': 3}","{'Y': 3, 'A': 3, 'B': 1, 'D': 1, 'E': 1, 'G': 3, 'I': 1, 'K': 3, 'L': 1, 'N': 1, 'O': 1, 'U': 3, 'V': 1, 'W': 1, 'X': 1}"
INV-ZZ-4940563,SCH-ZZ-1646787,ZZ,ZZ20240427GOIPNQ4429.0,4429.0,BAe 146,04/27/2024,2024-04-27 22:10:00,2024-04-28 08:41:00,GOI,PNQ,91.0,106,62,-29,44,9,18,27,36,10,6,3,4,20,12,6,8,30,18,9,12,40,23,13,17,"{'F': 5, 'P': 4}","{'C': 7, 'J': 5, 'Z': 5}","{'Q': 8, 'R': 5, 'S': 3, 'T': 3, 'H': 5, 'M': 3}","{'Y': 3, 'A': 3, 'B': 1, 'D': 1, 'E': 1, 'G': 3, 'I': 1, 'K': 3, 'L': 1, 'N': 1, 'O': 1, 'U': 3, 'V': 1, 'W': 1, 'X': 1}"
INV-ZZ-7840434,SCH-ZZ-1646787,ZZ,ZZ20240429GOIPNQ4429.0,4429.0,BAe 146,04/29/2024,2024-04-29 22:10:00,2024-04-30 08:41:00,GOI,PNQ,91.0,102,58,-33,44,9,18,27,36,10,6,3,4,21,12,6,9,31,18,9,13,41,23,13,18,"{'F': 5, 'P': 4}","{'C': 7, 'J': 5, 'Z': 5}","{'Q': 8, 'R': 5, 'S': 3, 'T': 3, 'H': 5, 'M': 3}","{'Y': 3, 'A': 3, 'B': 1, 'D': 1, 'E': 1, 'G': 3, 'I': 1, 'K': 3, 'L': 1, 'N': 1, 'O': 1, 'U': 3, 'V': 1, 'W': 1, 'X': 1}"
INV-ZZ-1561326,SCH-ZZ-1646787,ZZ,ZZ20240501GOIPNQ4429.0,4429.0,BAe 146,05/01/2024,2024-05-01 22:10:00,2024-05-02 08:41:00,GOI,PNQ,91.0,103,56,-35,47,9,18,27,36,11,6,3,5,20,11,7,9,32,17,10,15,42,23,13,19,"{'F': 5, 'P': 4}","{'C': 7, 'J': 5, 'Z': 5}","{'Q': 8, 'R': 5, 'S': 3, 'T': 3, 'H': 5, 'M': 3}","{'Y': 3, 'A': 3, 'B': 1, 'D': 1, 'E': 1, 'G': 3, 'I': 1, 'K': 3, 'L': 1, 'N': 1, 'O': 1, 'U': 3, 'V': 1, 'W': 1, 'X': 1}"
INV-ZZ-8590961,SCH-ZZ-1646787,ZZ,ZZ20240504GOIPNQ4429.0,4429.0,BAe 146,05/04/2024,2024-05-04 22:10:00,2024-05-05 08:41:00,GOI,PNQ,91.0,106,62,-29,44,9,18,27,36,11,6,3,5,20,12,6,8,32,19,8,13,41,24,12,17,"{'F': 5, 'P': 4}","{'C': 7, 'J': 5, 'Z': 5}","{'Q': 8, 'R': 5, 'S': 3, 'T': 3, 'H': 5, 'M': 3}","{'Y': 3, 'A': 3, 'B': 1, 'D': 1, 'E': 1, 'G': 3, 'I': 1, 'K': 3, 'L': 1, 'N': 1, 'O': 1, 'U': 3, 'V': 1, 'W': 1, 'X': 1}"
INV-ZZ-6309912,SCH-ZZ-1646787,ZZ,ZZ20240506GOIPNQ4429.0,4429.0,BAe 146,05/06/2024,2024-05-06 22:10:00,2024-05-07 08:41:00,GOI,PNQ,91.0,108,55,-36,53,9,18,27,36,10,5,4,5,21,11,7,10,30,15,12,15,42,21,15,21,"{'F': 5, 'P': 4}","{'C': 7, 'J': 5, 'Z': 5}","{'Q': 8, 'R': 5, 'S': 3, 'T': 3, 'H': 5, 'M': 3}","{'Y': 3, 'A': 3, 'B': 1, 'D': 1, 'E': 1, 'G': 3, 'I': 1, 'K': 3, 'L': 1, 'N': 1, 'O': 1, 'U': 3, 'V': 1, 'W': 1, 'X': 1}"
INV-ZZ-7871715,SCH-ZZ-1646787,ZZ,ZZ20240508GOIPNQ4429.0,4429.0,BAe 146,05/08/2024,2024-05-08 22:10:00,2024-05-09 08:41:00,GOI,PNQ,91.0,107,56,-35,51,9,18,27,36,10,5,4,5,21,11,7,10,30,16,11,14,41,21,15,20,"{'F': 5, 'P': 4}","{'C': 7, 'J': 5, 'Z': 5}","{'Q': 8, 'R': 5, 'S': 3, 'T': 3, 'H': 5, 'M': 3}","{'Y': 3, 'A': 3, 'B': 1, 'D': 1, 'E': 1, 'G': 3, 'I': 1, 'K': 3, 'L': 1, 'N': 1, 'O': 1, 'U': 3, 'V': 1, 'W': 1, 'X': 1}"
INV-ZZ-5801187,SCH-ZZ-1646787,ZZ,ZZ20240511GOIPNQ4429.0,4429.0,BAe 146,05/11/2024,2024-05-11 22:10:00,2024-05-12 08:41:00,GOI,PNQ,91.0,106,56,-35,50,9,18,27,36,11,6,3,5,20,10,8,10,32,17,10,15,40,21,15,19,"{'F': 5, 'P': 4}","{'C': 7, 'J': 5, 'Z': 5}","{'Q': 8, 'R': 5, 'S': 3, 'T': 3, 'H': 5, 'M': 3}","{'Y': 3, 'A': 3, 'B': 1, 'D': 1, 'E': 1, 'G': 3, 'I': 1, 'K': 3, 'L': 1, 'N': 1, 'O': 1, 'U': 3, 'V': 1, 'W': 1, 'X': 1}"
INV-ZZ-6128224,SCH-ZZ-1646787,ZZ,ZZ20240513GOIPNQ4429.0,4429.0,BAe 146,05/13/2024,2024-05-13 22:10:00,2024-05-14 08:41:00,GOI,PNQ,91.0,104,55,-36,49,9,18,27,36,10,5,4,5,20,11,7,9,32,17,10,15,40,21,15,19,"{'F': 5, 'P': 4}","{'C': 7, 'J': 5, 'Z': 5}","{'Q': 8, 'R': 5, 'S': 3, 'T': 3, 'H': 5, 'M': 3}","{'Y': 3, 'A': 3, 'B': 1, 'D': 1, 'E': 1, 'G': 3, 'I': 1, 'K': 3, 'L': 1, 'N': 1, 'O': 1, 'U': 3, 'V': 1, 'W': 1, 'X': 1}"
INV-ZZ-6981065,SCH-ZZ-1646787,ZZ,ZZ20240515GOIPNQ4429.0,4429.0,BAe 146,05/15/2024,2024-05-15 22:10:00,2024-05-16 08:41:00,GOI,PNQ,91.0,105,57,-34,48,9,18,27,36,10,5,4,5,21,11,7,10,32,17,10,15,40,22,14,18,"{'F': 5, 'P': 4}","{'C': 7, 'J': 5, 'Z': 5}","{'Q': 8, 'R': 5, 'S': 3, 'T': 3, 'H': 5, 'M': 3}","{'Y': 3, 'A': 3, 'B': 1, 'D': 1, 'E': 1, 'G': 3, 'I': 1, 'K': 3, 'L': 1, 'N': 1, 'O': 1, 'U': 3, 'V': 1, 'W': 1, 'X': 1}"
INV-ZZ-9162624,SCH-ZZ-1646787,ZZ,ZZ20240518GOIPNQ4429.0,4429.0,BAe 146,05/18/2024,2024-05-18 22:10:00,2024-05-19 08:41:00,GOI,PNQ,91.0,108,56,-35,52,9,18,27,36,10,5,4,5,20,10,8,10,32,17,10,15,43,22,14,21,"{'F': 5, 'P': 4}","{'C': 7, 'J': 5, 'Z': 5}","{'Q': 8, 'R': 5, 'S': 3, 'T': 3, 'H': 5, 'M': 3}","{'Y': 3, 'A': 3, 'B': 1, 'D': 1, 'E': 1, 'G': 3, 'I': 1, 'K': 3, 'L': 1, 'N': 1, 'O': 1, 'U': 3, 'V': 1, 'W': 1, 'X': 1}"
INV-ZZ-6823401,SCH-ZZ-1646787,ZZ,ZZ20240520GOIPNQ4429.0,4429.0,BAe 146,05/20/2024,2024-05-20 22:10:00,2024-05-21 08:41:00,GOI,PNQ,91.0,102,48,-43,54,9,18,27,36,10,5,4,5,21,10,8,11,31,15,12,16,41,19,17,22,"{'F': 5, 'P': 4}","{'C': 7, 'J': 5, 'Z': 5}","{'Q': 8, 'R': 5, 'S': 3, 'T': 3, 'H': 5, 'M': 3}","{'Y': 3, 'A': 3, 'B': 1, 'D': 1, 'E': 1, 'G': 3, 'I': 1, 'K': 3, 'L': 1, 'N': 1, 'O': 1, 'U': 3, 'V': 1, 'W': 1, 'X': 1}"
INV-ZZ-8541024,SCH-ZZ-1646787,ZZ,ZZ20240522GOIPNQ4429.0,4429.0,BAe 146,05/22/2024,2024-05-22 22:10:00,2024-05-23 08:41:00,GOI,PNQ,91.0,103,53,-38,50,9,18,27,36,10,5,4,5,21,11,7,10,31,16,11,15,40,20,16,20,"{'F': 5, 'P': 4}","{'C': 7, 'J': 5, 'Z': 5}","{'Q': 8, 'R': 5, 'S': 3, 'T': 3, 'H': 5, 'M': 3}","{'Y': 3, 'A': 3, 'B': 1, 'D': 1, 'E': 1, 'G': 3, 'I': 1, 'K': 3, 'L': 1, 'N': 1, 'O': 1, 'U': 3, 'V': 1, 'W': 1, 'X': 1}"
INV-ZZ-8953044,SCH-ZZ-1646787,ZZ,ZZ20240525GOIPNQ4429.0,4429.0,BAe 146,05/25/2024,2024-05-25 22:10:00,2024-05-26 08:41:00,GOI,PNQ,91.0,108,56,-35,52,9,18,27,36,10,5,4,5,21,11,7,10,30,16,11,14,42,22,14,20,"{'F': 5, 'P': 4}","{'C': 7, 'J': 5, 'Z': 5}","{'Q': 8, 'R': 5, 'S': 3, 'T': 3, 'H': 5, 'M': 3}","{'Y': 3, 'A': 3, 'B': 1, 'D': 1, 'E': 1, 'G': 3, 'I': 1, 'K': 3, 'L': 1, 'N': 1, 'O': 1, 'U': 3, 'V': 1, 'W': 1, 'X': 1}"
INV-ZZ-5658647,SCH-ZZ-1646787,ZZ,ZZ20240527GOIPNQ4429.0,4429.0,BAe 146,05/27/2024,2024-05-27 22:10:00,2024-05-28 08:41:00,GOI,PNQ,91.0,101,53,-38,48,9,18,27,36,10,5,4,5,20,10,8,10,31,16,11,15,41,21,15,20,"{'F': 5, 'P': 4}","{'C': 7, 'J': 5, 'Z': 5}","{'Q': 8, 'R': 5, 'S': 3, 'T': 3, 'H': 5, 'M': 3}","{'Y': 3, 'A': 3, 'B': 1, 'D': 1, 'E': 1, 'G': 3, 'I': 1, 'K': 3, 'L': 1, 'N': 1, 'O': 1, 'U': 3, 'V': 1, 'W': 1, 'X': 1}"
INV-ZZ-2909000,SCH-ZZ-1646787,ZZ,ZZ20240529GOIPNQ4429.0,4429.0,BAe 146,05/29/2024,2024-05-29 22:10:00,2024-05-30 08:41:00,GOI,PNQ,91.0,107,51,-40,56,9,18,27,36,10,5,4,5,21,10,8,11,31,15,12,16,42,20,16,22,"{'F': 5, 'P': 4}","{'C': 7, 'J': 5, 'Z': 5}","{'Q': 8, 'R': 5, 'S': 3, 'T': 3, 'H': 5, 'M': 3}","{'Y': 3, 'A': 3, 'B': 1, 'D': 1, 'E': 1, 'G': 3, 'I': 1, 'K': 3, 'L': 1, 'N': 1, 'O': 1, 'U': 3, 'V': 1, 'W': 1, 'X': 1}"
INV-ZZ-8954983,SCH-ZZ-8782078,ZZ,ZZ20240424PNQGOI2738.0,2738.0,Boeing 777,04/24/2024,2024-04-24 05:09:00,2024-04-24 17:37:00,PNQ,GOI,425.0,491,272,-153,219,42,85,127,170,48,27,15,21,94,52,33,42,141,78,49,63,199,110,60,89,"{'F': 25, 'P': 17}","{'C': 34, 'J': 26, 'Z': 26}","{'Q': 38, 'R': 25, 'S': 13, 'T': 13, 'H': 25, 'M': 13}","{'Y': 13, 'A': 13, 'B': 6, 'D': 6, 'E': 6, 'G': 13, 'I': 6, 'K': 13, 'L': 6, 'N': 6, 'O': 6, 'U': 13, 'V': 6, 'W': 6, 'X': 6}"
INV-ZZ-7994304,SCH-ZZ-8782078,ZZ,ZZ20240429PNQGOI2738.0,2738.0,Boeing 777,04/29/2024,2024-04-29 05:09:00,2024-04-29 17:37:00,PNQ,GOI,425.0,480,290,-135,190,42,85,127,170,48,29,13,19,97,59,26,38,151,91,36,60,200,121,49,79,"{'F': 25, 'P': 17}","{'C': 34, 'J': 26, 'Z': 26}","{'Q': 38, 'R': 25, 'S': 13, 'T': 13, 'H': 25, 'M': 13}","{'Y': 13, 'A': 13, 'B': 6, 'D': 6, 'E': 6, 'G': 13, 'I': 6, 'K': 13, 'L': 6, 'N': 6, 'O': 6, 'U': 13, 'V': 6, 'W': 6, 'X': 6}"
INV-ZZ-4499968,SCH-ZZ-8782078,ZZ,ZZ20240501PNQGOI2738.0,2738.0,Boeing 777,05/01/2024,2024-05-01 05:09:00,2024-05-01 17:37:00,PNQ,GOI,425.0,473,251,-174,222,42,85,127,170,48,25,17,23,95,50,35,45,142,75,52,67,193,102,68,91,"{'F': 25, 'P': 17}","{'C': 34, 'J': 26, 'Z': 26}","{'Q': 38, 'R': 25, 'S': 13, 'T': 13, 'H': 25, 'M': 13}","{'Y': 13, 'A': 13, 'B': 6, 'D': 6, 'E': 6, 'G': 13, 'I': 6, 'K': 13, 'L': 6, 'N': 6, 'O': 6, 'U': 13, 'V': 6, 'W': 6, 'X': 6}"
INV-ZZ-1240520,SCH-ZZ-8782078,ZZ,ZZ20240506PNQGOI2738.0,2738.0,Boeing 777,05/06/2024,2024-05-06 05:09:00,2024-05-06 17:37:00,PNQ,GOI,425.0,489,253,-172,236,42,85,127,170,50,26,16,24,94,49,36,45,143,74,53,69,203,105,65,98,"{'F': 25, 'P': 17}","{'C': 34, 'J': 26, 'Z': 26}","{'Q': 38, 'R': 25, 'S': 13, 'T': 13, 'H': 25, 'M': 13}","{'Y': 13, 'A': 13, 'B': 6, 'D': 6, 'E': 6, 'G': 13, 'I': 6, 'K': 13, 'L': 6, 'N': 6, 'O': 6, 'U': 13, 'V': 6, 'W': 6, 'X': 6}"
INV-ZZ-8724058,SCH-ZZ-8782078,ZZ,ZZ20240508PNQGOI2738.0,2738.0,Boeing 777,05/08/2024,2024-05-08 05:09:00,2024-05-08 17:37:00,PNQ,GOI,425.0,468,247,-178,221,42,85,127,170,49,26,16,23,99,52,33,47,143,76,51,67,188,99,71,89,"{'F': 25, 'P': 17}","{'C': 34, 'J': 26, 'Z': 26}","{'Q': 38, 'R': 25, 'S': 13, 'T': 13, 'H': 25, 'M': 13}","{'Y': 13, 'A': 13, 'B': 6, 'D': 6, 'E': 6, 'G': 13, 'I': 6, 'K': 13, 'L': 6, 'N': 6, 'O': 6, 'U': 13, 'V': 6, 'W': 6, 'X': 6}"
INV-ZZ-2681240,SCH-ZZ-8782078,ZZ,ZZ20240513PNQGOI2738.0,2738.0,Boeing 777,05/13/2024,2024-05-13 05:09:00,2024-05-13 17:37:00,PNQ,GOI,425.0,501,255,-170,246,42,85,127,170,50,25,17,25,101,51,34,50,145,74,53,71,203,103,67,100,"{'F': 25, 'P': 17}","{'C': 34, 'J': 26, 'Z': 26}","{'Q': 38, 'R': 25, 'S': 13, 'T': 13, 'H': 25, 'M': 13}","{'Y': 13, 'A': 13, 'B': 6, 'D': 6, 'E': 6, 'G': 13, 'I': 6, 'K': 13, 'L': 6, 'N': 6, 'O': 6, 'U': 13, 'V': 6, 'W': 6, 'X': 6}"
INV-ZZ-8456796,SCH-ZZ-8782078,ZZ,ZZ20240515PNQGOI2738.0,2738.0,Boeing 777,05/15/2024,2024-05-15 05:09:00,2024-05-15 17:37:00,PNQ,GOI,425.0,471,247,-178,224,42,85,127,170,48,25,17,23,101,53,32,48,142,74,53,68,187,98,72,89,"{'F': 25, 'P': 17}","{'C': 34, 'J': 26, 'Z': 26}","{'Q': 38, 'R': 25, 'S': 13, 'T': 13, 'H': 25, 'M': 13}","{'Y': 13, 'A': 13, 'B': 6, 'D': 6, 'E': 6, 'G': 13, 'I': 6, 'K': 13, 'L': 6, 'N': 6, 'O': 6, 'U': 13, 'V': 6, 'W': 6, 'X': 6}"
INV-ZZ-3154232,SCH-ZZ-8782078,ZZ,ZZ20240520PNQGOI2738.0,2738.0,Boeing 777,05/20/2024,2024-05-20 05:09:00,2024-05-20 17:37:00,PNQ,GOI,425.0,477,258,-167,219,42,85,127,170,47,25,17,22,96,52,33,44,144,78,49,66,190,103,67,87,"{'F': 25, 'P': 17}","{'C': 34, 'J': 26, 'Z': 26}","{'Q': 38, 'R': 25, 'S': 13, 'T': 13, 'H': 25, 'M': 13}","{'Y': 13, 'A': 13, 'B': 6, 'D': 6, 'E': 6, 'G': 13, 'I': 6, 'K': 13, 'L': 6, 'N': 6, 'O': 6, 'U': 13, 'V': 6, 'W': 6, 'X': 6}"
INV-ZZ-5687667,SCH-ZZ-8782078,ZZ,ZZ20240522PNQGOI2738.0,2738.0,Boeing 777,05/22/2024,2024-05-22 05:09:00,2024-05-22 17:37:00,PNQ,GOI,425.0,476,254,-171,222,42,85,127,170,49,26,16,23,102,55,30,47,148,79,48,69,193,103,67,90,"{'F': 25, 'P': 17}","{'C': 34, 'J': 26, 'Z': 26}","{'Q': 38, 'R': 25, 'S': 13, 'T': 13, 'H': 25, 'M': 13}","{'Y': 13, 'A': 13, 'B': 6, 'D': 6, 'E': 6, 'G': 13, 'I': 6, 'K': 13, 'L': 6, 'N': 6, 'O': 6, 'U': 13, 'V': 6, 'W': 6, 'X': 6}"
INV-ZZ-6737394,SCH-ZZ-8782078,ZZ,ZZ20240527PNQGOI2738.0,2738.0,Boeing 777,05/27/2024,2024-05-27 05:09:00,2024-05-27 17:37:00,PNQ,GOI,425.0,480,244,-181,236,42,85,127,170,48,24,18,24,99,50,35,49,152,77,50,75,195,99,71,96,"{'F': 25, 'P': 17}","{'C': 34, 'J': 26, 'Z': 26}","{'Q': 38, 'R': 25, 'S': 13, 'T': 13, 'H': 25, 'M': 13}","{'Y': 13, 'A': 13, 'B': 6, 'D': 6, 'E': 6, 'G': 13, 'I': 6, 'K': 13, 'L': 6, 'N': 6, 'O': 6, 'U': 13, 'V': 6, 'W': 6, 'X': 6}"
INV-ZZ-5944040,SCH-ZZ-8782078,ZZ,ZZ20240529PNQGOI2738.0,2738.0,Boeing 777,05/29/2024,2024-05-29 05:09:00,2024-05-29 17:37:00,PNQ,GOI,425.0,508,260,-165,248,42,85,127,170,49,25,17,24,94,48,37,46,145,74,53,71,194,99,71,95,"{'F': 25, 'P': 17}","{'C': 34, 'J': 26, 'Z': 26}","{'Q': 38, 'R': 25, 'S': 13, 'T': 13, 'H': 25, 'M': 13}","{'Y': 13, 'A': 13, 'B': 6, 'D': 6, 'E': 6, 'G': 13, 'I': 6, 'K': 13, 'L': 6, 'N': 6, 'O': 6, 'U': 13, 'V': 6, 'W': 6, 'X': 6}"
INV-ZZ-7341693,SCH-ZZ-8782078,ZZ,ZZ20240603PNQGOI2738.0,2738.0,Boeing 777,06/03/2024,2024-06-03 05:09:00,2024-06-03 17:37:00,PNQ,GOI,425.0,480,221,-204,259,42,85,127,170,47,22,20,25,101,46,39,55,150,69,58,81,202,93,77,109,"{'F': 25, 'P': 17}","{'C': 34, 'J': 26, 'Z': 26}","{'Q': 38, 'R': 25, 'S': 13, 'T': 13, 'H': 25, 'M': 13}","{'Y': 13, 'A': 13, 'B': 6, 'D': 6, 'E': 6, 'G': 13, 'I': 6, 'K': 13, 'L': 6, 'N': 6, 'O': 6, 'U': 13, 'V': 6, 'W': 6, 'X': 6}"
INV-ZZ-7137489,SCH-ZZ-8782078,ZZ,ZZ20240605PNQGOI2738.0,2738.0,Boeing 777,06/05/2024,2024-06-05 05:09:00,2024-06-05 17:37:00,PNQ,GOI,425.0,494,221,-204,273,42,85,127,170,47,21,21,26,98,44,41,54,146,65,62,81,195,87,83,108,"{'F': 25, 'P': 17}","{'C': 34, 'J': 26, 'Z': 26}","{'Q': 38, 'R': 25, 'S': 13, 'T': 13, 'H': 25, 'M': 13}","{'Y': 13, 'A': 13, 'B': 6, 'D': 6, 'E': 6, 'G': 13, 'I': 6, 'K': 13, 'L': 6, 'N': 6, 'O': 6, 'U': 13, 'V': 6, 'W': 6, 'X': 6}"
INV-ZZ-8552205,SCH-ZZ-4235611,ZZ,ZZ20240505GOIGAU3294.0,3294.0,Boeing 787,05/05/2024,2024-05-05 10:57:00,2024-05-06 10:08:00,GOI,GAU,270.0,297,161,-109,136,27,54,81,108,32,17,10,15,62,34,20,28,96,52,29,44,125,68,40,57,"{'F': 16, 'P': 11}","{'C': 22, 'J': 16, 'Z': 16}","{'Q': 24, 'R': 16, 'S': 8, 'T': 8, 'H': 16, 'M': 8}","{'Y': 8, 'A': 8, 'B': 4, 'D': 4, 'E': 4, 'G': 8, 'I': 4, 'K': 8, 'L': 4, 'N': 4, 'O': 4, 'U': 8, 'V': 4, 'W': 4, 'X': 4}"
INV-ZZ-4943627,SCH-ZZ-4235611,ZZ,ZZ20240506GOIGAU3294.0,3294.0,Boeing 787,05/06/2024,2024-05-06 10:57:00,2024-05-07 10:08:00,GOI,GAU,270.0,320,168,-102,152,27,54,81,108,30,16,11,14,62,33,21,29,90,47,34,43,123,65,43,58,"{'F': 16, 'P': 11}","{'C': 22, 'J': 16, 'Z': 16}","{'Q': 24, 'R': 16, 'S': 8, 'T': 8, 'H': 16, 'M': 8}","{'Y': 8, 'A': 8, 'B': 4, 'D': 4, 'E': 4, 'G': 8, 'I': 4, 'K': 8, 'L': 4, 'N': 4, 'O': 4, 'U': 8, 'V': 4, 'W': 4, 'X': 4}"
INV-ZZ-3017175,SCH-ZZ-4235611,ZZ,ZZ20240512GOIGAU3294.0,3294.0,Boeing 787,05/12/2024,2024-05-12 10:57:00,2024-05-13 10:08:00,GOI,GAU,270.0,310,163,-107,147,27,54,81,108,31,16,11,15,60,32,22,28,92,48,33,44,123,65,43,58,"{'F': 16, 'P': 11}","{'C': 22, 'J': 16, 'Z': 16}","{'Q': 24, 'R': 16, 'S': 8, 'T': 8, 'H': 16, 'M': 8}","{'Y': 8, 'A': 8, 'B': 4, 'D': 4, 'E': 4, 'G': 8, 'I': 4, 'K': 8, 'L': 4, 'N': 4, 'O': 4, 'U': 8, 'V': 4, 'W': 4, 'X': 4}"
INV-ZZ-6122409,SCH-ZZ-4235611,ZZ,ZZ20240513GOIGAU3294.0,3294.0,Boeing 787,05/13/2024,2024-05-13 10:57:00,2024-05-14 10:08:00,GOI,GAU,270.0,305,157,-113,148,27,54,81,108,31,16,11,15,63,32,22,31,94,48,33,46,128,66,42,62,"{'F': 16, 'P': 11}","{'C': 22, 'J': 16, 'Z': 16}","{'Q': 24, 'R': 16, 'S': 8, 'T': 8, 'H': 16, 'M': 8}","{'Y': 8, 'A': 8, 'B': 4, 'D': 4, 'E': 4, 'G': 8, 'I': 4, 'K': 8, 'L': 4, 'N': 4, 'O': 4, 'U': 8, 'V': 4, 'W': 4, 'X': 4}"
INV-ZZ-6195411,SCH-ZZ-4235611,ZZ,ZZ20240519GOIGAU3294.0,3294.0,Boeing 787,05/19/2024,2024-05-19 10:57:00,2024-05-20 10:08:00,GOI,GAU,270.0,310,157,-113,153,27,54,81,108,32,16,11,16,62,31,23,31,92,47,34,45,125,63,45,62,"{'F': 16, 'P': 11}","{'C': 22, 'J': 16, 'Z': 16}","{'Q': 24, 'R': 16, 'S': 8, 'T': 8, 'H': 16, 'M': 8}","{'Y': 8, 'A': 8, 'B': 4, 'D': 4, 'E': 4, 'G': 8, 'I': 4, 'K': 8, 'L': 4, 'N': 4, 'O': 4, 'U': 8, 'V': 4, 'W': 4, 'X': 4}"
INV-ZZ-1885845,SCH-ZZ-4235611,ZZ,ZZ20240520GOIGAU3294.0,3294.0,Boeing 787,05/20/2024,2024-05-20 10:57:00,2024-05-21 10:08:00,GOI,GAU,270.0,323,172,-98,151,27,54,81,108,30,16,11,14,60,32,22,28,89,47,34,42,120,64,44,56,"{'F': 16, 'P': 11}","{'C': 22, 'J': 16, 'Z': 16}","{'Q': 24, 'R': 16, 'S': 8, 'T': 8, 'H': 16, 'M': 8}","{'Y': 8, 'A': 8, 'B': 4, 'D': 4, 'E': 4, 'G': 8, 'I': 4, 'K': 8, 'L': 4, 'N': 4, 'O': 4, 'U': 8, 'V': 4, 'W': 4, 'X': 4}"
INV-ZZ-8993532,SCH-ZZ-4235611,ZZ,ZZ20240526GOIGAU3294.0,3294.0,Boeing 787,05/26/2024,2024-05-26 10:57:00,2024-05-27 10:08:00,GOI,GAU,270.0,304,154,-116,150,27,54,81,108,30,15,12,15,63,32,22,31,93,47,34,46,123,62,46,61,"{'F': 16, 'P': 11}","{'C': 22, 'J': 16, 'Z': 16}","{'Q': 24, 'R': 16, 'S': 8, 'T': 8, 'H': 16, 'M': 8}","{'Y': 8, 'A': 8, 'B': 4, 'D': 4, 'E': 4, 'G': 8, 'I': 4, 'K': 8, 'L': 4, 'N': 4, 'O': 4, 'U': 8, 'V': 4, 'W': 4, 'X': 4}"
INV-ZZ-5481055,SCH-ZZ-4235611,ZZ,ZZ20240527GOIGAU3294.0,3294.0,Boeing 787,05/27/2024,2024-05-27 10:57:00,2024-05-28 10:08:00,GOI,GAU,270.0,305,157,-113,148,27,54,81,108,30,15,12,15,65,33,21,32,97,50,31,47,121,62,46,59,"{'F': 16, 'P': 11}","{'C': 22, 'J': 16, 'Z': 16}","{'Q': 24, 'R': 16, 'S': 8, 'T': 8, 'H': 16, 'M': 8}","{'Y': 8, 'A': 8, 'B': 4, 'D': 4, 'E': 4, 'G': 8, 'I': 4, 'K': 8, 'L': 4, 'N': 4, 'O': 4, 'U': 8, 'V': 4, 'W': 4, 'X': 4}"
INV-ZZ-4322086,SCH-ZZ-4235611,ZZ,ZZ20240602GOIGAU3294.0,3294.0,Boeing 787,06/02/2024,2024-06-02 10:57:00,2024-06-03 10:08:00,GOI,GAU,270.0,308,159,-111,149,27,54,81,108,31,16,11,15,61,31,23,30,94,48,33,46,130,67,41,63,"{'F': 16, 'P': 11}","{'C': 22, 'J': 16, 'Z': 16}","{'Q': 24, 'R': 16, 'S': 8, 'T': 8, 'H': 16, 'M': 8}","{'Y': 8, 'A': 8, 'B': 4, 'D': 4, 'E': 4, 'G': 8, 'I': 4, 'K': 8, 'L': 4, 'N': 4, 'O': 4, 'U': 8, 'V': 4, 'W': 4, 'X': 4}"
INV-ZZ-3519159,SCH-ZZ-4235611,ZZ,ZZ20240603GOIGAU3294.0,3294.0,Boeing 787,06/03/2024,2024-06-03 10:57:00,2024-06-04 10:08:00,GOI,GAU,270.0,302,136,-134,166,27,54,81,108,32,14,13,18,62,28,26,34,94,42,39,52,128,58,50,70,"{'F': 16, 'P': 11}","{'C': 22, 'J': 16, 'Z': 16}","{'Q': 24, 'R': 16, 'S': 8, 'T': 8, 'H': 16, 'M': 8}","{'Y': 8, 'A': 8, 'B': 4, 'D': 4, 'E': 4, 'G': 8, 'I': 4, 'K': 8, 'L': 4, 'N': 4, 'O': 4, 'U': 8, 'V': 4, 'W': 4, 'X': 4}"
INV-ZZ-5796157,SCH-ZZ-4235611,ZZ,ZZ20240609GOIGAU3294.0,3294.0,Boeing 787,06/09/2024,2024-06-09 10:57:00,2024-06-10 10:08:00,GOI,GAU,270.0,304,136,-134,168,27,54,81,108,32,14,13,18,61,27,27,34,91,41,40,50,121,54,54,67,"{'F': 16, 'P': 11}","{'C': 22, 'J': 16, 'Z': 16}","{'Q': 24, 'R': 16, 'S': 8, 'T': 8, 'H': 16, 'M': 8}","{'Y': 8, 'A': 8, 'B': 4, 'D': 4, 'E': 4, 'G': 8, 'I': 4, 'K': 8, 'L': 4, 'N': 4, 'O': 4, 'U': 8, 'V': 4, 'W': 4, 'X': 4}"
INV-ZZ-6315434,SCH-ZZ-4235611,ZZ,ZZ20240610GOIGAU3294.0,3294.0,Boeing 787,06/10/2024,2024-06-10 10:57:00,2024-06-11 10:08:00,GOI,GAU,270.0,323,159,-111,164,27,54,81,108,30,15,12,15,64,31,23,33,96,47,34,49,124,61,47,63,"{'F': 16, 'P': 11}","{'C': 22, 'J': 16, 'Z': 16}","{'Q': 24, 'R': 16, 'S': 8, 'T': 8, 'H': 16, 'M': 8}","{'Y': 8, 'A': 8, 'B': 4, 'D': 4, 'E': 4, 'G': 8, 'I': 4, 'K': 8, 'L': 4, 'N': 4, 'O': 4, 'U': 8, 'V': 4, 'W': 4, 'X': 4}"
INV-ZZ-7037167,SCH-ZZ-4235611,ZZ,ZZ20240616GOIGAU3294.0,3294.0,Boeing 787,06/16/2024,2024-06-16 10:57:00,2024-06-17 10:08:00,GOI,GAU,270.0,311,129,-141,182,27,54,81,108,31,13,14,18,64,27,27,37,96,40,41,56,119,49,59,70,"{'F': 16, 'P': 11}","{'C': 22, 'J': 16, 'Z': 16}","{'Q': 24, 'R': 16, 'S': 8, 'T': 8, 'H': 16, 'M': 8}","{'Y': 8, 'A': 8, 'B': 4, 'D': 4, 'E': 4, 'G': 8, 'I': 4, 'K': 8, 'L': 4, 'N': 4, 'O': 4, 'U': 8, 'V': 4, 'W': 4, 'X': 4}"
INV-ZZ-2046846,SCH-ZZ-4235611,ZZ,ZZ20240617GOIGAU3294.0,3294.0,Boeing 787,06/17/2024,2024-06-17 10:57:00,2024-06-18 10:08:00,GOI,GAU,270.0,323,139,-131,184,27,54,81,108,30,13,14,17,63,27,27,36,96,41,40,55,119,51,57,68,"{'F': 16, 'P': 11}","{'C': 22, 'J': 16, 'Z': 16}","{'Q': 24, 'R': 16, 'S': 8, 'T': 8, 'H': 16, 'M': 8}","{'Y': 8, 'A': 8, 'B': 4, 'D': 4, 'E': 4, 'G': 8, 'I': 4, 'K': 8, 'L': 4, 'N': 4, 'O': 4, 'U': 8, 'V': 4, 'W': 4, 'X': 4}"
INV-ZZ-3110370,SCH-ZZ-9059901,ZZ,ZZ20240426GOIGAU2919.0,2919.0,Boeing 717,04/26/2024,2024-04-26 19:19:00,2024-04-27 18:01:00,GOI,GAU,100.0,117,65,-35,52,10,20,30,40,12,7,3,5,23,13,7,10,35,19,11,16,46,26,14,20,"{'F': 6, 'P': 4}","{'C': 8, 'J': 6, 'Z': 6}","{'Q': 9, 'R': 6, 'S': 3, 'T': 3, 'H': 6, 'M': 3}","{'Y': 3, 'A': 3, 'B': 2, 'D': 2, 'E': 2, 'G': 3, 'I': 2, 'K': 3, 'L': 2, 'N': 2, 'O': 2, 'U': 3, 'V': 2, 'W': 2, 'X': 2}"
INV-ZZ-6934477,SCH-ZZ-9059901,ZZ,ZZ20240427GOIGAU2919.0,2919.0,Boeing 717,04/27/2024,2024-04-27 19:19:00,2024-04-28 18:01:00,GOI,GAU,100.0,111,61,-39,50,10,20,30,40,12,7,3,5,23,13,7,10,35,19,11,16,44,24,16,20,"{'F': 6, 'P': 4}","{'C': 8, 'J': 6, 'Z': 6}","{'Q': 9, 'R': 6, 'S': 3, 'T': 3, 'H': 6, 'M': 3}","{'Y': 3, 'A': 3, 'B': 2, 'D': 2, 'E': 2, 'G': 3, 'I': 2, 'K': 3, 'L': 2, 'N': 2, 'O': 2, 'U': 3, 'V': 2, 'W': 2, 'X': 2}"
INV-ZZ-3869664,SCH-ZZ-9059901,ZZ,ZZ20240428GOIGAU2919.0,2919.0,Boeing 717,04/28/2024,2024-04-28 19:19:00,2024-04-29 18:01:00,GOI,GAU,100.0,115,60,-40,55,10,20,30,40,11,6,4,5,22,12,8,10,33,17,13,16,44,23,17,21,"{'F': 6, 'P': 4}","{'C': 8, 'J': 6, 'Z': 6}","{'Q': 9, 'R': 6, 'S': 3, 'T': 3, 'H': 6, 'M': 3}","{'Y': 3, 'A': 3, 'B': 2, 'D': 2, 'E': 2, 'G': 3, 'I': 2, 'K': 3, 'L': 2, 'N': 2, 'O': 2, 'U': 3, 'V': 2, 'W': 2, 'X': 2}"
INV-ZZ-8756686,SCH-ZZ-9059901,ZZ,ZZ20240501GOIGAU2919.0,2919.0,Boeing 717,05/01/2024,2024-05-01 19:19:00,2024-05-02 18:01:00,GOI,GAU,100.0,115,64,-36,51,10,20,30,40,11,6,4,5,23,13,7,10,34,19,11,15,44,24,16,20,"{'F': 6, 'P': 4}","{'C': 8, 'J': 6, 'Z': 6}","{'Q': 9, 'R': 6, 'S': 3, 'T': 3, 'H': 6, 'M': 3}","{'Y': 3, 'A': 3, 'B': 2, 'D': 2, 'E': 2, 'G': 3, 'I': 2, 'K': 3, 'L': 2, 'N': 2, 'O': 2, 'U': 3, 'V': 2, 'W': 2, 'X': 2}"
INV-ZZ-6038866,SCH-ZZ-9059901,ZZ,ZZ20240503GOIGAU2919.0,2919.0,Boeing 717,05/03/2024,2024-05-03 19:19:00,2024-05-04 18:01:00,GOI,GAU,100.0,113,66,-34,47,10,20,30,40,11,6,4,5,23,13,7,10,35,20,10,15,48,28,12,20,"{'F': 6, 'P': 4}","{'C': 8, 'J': 6, 'Z': 6}","{'Q': 9, 'R': 6, 'S': 3, 'T': 3, 'H': 6, 'M': 3}","{'Y': 3, 'A': 3, 'B': 2, 'D': 2, 'E': 2, 'G': 3, 'I': 2, 'K': 3, 'L': 2, 'N': 2, 'O': 2, 'U': 3, 'V': 2, 'W': 2, 'X': 2}"
INV-ZZ-6260617,SCH-ZZ-9059901,ZZ,ZZ20240504GOIGAU2919.0,2919.0,Boeing 717,05/04/2024,2024-05-04 19:19:00,2024-05-05 18:01:00,GOI,GAU,100.0,119,62,-38,57,10,20,30,40,12,6,4,6,23,12,8,11,33,17,13,16,48,25,15,23,"{'F': 6, 'P': 4}","{'C': 8, 'J': 6, 'Z': 6}","{'Q': 9, 'R': 6, 'S': 3, 'T': 3, 'H': 6, 'M': 3}","{'Y': 3, 'A': 3, 'B': 2, 'D': 2, 'E': 2, 'G': 3, 'I': 2, 'K': 3, 'L': 2, 'N': 2, 'O': 2, 'U': 3, 'V': 2, 'W': 2, 'X': 2}"
INV-ZZ-1445105,SCH-ZZ-9059901,ZZ,ZZ20240505GOIGAU2919.0,2919.0,Boeing 717,05/05/2024,2024-05-05 19:19:00,2024-05-06 18:01:00,GOI,GAU,100.0,114,64,-36,50,10,20,30,40,11,6,4,5,23,13,7,10,35,20,10,15,47,27,13,20,"{'F': 6, 'P': 4}","{'C': 8, 'J': 6, 'Z': 6}","{'Q': 9, 'R': 6, 'S': 3, 'T': 3, 'H': 6, 'M': 3}","{'Y': 3, 'A': 3, 'B': 2, 'D': 2, 'E': 2, 'G': 3, 'I': 2, 'K': 3, 'L': 2, 'N': 2, 'O': 2, 'U': 3, 'V': 2, 'W': 2, 'X': 2}"
INV-ZZ-1616120,SCH-ZZ-9059901,ZZ,ZZ20240508GOIGAU2919.0,2919.0,Boeing 717,05/08/2024,2024-05-08 19:19:00,2024-05-09 18:01:00,GOI,GAU,100.0,110,63,-37,47,10,20,30,40,12,7,3,5,23,13,7,10,33,19,11,14,46,26,14,20,"{'F': 6, 'P': 4}","{'C': 8, 'J': 6, 'Z': 6}","{'Q': 9, 'R': 6, 'S': 3, 'T': 3, 'H': 6, 'M': 3}","{'Y': 3, 'A': 3, 'B': 2, 'D': 2, 'E': 2, 'G': 3, 'I': 2, 'K': 3, 'L': 2, 'N': 2, 'O': 2, 'U': 3, 'V': 2, 'W': 2, 'X': 2}"
INV-ZZ-4351559,SCH-ZZ-9059901,ZZ,ZZ20240510GOIGAU2919.0,2919.0,Boeing 717,05/10/2024,2024-05-10 19:19:00,2024-05-11 18:01:00,GOI,GAU,100.0,115,63,-37,52,10,20,30,40,12,7,3,5,24,13,7,11,35,19,11,16,45,25,15,20,"{'F': 6, 'P': 4}","{'C': 8, 'J': 6, 'Z': 6}","{'Q': 9, 'R': 6, 'S': 3, 'T': 3, 'H': 6, 'M': 3}","{'Y': 3, 'A': 3, 'B': 2, 'D': 2, 'E': 2, 'G': 3, 'I': 2, 'K': 3, 'L': 2, 'N': 2, 'O': 2, 'U': 3, 'V': 2, 'W': 2, 'X': 2}"
INV-ZZ-3690139,SCH-ZZ-9059901,ZZ,ZZ20240511GOIGAU2919.0,2919.0,Boeing 717,05/11/2024,2024-05-11 19:19:00,2024-05-12 18:01:00,GOI,GAU,100.0,110,63,-37,47,10,20,30,40,11,6,4,5,22,13,7,9,35,20,10,15,47,27,13,20,"{'F': 6, 'P': 4}","{'C': 8, 'J': 6, 'Z': 6}","{'Q': 9, 'R': 6, 'S': 3, 'T': 3, 'H': 6, 'M': 3}","{'Y': 3, 'A': 3, 'B': 2, 'D': 2, 'E': 2, 'G': 3, 'I': 2, 'K': 3, 'L': 2, 'N': 2, 'O': 2, 'U': 3, 'V': 2, 'W': 2, 'X': 2}"
INV-ZZ-3537787,SCH-ZZ-9059901,ZZ,ZZ20240512GOIGAU2919.0,2919.0,Boeing 717,05/12/2024,2024-05-12 19:19:00,2024-05-13 18:01:00,GOI,GAU,100.0,112,58,-42,54,10,20,30,40,12,6,4,6,22,11,9,11,34,18,12,16,45,23,17,22,"{'F': 6, 'P': 4}","{'C': 8, 'J': 6, 'Z': 6}","{'Q': 9, 'R': 6, 'S': 3, 'T': 3, 'H': 6, 'M': 3}","{'Y': 3, 'A': 3, 'B': 2, 'D': 2, 'E': 2, 'G': 3, 'I': 2, 'K': 3, 'L': 2, 'N': 2, 'O': 2, 'U': 3, 'V': 2, 'W': 2, 'X': 2}"
INV-ZZ-9631690,SCH-ZZ-9059901,ZZ,ZZ20240515GOIGAU2919.0,2919.0,Boeing 717,05/15/2024,2024-05-15 19:19:00,2024-05-16 18:01:00,GOI,GAU,100.0,110,60,-40,50,10,20,30,40,12,7,3,5,23,13,7,10,34,19,11,15,45,25,15,20,"{'F': 6, 'P': 4}","{'C': 8, 'J': 6, 'Z': 6}","{'Q': 9, 'R': 6, 'S': 3, 'T': 3, 'H': 6, 'M': 3}","{'Y': 3, 'A': 3, 'B': 2, 'D': 2, 'E': 2, 'G': 3, 'I': 2, 'K': 3, 'L': 2, 'N': 2, 'O': 2, 'U': 3, 'V': 2, 'W': 2, 'X': 2}"
INV-ZZ-8522004,SCH-ZZ-9059901,ZZ,ZZ20240517GOIGAU2919.0,2919.0,Boeing 717,05/17/2024,2024-05-17 19:19:00,2024-05-18 18:01:00,GOI,GAU,100.0,119,63,-37,56,10,20,30,40,12,6,4,6,22,12,8,10,35,19,11,16,45,24,16,21,"{'F': 6, 'P': 4}","{'C': 8, 'J': 6, 'Z': 6}","{'Q': 9, 'R': 6, 'S': 3, 'T': 3, 'H': 6, 'M': 3}","{'Y': 3, 'A': 3, 'B': 2, 'D': 2, 'E': 2, 'G': 3, 'I': 2, 'K': 3, 'L': 2, 'N': 2, 'O': 2, 'U': 3, 'V': 2, 'W': 2, 'X': 2}"
INV-ZZ-5157841,SCH-ZZ-9059901,ZZ,ZZ20240518GOIGAU2919.0,2919.0,Boeing 717,05/18/2024,2024-05-18 19:19:00,2024-05-19 18:01:00,GOI,GAU,100.0,115,54,-46,61,10,20,30,40,11,5,5,6,24,11,9,13,35,17,13,18,47,22,18,25,"{'F': 6, 'P': 4}","{'C': 8, 'J': 6, 'Z': 6}","{'Q': 9, 'R': 6, 'S': 3, 'T': 3, 'H': 6, 'M': 3}","{'Y': 3, 'A': 3, 'B': 2, 'D': 2, 'E': 2, 'G': 3, 'I': 2, 'K': 3, 'L': 2, 'N': 2, 'O': 2, 'U': 3, 'V': 2, 'W': 2, 'X': 2}"
INV-ZZ-2407714,SCH-ZZ-9059901,ZZ,ZZ20240519GOIGAU2919.0,2919.0,Boeing 717,05/19/2024,2024-05-19 19:19:00,2024-05-20 18:01:00,GOI,GAU,100.0,110,53,-47,57,10,20,30,40,12,6,4,6,24,12,8,12,33,16,14,17,45,22,18,23,"{'F': 6, 'P': 4}","{'C': 8, 'J': 6, 'Z': 6}","{'Q': 9, 'R': 6, 'S': 3, 'T': 3, 'H': 6, 'M': 3}","{'Y': 3, 'A': 3, 'B': 2, 'D': 2, 'E': 2, 'G': 3, 'I': 2, 'K': 3, 'L': 2, 'N': 2, 'O': 2, 'U': 3, 'V': 2, 'W': 2, 'X': 2}"
INV-ZZ-5807157,SCH-ZZ-9059901,ZZ,ZZ20240522GOIGAU2919.0,2919.0,Boeing 717,05/22/2024,2024-05-22 19:19:00,2024-05-23 18:01:00,GOI,GAU,100.0,110,54,-46,56,10,20,30,40,11,5,5,6,23,11,9,12,34,17,13,17,47,23,17,24,"{'F': 6, 'P': 4}","{'C': 8, 'J': 6, 'Z': 6}","{'Q': 9, 'R': 6, 'S': 3, 'T': 3, 'H': 6, 'M': 3}","{'Y': 3, 'A': 3, 'B': 2, 'D': 2, 'E': 2, 'G': 3, 'I': 2, 'K': 3, 'L': 2, 'N': 2, 'O': 2, 'U': 3, 'V': 2, 'W': 2, 'X': 2}"
INV-ZZ-3211506,SCH-ZZ-9059901,ZZ,ZZ20240524GOIGAU2919.0,2919.0,Boeing 717,05/24/2024,2024-05-24 19:19:00,2024-05-25 18:01:00,GOI,GAU,100.0,118,59,-41,59,10,20,30,40,12,6,4,6,24,12,8,12,34,17,13,17,46,23,17,23,"{'F': 6, 'P': 4}","{'C': 8, 'J': 6, 'Z': 6}","{'Q': 9, 'R': 6, 'S': 3, 'T': 3, 'H': 6, 'M': 3}","{'Y': 3, 'A': 3, 'B': 2, 'D': 2, 'E': 2, 'G': 3, 'I': 2, 'K': 3, 'L': 2, 'N': 2, 'O': 2, 'U': 3, 'V': 2, 'W': 2, 'X': 2}"
INV-ZZ-3219984,SCH-ZZ-9059901,ZZ,ZZ20240525GOIGAU2919.0,2919.0,Boeing 717,05/25/2024,2024-05-25 19:19:00,2024-05-26 18:01:00,GOI,GAU,100.0,115,57,-43,58,10,20,30,40,12,6,4,6,23,11,9,12,33,16,14,17,47,23,17,24,"{'F': 6, 'P': 4}","{'C': 8, 'J': 6, 'Z': 6}","{'Q': 9, 'R': 6, 'S': 3, 'T': 3, 'H': 6, 'M': 3}","{'Y': 3, 'A': 3, 'B': 2, 'D': 2, 'E': 2, 'G': 3, 'I': 2, 'K': 3, 'L': 2, 'N': 2, 'O': 2, 'U': 3, 'V': 2, 'W': 2, 'X': 2}"
INV-ZZ-9486392,SCH-ZZ-9059901,ZZ,ZZ20240526GOIGAU2919.0,2919.0,Boeing 717,05/26/2024,2024-05-26 19:19:00,2024-05-27 18:01:00,GOI,GAU,100.0,111,54,-46,57,10,20,30,40,12,6,4,6,24,12,8,12,34,17,13,17,48,23,17,25,"{'F': 6, 'P': 4}","{'C': 8, 'J': 6, 'Z': 6}","{'Q': 9, 'R': 6, 'S': 3, 'T': 3, 'H': 6, 'M': 3}","{'Y': 3, 'A': 3, 'B': 2, 'D': 2, 'E': 2, 'G': 3, 'I': 2, 'K': 3, 'L': 2, 'N': 2, 'O': 2, 'U': 3, 'V': 2, 'W': 2, 'X': 2}"
INV-ZZ-1714724,SCH-ZZ-9059901,ZZ,ZZ20240529GOIGAU2919.0,2919.0,Boeing 717,05/29/2024,2024-05-29 19:19:00,2024-05-30 18:01:00,GOI,GAU,100.0,110,57,-43,53,10,20,30,40,11,6,4,5,24,12,8,12,33,17,13,16,45,23,17,22,"{'F': 6, 'P': 4}","{'C': 8, 'J': 6, 'Z': 6}","{'Q': 9, 'R': 6, 'S': 3, 'T': 3, 'H': 6, 'M': 3}","{'Y': 3, 'A': 3, 'B': 2, 'D': 2, 'E': 2, 'G': 3, 'I': 2, 'K': 3, 'L': 2, 'N': 2, 'O': 2, 'U': 3, 'V': 2, 'W': 2, 'X': 2}"
INV-ZZ-4156087,SCH-ZZ-9059901,ZZ,ZZ20240531GOIGAU2919.0,2919.0,Boeing 717,05/31/2024,2024-05-31 19:19:00,2024-06-01 18:01:00,GOI,GAU,100.0,119,54,-46,65,10,20,30,40,12,5,5,7,23,10,10,13,34,15,15,19,44,20,20,24,"{'F': 6, 'P': 4}","{'C': 8, 'J': 6, 'Z': 6}","{'Q': 9, 'R': 6, 'S': 3, 'T': 3, 'H': 6, 'M': 3}","{'Y': 3, 'A': 3, 'B': 2, 'D': 2, 'E': 2, 'G': 3, 'I': 2, 'K': 3, 'L': 2, 'N': 2, 'O': 2, 'U': 3, 'V': 2, 'W': 2, 'X': 2}"
INV-ZZ-3557390,SCH-ZZ-9059901,ZZ,ZZ20240601GOIGAU2919.0,2919.0,Boeing 717,06/01/2024,2024-06-01 19:19:00,2024-06-02 18:01:00,GOI,GAU,100.0,118,59,-41,59,10,20,30,40,12,6,4,6,23,12,8,11,35,18,12,17,46,23,17,23,"{'F': 6, 'P': 4}","{'C': 8, 'J': 6, 'Z': 6}","{'Q': 9, 'R': 6, 'S': 3, 'T': 3, 'H': 6, 'M': 3}","{'Y': 3, 'A': 3, 'B': 2, 'D': 2, 'E': 2, 'G': 3, 'I': 2, 'K': 3, 'L': 2, 'N': 2, 'O': 2, 'U': 3, 'V': 2, 'W': 2, 'X': 2}"
INV-ZZ-2949322,SCH-ZZ-9059901,ZZ,ZZ20240602GOIGAU2919.0,2919.0,Boeing 717,06/02/2024,2024-06-02 19:19:00,2024-06-03 18:01:00,GOI,GAU,100.0,116,59,-41,57,10,20,30,40,12,6,4,6,23,12,8,11,35,18,12,17,47,24,16,23,"{'F': 6, 'P': 4}","{'C': 8, 'J': 6, 'Z': 6}","{'Q': 9, 'R': 6, 'S': 3, 'T': 3, 'H': 6, 'M': 3}","{'Y': 3, 'A': 3, 'B': 2, 'D': 2, 'E': 2, 'G': 3, 'I': 2, 'K': 3, 'L': 2, 'N': 2, 'O': 2, 'U': 3, 'V': 2, 'W': 2, 'X': 2}"
INV-ZZ-7644665,SCH-ZZ-9059901,ZZ,ZZ20240605GOIGAU2919.0,2919.0,Boeing 717,06/05/2024,2024-06-05 19:19:00,2024-06-06 18:01:00,GOI,GAU,100.0,118,53,-47,65,10,20,30,40,11,5,5,6,23,10,10,13,34,15,15,19,46,21,19,25,"{'F': 6, 'P': 4}","{'C': 8, 'J': 6, 'Z': 6}","{'Q': 9, 'R': 6, 'S': 3, 'T': 3, 'H': 6, 'M': 3}","{'Y': 3, 'A': 3, 'B': 2, 'D': 2, 'E': 2, 'G': 3, 'I': 2, 'K': 3, 'L': 2, 'N': 2, 'O': 2, 'U': 3, 'V': 2, 'W': 2, 'X': 2}"
INV-ZZ-9617127,SCH-ZZ-9059901,ZZ,ZZ20240607GOIGAU2919.0,2919.0,Boeing 717,06/07/2024,2024-06-07 19:19:00,2024-06-08 18:01:00,GOI,GAU,100.0,113,55,-45,58,10,20,30,40,12,6,4,6,23,11,9,12,33,16,14,17,45,22,18,23,"{'F': 6, 'P': 4}","{'C': 8, 'J': 6, 'Z': 6}","{'Q': 9, 'R': 6, 'S': 3, 'T': 3, 'H': 6, 'M': 3}","{'Y': 3, 'A': 3, 'B': 2, 'D': 2, 'E': 2, 'G': 3, 'I': 2, 'K': 3, 'L': 2, 'N': 2, 'O': 2, 'U': 3, 'V': 2, 'W': 2, 'X': 2}"
INV-ZZ-1784094,SCH-ZZ-9059901,ZZ,ZZ20240608GOIGAU2919.0,2919.0,Boeing 717,06/08/2024,2024-06-08 19:19:00,2024-06-09 18:01:00,GOI,GAU,100.0,112,48,-52,64,10,20,30,40,11,5,5,6,23,10,10,13,34,15,15,19,45,19,21,26,"{'F': 6, 'P': 4}","{'C': 8, 'J': 6, 'Z': 6}","{'Q': 9, 'R': 6, 'S': 3, 'T': 3, 'H': 6, 'M': 3}","{'Y': 3, 'A': 3, 'B': 2, 'D': 2, 'E': 2, 'G': 3, 'I': 2, 'K': 3, 'L': 2, 'N': 2, 'O': 2, 'U': 3, 'V': 2, 'W': 2, 'X': 2}"
INV-ZZ-6251526,SCH-ZZ-9059901,ZZ,ZZ20240609GOIGAU2919.0,2919.0,Boeing 717,06/09/2024,2024-06-09 19:19:00,2024-06-10 18:01:00,GOI,GAU,100.0,112,52,-48,60,10,20,30,40,12,6,4,6,24,11,9,13,36,17,13,19,48,22,18,26,"{'F': 6, 'P': 4}","{'C': 8, 'J': 6, 'Z': 6}","{'Q': 9, 'R': 6, 'S': 3, 'T': 3, 'H': 6, 'M': 3}","{'Y': 3, 'A': 3, 'B': 2, 'D': 2, 'E': 2, 'G': 3, 'I': 2, 'K': 3, 'L': 2, 'N': 2, 'O': 2, 'U': 3, 'V': 2, 'W': 2, 'X': 2}"
INV-ZZ-5815204,SCH-ZZ-8267287,ZZ,ZZ20240515PNQGOI2702.0,2702.0,Boeing 777,05/15/2024,2024-05-15 19:48:00,2024-05-16 05:09:00,PNQ,GOI,425.0,492,241,-184,251,42,85,127,170,48,24,18,24,95,47,38,48,151,74,53,77,196,96,74,100,"{'F': 25, 'P': 17}","{'C': 34, 'J': 26, 'Z': 26}","{'Q': 38, 'R': 25, 'S': 13, 'T': 13, 'H': 25, 'M': 13}","{'Y': 13, 'A': 13, 'B': 6, 'D': 6, 'E': 6, 'G': 13, 'I': 6, 'K': 13, 'L': 6, 'N': 6, 'O': 6, 'U': 13, 'V': 6, 'W': 6, 'X': 6}"
INV-ZZ-4241879,SCH-ZZ-8267287,ZZ,ZZ20240516PNQGOI2702.0,2702.0,Boeing 777,05/16/2024,2024-05-16 19:48:00,2024-05-17 05:09:00,PNQ,GOI,425.0,496,278,-147,218,42,85,127,170,47,26,16,21,95,53,32,42,148,83,44,65,202,113,57,89,"{'F': 25, 'P': 17}","{'C': 34, 'J': 26, 'Z': 26}","{'Q': 38, 'R': 25, 'S': 13, 'T': 13, 'H': 25, 'M': 13}","{'Y': 13, 'A': 13, 'B': 6, 'D': 6, 'E': 6, 'G': 13, 'I': 6, 'K': 13, 'L': 6, 'N': 6, 'O': 6, 'U': 13, 'V': 6, 'W': 6, 'X': 6}"
INV-ZZ-9293475,SCH-ZZ-8267287,ZZ,ZZ20240518PNQGOI2702.0,2702.0,Boeing 777,05/18/2024,2024-05-18 19:48:00,2024-05-19 05:09:00,PNQ,GOI,425.0,507,250,-175,257,42,85,127,170,47,23,19,24,97,48,37,49,144,71,56,73,198,98,72,100,"{'F': 25, 'P': 17}","{'C': 34, 'J': 26, 'Z': 26}","{'Q': 38, 'R': 25, 'S': 13, 'T': 13, 'H': 25, 'M': 13}","{'Y': 13, 'A': 13, 'B': 6, 'D': 6, 'E': 6, 'G': 13, 'I': 6, 'K': 13, 'L': 6, 'N': 6, 'O': 6, 'U': 13, 'V': 6, 'W': 6, 'X': 6}"
INV-ZZ-6819078,SCH-ZZ-8267287,ZZ,ZZ20240520PNQGOI2702.0,2702.0,Boeing 777,05/20/2024,2024-05-20 19:48:00,2024-05-21 05:09:00,PNQ,GOI,425.0,471,232,-193,239,42,85,127,170,50,25,17,25,95,47,38,48,151,74,53,77,196,97,73,99,"{'F': 25, 'P': 17}","{'C': 34, 'J': 26, 'Z': 26}","{'Q': 38, 'R': 25, 'S': 13, 'T': 13, 'H': 25, 'M': 13}","{'Y': 13, 'A': 13, 'B': 6, 'D': 6, 'E': 6, 'G': 13, 'I': 6, 'K': 13, 'L': 6, 'N': 6, 'O': 6, 'U': 13, 'V': 6, 'W': 6, 'X': 6}"
INV-ZZ-3525910,SCH-ZZ-8267287,ZZ,ZZ20240521PNQGOI2702.0,2702.0,Boeing 777,05/21/2024,2024-05-21 19:48:00,2024-05-22 05:09:00,PNQ,GOI,425.0,498,265,-160,233,42,85,127,170,47,25,17,22,96,51,34,45,141,75,52,66,198,105,65,93,"{'F': 25, 'P': 17}","{'C': 34, 'J': 26, 'Z': 26}","{'Q': 38, 'R': 25, 'S': 13, 'T': 13, 'H': 25, 'M': 13}","{'Y': 13, 'A': 13, 'B': 6, 'D': 6, 'E': 6, 'G': 13, 'I': 6, 'K': 13, 'L': 6, 'N': 6, 'O': 6, 'U': 13, 'V': 6, 'W': 6, 'X': 6}"
INV-ZZ-3901481,SCH-ZZ-8267287,ZZ,ZZ20240522PNQGOI2702.0,2702.0,Boeing 777,05/22/2024,2024-05-22 19:48:00,2024-05-23 05:09:00,PNQ,GOI,425.0,490,256,-169,234,42,85,127,170,50,26,16,24,98,51,34,47,150,78,49,72,199,104,66,95,"{'F': 25, 'P': 17}","{'C': 34, 'J': 26, 'Z': 26}","{'Q': 38, 'R': 25, 'S': 13, 'T': 13, 'H': 25, 'M': 13}","{'Y': 13, 'A': 13, 'B': 6, 'D': 6, 'E': 6, 'G': 13, 'I': 6, 'K': 13, 'L': 6, 'N': 6, 'O': 6, 'U': 13, 'V': 6, 'W': 6, 'X': 6}"
INV-ZZ-4020445,SCH-ZZ-8267287,ZZ,ZZ20240523PNQGOI2702.0,2702.0,Boeing 777,05/23/2024,2024-05-23 19:48:00,2024-05-24 05:09:00,PNQ,GOI,425.0,496,236,-189,260,42,85,127,170,47,22,20,25,100,48,37,52,147,70,57,77,188,89,81,99,"{'F': 25, 'P': 17}","{'C': 34, 'J': 26, 'Z': 26}","{'Q': 38, 'R': 25, 'S': 13, 'T': 13, 'H': 25, 'M': 13}","{'Y': 13, 'A': 13, 'B': 6, 'D': 6, 'E': 6, 'G': 13, 'I': 6, 'K': 13, 'L': 6, 'N': 6, 'O': 6, 'U': 13, 'V': 6, 'W': 6, 'X': 6}"
INV-ZZ-3625668,SCH-ZZ-8267287,ZZ,ZZ20240525PNQGOI2702.0,2702.0,Boeing 777,05/25/2024,2024-05-25 19:48:00,2024-05-26 05:09:00,PNQ,GOI,425.0,469,219,-206,250,42,85,127,170,50,23,19,27,94,44,41,50,148,69,58,79,201,94,76,107,"{'F': 25, 'P': 17}","{'C': 34, 'J': 26, 'Z': 26}","{'Q': 38, 'R': 25, 'S': 13, 'T': 13, 'H': 25, 'M': 13}","{'Y': 13, 'A': 13, 'B': 6, 'D': 6, 'E': 6, 'G': 13, 'I': 6, 'K': 13, 'L': 6, 'N': 6, 'O': 6, 'U': 13, 'V': 6, 'W': 6, 'X': 6}"
INV-ZZ-3596376,SCH-ZZ-8267287,ZZ,ZZ20240527PNQGOI2702.0,2702.0,Boeing 777,05/27/2024,2024-05-27 19:48:00,2024-05-28 05:09:00,PNQ,GOI,425.0,500,248,-177,252,42,85,127,170,47,23,19,24,95,47,38,48,149,74,53,75,199,99,71,100,"{'F': 25, 'P': 17}","{'C': 34, 'J': 26, 'Z': 26}","{'Q': 38, 'R': 25, 'S': 13, 'T': 13, 'H': 25, 'M': 13}","{'Y': 13, 'A': 13, 'B': 6, 'D': 6, 'E': 6, 'G': 13, 'I': 6, 'K': 13, 'L': 6, 'N': 6, 'O': 6, 'U': 13, 'V': 6, 'W': 6, 'X': 6}"
INV-ZZ-1409214,SCH-ZZ-8267287,ZZ,ZZ20240528PNQGOI2702.0,2702.0,Boeing 777,05/28/2024,2024-05-28 19:48:00,2024-05-29 05:09:00,PNQ,GOI,425.0,477,226,-199,251,42,85,127,170,48,23,19,25,101,48,37,53,149,71,56,78,198,94,76,104,"{'F': 25, 'P': 17}","{'C': 34, 'J': 26, 'Z': 26}","{'Q': 38, 'R': 25, 'S': 13, 'T': 13, 'H': 25, 'M': 13}","{'Y': 13, 'A': 13, 'B': 6, 'D': 6, 'E': 6, 'G': 13, 'I': 6, 'K': 13, 'L': 6, 'N': 6, 'O': 6, 'U': 13, 'V': 6, 'W': 6, 'X': 6}"
INV-ZZ-4614231,SCH-ZZ-8267287,ZZ,ZZ20240529PNQGOI2702.0,2702.0,Boeing 777,05/29/2024,2024-05-29 19:48:00,2024-05-30 05:09:00,PNQ,GOI,425.0,503,234,-191,269,42,85,127,170,46,21,21,25,98,46,39,52,143,67,60,76,197,92,78,105,"{'F': 25, 'P': 17}","{'C': 34, 'J': 26, 'Z': 26}","{'Q': 38, 'R': 25, 'S': 13, 'T': 13, 'H': 25, 'M': 13}","{'Y': 13, 'A': 13, 'B': 6, 'D': 6, 'E': 6, 'G': 13, 'I': 6, 'K': 13, 'L': 6, 'N': 6, 'O': 6, 'U': 13, 'V': 6, 'W': 6, 'X': 6}"
INV-ZZ-2185895,SCH-ZZ-8267287,ZZ,ZZ20240530PNQGOI2702.0,2702.0,Boeing 777,05/30/2024,2024-05-30 19:48:00,2024-05-31 05:09:00,PNQ,GOI,425.0,496,252,-173,244,42,85,127,170,48,24,18,24,98,50,35,48,144,73,54,71,196,99,71,97,"{'F': 25, 'P': 17}","{'C': 34, 'J': 26, 'Z': 26}","{'Q': 38, 'R': 25, 'S': 13, 'T': 13, 'H': 25, 'M': 13}","{'Y': 13, 'A': 13, 'B': 6, 'D': 6, 'E': 6, 'G': 13, 'I': 6, 'K': 13, 'L': 6, 'N': 6, 'O': 6, 'U': 13, 'V': 6, 'W': 6, 'X': 6}"
INV-ZZ-4485630,SCH-ZZ-8267287,ZZ,ZZ20240601PNQGOI2702.0,2702.0,Boeing 777,06/01/2024,2024-06-01 19:48:00,2024-06-02 05:09:00,PNQ,GOI,425.0,493,240,-185,253,42,85,127,170,49,24,18,25,96,47,38,49,147,71,56,76,197,96,74,101,"{'F': 25, 'P': 17}","{'C': 34, 'J': 26, 'Z': 26}","{'Q': 38, 'R': 25, 'S': 13, 'T': 13, 'H': 25, 'M': 13}","{'Y': 13, 'A': 13, 'B': 6, 'D': 6, 'E': 6, 'G': 13, 'I': 6, 'K': 13, 'L': 6, 'N': 6, 'O': 6, 'U': 13, 'V': 6, 'W': 6, 'X': 6}"
INV-ZZ-7849749,SCH-ZZ-8267287,ZZ,ZZ20240603PNQGOI2702.0,2702.0,Boeing 777,06/03/2024,2024-06-03 19:48:00,2024-06-04 05:09:00,PNQ,GOI,425.0,500,228,-197,272,42,85,127,170,49,22,20,27,99,45,40,54,152,69,58,83,203,92,78,111,"{'F': 25, 'P': 17}","{'C': 34, 'J': 26, 'Z': 26}","{'Q': 38, 'R': 25, 'S': 13, 'T': 13, 'H': 25, 'M': 13}","{'Y': 13, 'A': 13, 'B': 6, 'D': 6, 'E': 6, 'G': 13, 'I': 6, 'K': 13, 'L': 6, 'N': 6, 'O': 6, 'U': 13, 'V': 6, 'W': 6, 'X': 6}"
INV-ZZ-7833777,SCH-ZZ-8267287,ZZ,ZZ20240604PNQGOI2702.0,2702.0,Boeing 777,06/04/2024,2024-06-04 19:48:00,2024-06-05 05:09:00,PNQ,GOI,425.0,508,233,-192,275,42,85,127,170,49,23,19,26,96,44,41,52,149,68,59,81,196,90,80,106,"{'F': 25, 'P': 17}","{'C': 34, 'J': 26, 'Z': 26}","{'Q': 38, 'R': 25, 'S': 13, 'T': 13, 'H': 25, 'M': 13}","{'Y': 13, 'A': 13, 'B': 6, 'D': 6, 'E': 6, 'G': 13, 'I': 6, 'K': 13, 'L': 6, 'N': 6, 'O': 6, 'U': 13, 'V': 6, 'W': 6, 'X': 6}"
INV-ZZ-3575282,SCH-ZZ-8267287,ZZ,ZZ20240605PNQGOI2702.0,2702.0,Boeing 777,06/05/2024,2024-06-05 19:48:00,2024-06-06 05:09:00,PNQ,GOI,425.0,486,230,-195,256,42,85,127,170,48,23,19,25,98,46,39,52,146,69,58,77,202,95,75,107,"{'F': 25, 'P': 17}","{'C': 34, 'J': 26, 'Z': 26}","{'Q': 38, 'R': 25, 'S': 13, 'T': 13, 'H': 25, 'M': 13}","{'Y': 13, 'A': 13, 'B': 6, 'D': 6, 'E': 6, 'G': 13, 'I': 6, 'K': 13, 'L': 6, 'N': 6, 'O': 6, 'U': 13, 'V': 6, 'W': 6, 'X': 6}"
INV-ZZ-4297281,SCH-ZZ-8267287,ZZ,ZZ20240606PNQGOI2702.0,2702.0,Boeing 777,06/06/2024,2024-06-06 19:48:00,2024-06-07 05:09:00,PNQ,GOI,425.0,506,240,-185,266,42,85,127,170,49,23,19,26,97,46,39,51,145,69,58,76,203,96,74,107,"{'F': 25, 'P': 17}","{'C': 34, 'J': 26, 'Z': 26}","{'Q': 38, 'R': 25, 'S': 13, 'T': 13, 'H': 25, 'M': 13}","{'Y': 13, 'A': 13, 'B': 6, 'D': 6, 'E': 6, 'G': 13, 'I': 6, 'K': 13, 'L': 6, 'N': 6, 'O': 6, 'U': 13, 'V': 6, 'W': 6, 'X': 6}"
INV-ZZ-2831178,SCH-ZZ-8267287,ZZ,ZZ20240608PNQGOI2702.0,2702.0,Boeing 777,06/08/2024,2024-06-08 19:48:00,2024-06-09 05:09:00,PNQ,GOI,425.0,492,224,-201,268,42,85,127,170,47,21,21,26,98,45,40,53,148,67,60,81,197,90,80,107,"{'F': 25, 'P': 17}","{'C': 34, 'J': 26, 'Z': 26}","{'Q': 38, 'R': 25, 'S': 13, 'T': 13, 'H': 25, 'M': 13}","{'Y': 13, 'A': 13, 'B': 6, 'D': 6, 'E': 6, 'G': 13, 'I': 6, 'K': 13, 'L': 6, 'N': 6, 'O': 6, 'U': 13, 'V': 6, 'W': 6, 'X': 6}"
INV-ZZ-3608940,SCH-ZZ-8267287,ZZ,ZZ20240610PNQGOI2702.0,2702.0,Boeing 777,06/10/2024,2024-06-10 19:48:00,2024-06-11 05:09:00,PNQ,GOI,425.0,502,232,-193,270,42,85,127,170,47,22,20,25,96,44,41,52,146,68,59,78,204,94,76,110,"{'F': 25, 'P': 17}","{'C': 34, 'J': 26, 'Z': 26}","{'Q': 38, 'R': 25, 'S': 13, 'T': 13, 'H': 25, 'M': 13}","{'Y': 13, 'A': 13, 'B': 6, 'D': 6, 'E': 6, 'G': 13, 'I': 6, 'K': 13, 'L': 6, 'N': 6, 'O': 6, 'U': 13, 'V': 6, 'W': 6, 'X': 6}"
INV-ZZ-4927306,SCH-ZZ-8267287,ZZ,ZZ20240611PNQGOI2702.0,2702.0,Boeing 777,06/11/2024,2024-06-11 19:48:00,2024-06-12 05:09:00,PNQ,GOI,425.0,483,203,-222,280,42,85,127,170,46,19,23,27,97,41,44,56,152,64,63,88,198,83,87,115,"{'F': 25, 'P': 17}","{'C': 34, 'J': 26, 'Z': 26}","{'Q': 38, 'R': 25, 'S': 13, 'T': 13, 'H': 25, 'M': 13}","{'Y': 13, 'A': 13, 'B': 6, 'D': 6, 'E': 6, 'G': 13, 'I': 6, 'K': 13, 'L': 6, 'N': 6, 'O': 6, 'U': 13, 'V': 6, 'W': 6, 'X': 6}"
INV-ZZ-4992759,SCH-ZZ-8267287,ZZ,ZZ20240612PNQGOI2702.0,2702.0,Boeing 777,06/12/2024,2024-06-12 19:48:00,2024-06-13 05:09:00,PNQ,GOI,425.0,508,211,-214,297,42,85,127,170,49,20,22,29,102,42,43,60,140,58,69,82,198,82,88,116,"{'F': 25, 'P': 17}","{'C': 34, 'J': 26, 'Z': 26}","{'Q': 38, 'R': 25, 'S': 13, 'T': 13, 'H': 25, 'M': 13}","{'Y': 13, 'A': 13, 'B': 6, 'D': 6, 'E': 6, 'G': 13, 'I': 6, 'K': 13, 'L': 6, 'N': 6, 'O': 6, 'U': 13, 'V': 6, 'W': 6, 'X': 6}"
INV-ZZ-2868839,SCH-ZZ-8267287,ZZ,ZZ20240613PNQGOI2702.0,2702.0,Boeing 777,06/13/2024,2024-06-13 19:48:00,2024-06-14 05:09:00,PNQ,GOI,425.0,485,214,-211,271,42,85,127,170,49,22,20,27,95,42,43,53,145,64,63,81,189,83,87,106,"{'F': 25, 'P': 17}","{'C': 34, 'J': 26, 'Z': 26}","{'Q': 38, 'R': 25, 'S': 13, 'T': 13, 'H': 25, 'M': 13}","{'Y': 13, 'A': 13, 'B': 6, 'D': 6, 'E': 6, 'G': 13, 'I': 6, 'K': 13, 'L': 6, 'N': 6, 'O': 6, 'U': 13, 'V': 6, 'W': 6, 'X': 6}"
INV-ZZ-2457599,SCH-ZZ-8267287,ZZ,ZZ20240615PNQGOI2702.0,2702.0,Boeing 777,06/15/2024,2024-06-15 19:48:00,2024-06-16 05:09:00,PNQ,GOI,425.0,480,212,-213,268,42,85,127,170,49,22,20,27,98,43,42,55,142,63,64,79,196,86,84,110,"{'F': 25, 'P': 17}","{'C': 34, 'J': 26, 'Z': 26}","{'Q': 38, 'R': 25, 'S': 13, 'T': 13, 'H': 25, 'M': 13}","{'Y': 13, 'A': 13, 'B': 6, 'D': 6, 'E': 6, 'G': 13, 'I': 6, 'K': 13, 'L': 6, 'N': 6, 'O': 6, 'U': 13, 'V': 6, 'W': 6, 'X': 6}"
INV-ZZ-4602142,SCH-ZZ-8267287,ZZ,ZZ20240617PNQGOI2702.0,2702.0,Boeing 777,06/17/2024,2024-06-17 19:48:00,2024-06-18 05:09:00,PNQ,GOI,425.0,494,213,-212,281,42,85,127,170,49,21,21,28,94,41,44,53,142,61,66,81,195,84,86,111,"{'F': 25, 'P': 17}","{'C': 34, 'J': 26, 'Z': 26}","{'Q': 38, 'R': 25, 'S': 13, 'T': 13, 'H': 25, 'M': 13}","{'Y': 13, 'A': 13, 'B': 6, 'D': 6, 'E': 6, 'G': 13, 'I': 6, 'K': 13, 'L': 6, 'N': 6, 'O': 6, 'U': 13, 'V': 6, 'W': 6, 'X': 6}"
INV-ZZ-7382352,SCH-ZZ-8267287,ZZ,ZZ20240618PNQGOI2702.0,2702.0,Boeing 777,06/18/2024,2024-06-18 19:48:00,2024-06-19 05:09:00,PNQ,GOI,425.0,502,206,-219,296,42,85,127,170,50,21,21,29,97,40,45,57,148,61,66,87,197,81,89,116,"{'F': 25, 'P': 17}","{'C': 34, 'J': 26, 'Z': 26}","{'Q': 38, 'R': 25, 'S': 13, 'T': 13, 'H': 25, 'M': 13}","{'Y': 13, 'A': 13, 'B': 6, 'D': 6, 'E': 6, 'G': 13, 'I': 6, 'K': 13, 'L': 6, 'N': 6, 'O': 6, 'U': 13, 'V': 6, 'W': 6, 'X': 6}"
INV-ZZ-5821954,SCH-ZZ-8267287,ZZ,ZZ20240619PNQGOI2702.0,2702.0,Boeing 777,06/19/2024,2024-06-19 19:48:00,2024-06-20 05:09:00,PNQ,GOI,425.0,478,201,-224,277,42,85,127,170,50,21,21,29,98,41,44,57,149,63,64,86,196,82,88,114,"{'F': 25, 'P': 17}","{'C': 34, 'J': 26, 'Z': 26}","{'Q': 38, 'R': 25, 'S': 13, 'T': 13, 'H': 25, 'M': 13}","{'Y': 13, 'A': 13, 'B': 6, 'D': 6, 'E': 6, 'G': 13, 'I': 6, 'K': 13, 'L': 6, 'N': 6, 'O': 6, 'U': 13, 'V': 6, 'W': 6, 'X': 6}"
INV-ZZ-6232119,SCH-ZZ-8267287,ZZ,ZZ20240620PNQGOI2702.0,2702.0,Boeing 777,06/20/2024,2024-06-20 19:48:00,2024-06-21 05:09:00,PNQ,GOI,425.0,474,220,-205,254,42,85,127,170,49,23,19,26,96,45,40,51,148,69,58,79,188,87,83,101,"{'F': 25, 'P': 17}","{'C': 34, 'J': 26, 'Z': 26}","{'Q': 38, 'R': 25, 'S': 13, 'T': 13, 'H': 25, 'M': 13}","{'Y': 13, 'A': 13, 'B': 6, 'D': 6, 'E': 6, 'G': 13, 'I': 6, 'K': 13, 'L': 6, 'N': 6, 'O': 6, 'U': 13, 'V': 6, 'W': 6, 'X': 6}"
INV-ZZ-5576038,SCH-ZZ-8267287,ZZ,ZZ20240622PNQGOI2702.0,2702.0,Boeing 777,06/22/2024,2024-06-22 19:48:00,2024-06-23 05:09:00,PNQ,GOI,425.0,500,228,-197,272,42,85,127,170,47,21,21,26,97,44,41,53,142,65,62,77,195,89,81,106,"{'F': 25, 'P': 17}","{'C': 34, 'J': 26, 'Z': 26}","{'Q': 38, 'R': 25, 'S': 13, 'T': 13, 'H': 25, 'M': 13}","{'Y': 13, 'A': 13, 'B': 6, 'D': 6, 'E': 6, 'G': 13, 'I': 6, 'K': 13, 'L': 6, 'N': 6, 'O': 6, 'U': 13, 'V': 6, 'W': 6, 'X': 6}"
INV-ZZ-8685565,SCH-ZZ-8267287,ZZ,ZZ20240624PNQGOI2702.0,2702.0,Boeing 777,06/24/2024,2024-06-24 19:48:00,2024-06-25 05:09:00,PNQ,GOI,425.0,488,212,-213,276,42,85,127,170,49,21,21,28,97,42,43,55,142,62,65,80,191,83,87,108,"{'F': 25, 'P': 17}","{'C': 34, 'J': 26, 'Z': 26}","{'Q': 38, 'R': 25, 'S': 13, 'T': 13, 'H': 25, 'M': 13}","{'Y': 13, 'A': 13, 'B': 6, 'D': 6, 'E': 6, 'G': 13, 'I': 6, 'K': 13, 'L': 6, 'N': 6, 'O': 6, 'U': 13, 'V': 6, 'W': 6, 'X': 6}"
INV-ZZ-6928922,SCH-ZZ-8267287,ZZ,ZZ20240625PNQGOI2702.0,2702.0,Boeing 777,06/25/2024,2024-06-25 19:48:00,2024-06-26 05:09:00,PNQ,GOI,425.0,491,211,-214,280,42,85,127,170,48,21,21,27,97,42,43,55,140,60,67,80,189,81,89,108,"{'F': 25, 'P': 17}","{'C': 34, 'J': 26, 'Z': 26}","{'Q': 38, 'R': 25, 'S': 13, 'T': 13, 'H': 25, 'M': 13}","{'Y': 13, 'A': 13, 'B': 6, 'D': 6, 'E': 6, 'G': 13, 'I': 6, 'K': 13, 'L': 6, 'N': 6, 'O': 6, 'U': 13, 'V': 6, 'W': 6, 'X': 6}"
INV-ZZ-3298843,SCH-ZZ-8267287,ZZ,ZZ20240626PNQGOI2702.0,2702.0,Boeing 777,06/26/2024,2024-06-26 19:48:00,2024-06-27 05:09:00,PNQ,GOI,425.0,509,210,-215,299,42,85,127,170,49,20,22,29,97,40,45,57,144,59,68,85,196,81,89,115,"{'F': 25, 'P': 17}","{'C': 34, 'J': 26, 'Z': 26}","{'Q': 38, 'R': 25, 'S': 13, 'T': 13, 'H': 25, 'M': 13}","{'Y': 13, 'A': 13, 'B': 6, 'D': 6, 'E': 6, 'G': 13, 'I': 6, 'K': 13, 'L': 6, 'N': 6, 'O': 6, 'U': 13, 'V': 6, 'W': 6, 'X': 6}"
INV-ZZ-5217629,SCH-ZZ-8267287,ZZ,ZZ20240627PNQGOI2702.0,2702.0,Boeing 777,06/27/2024,2024-06-27 19:48:00,2024-06-28 05:09:00,PNQ,GOI,425.0,472,183,-242,289,42,85,127,170,50,19,23,31,100,39,46,61,148,57,70,91,198,77,93,121,"{'F': 25, 'P': 17}","{'C': 34, 'J': 26, 'Z': 26}","{'Q': 38, 'R': 25, 'S': 13, 'T': 13, 'H': 25, 'M': 13}","{'Y': 13, 'A': 13, 'B': 6, 'D': 6, 'E': 6, 'G': 13, 'I': 6, 'K': 13, 'L': 6, 'N': 6, 'O': 6, 'U': 13, 'V': 6, 'W': 6, 'X': 6}"
INV-ZZ-2112158,SCH-ZZ-8267287,ZZ,ZZ20240629PNQGOI2702.0,2702.0,Boeing 777,06/29/2024,2024-06-29 19:48:00,2024-06-30 05:09:00,PNQ,GOI,425.0,505,212,-213,293,42,85,127,170,47,20,22,27,95,40,45,55,148,62,65,86,199,84,86,115,"{'F': 25, 'P': 17}","{'C': 34, 'J': 26, 'Z': 26}","{'Q': 38, 'R': 25, 'S': 13, 'T': 13, 'H': 25, 'M': 13}","{'Y': 13, 'A': 13, 'B': 6, 'D': 6, 'E': 6, 'G': 13, 'I': 6, 'K': 13, 'L': 6, 'N': 6, 'O': 6, 'U': 13, 'V': 6, 'W': 6, 'X': 6}"
INV-ZZ-5788471,SCH-ZZ-2790389,ZZ,ZZ20240423GAUPNQ3723.0,3723.0,Boeing 717,04/23/2024,2024-04-23 01:26:00,2024-04-23 20:43:00,GAU,PNQ,100.0,111,65,-35,46,10,20,30,40,11,6,4,5,23,13,7,10,35,20,10,15,45,26,14,19,"{'F': 6, 'P': 4}","{'C': 8, 'J': 6, 'Z': 6}","{'Q': 9, 'R': 6, 'S': 3, 'T': 3, 'H': 6, 'M': 3}","{'Y': 3, 'A': 3, 'B': 2, 'D': 2, 'E': 2, 'G': 3, 'I': 2, 'K': 3, 'L': 2, 'N': 2, 'O': 2, 'U': 3, 'V': 2, 'W': 2, 'X': 2}"
INV-ZZ-1013270,SCH-ZZ-2790389,ZZ,ZZ20240426GAUPNQ3723.0,3723.0,Boeing 717,04/26/2024,2024-04-26 01:26:00,2024-04-26 20:43:00,GAU,PNQ,100.0,110,64,-36,46,10,20,30,40,11,6,4,5,23,13,7,10,34,20,10,14,46,27,13,19,"{'F': 6, 'P': 4}","{'C': 8, 'J': 6, 'Z': 6}","{'Q': 9, 'R': 6, 'S': 3, 'T': 3, 'H': 6, 'M': 3}","{'Y': 3, 'A': 3, 'B': 2, 'D': 2, 'E': 2, 'G': 3, 'I': 2, 'K': 3, 'L': 2, 'N': 2, 'O': 2, 'U': 3, 'V': 2, 'W': 2, 'X': 2}"
INV-ZZ-5361019,SCH-ZZ-2790389,ZZ,ZZ20240430GAUPNQ3723.0,3723.0,Boeing 717,04/30/2024,2024-04-30 01:26:00,2024-04-30 20:43:00,GAU,PNQ,100.0,110,66,-34,44,10,20,30,40,11,7,3,4,22,13,7,9,35,21,9,14,47,28,12,19,"{'F': 6, 'P': 4}","{'C': 8, 'J': 6, 'Z': 6}","{'Q': 9, 'R': 6, 'S': 3, 'T': 3, 'H': 6, 'M': 3}","{'Y': 3, 'A': 3, 'B': 2, 'D': 2, 'E': 2, 'G': 3, 'I': 2, 'K': 3, 'L': 2, 'N': 2, 'O': 2, 'U': 3, 'V': 2, 'W': 2, 'X': 2}"
INV-ZZ-5645584,SCH-ZZ-2790389,ZZ,ZZ20240503GAUPNQ3723.0,3723.0,Boeing 717,05/03/2024,2024-05-03 01:26:00,2024-05-03 20:43:00,GAU,PNQ,100.0,119,70,-30,49,10,20,30,40,11,6,4,5,22,13,7,9,35,20,10,15,45,26,14,19,"{'F': 6, 'P': 4}","{'C': 8, 'J': 6, 'Z': 6}","{'Q': 9, 'R': 6, 'S': 3, 'T': 3, 'H': 6, 'M': 3}","{'Y': 3, 'A': 3, 'B': 2, 'D': 2, 'E': 2, 'G': 3, 'I': 2, 'K': 3, 'L': 2, 'N': 2, 'O': 2, 'U': 3, 'V': 2, 'W': 2, 'X': 2}"
INV-ZZ-3164285,SCH-ZZ-2790389,ZZ,ZZ20240507GAUPNQ3723.0,3723.0,Boeing 717,05/07/2024,2024-05-07 01:26:00,2024-05-07 20:43:00,GAU,PNQ,100.0,117,66,-34,51,10,20,30,40,11,6,4,5,24,13,7,11,35,20,10,15,47,26,14,21,"{'F': 6, 'P': 4}","{'C': 8, 'J': 6, 'Z': 6}","{'Q': 9, 'R': 6, 'S': 3, 'T': 3, 'H': 6, 'M': 3}","{'Y': 3, 'A': 3, 'B': 2, 'D': 2, 'E': 2, 'G': 3, 'I': 2, 'K': 3, 'L': 2, 'N': 2, 'O': 2, 'U': 3, 'V': 2, 'W': 2, 'X': 2}"
INV-ZZ-1733836,SCH-ZZ-2790389,ZZ,ZZ20240510GAUPNQ3723.0,3723.0,Boeing 717,05/10/2024,2024-05-10 01:26:00,2024-05-10 20:43:00,GAU,PNQ,100.0,114,64,-36,50,10,20,30,40,12,7,3,5,24,13,7,11,33,19,11,14,47,26,14,21,"{'F': 6, 'P': 4}","{'C': 8, 'J': 6, 'Z': 6}","{'Q': 9, 'R': 6, 'S': 3, 'T': 3, 'H': 6, 'M': 3}","{'Y': 3, 'A': 3, 'B': 2, 'D': 2, 'E': 2, 'G': 3, 'I': 2, 'K': 3, 'L': 2, 'N': 2, 'O': 2, 'U': 3, 'V': 2, 'W': 2, 'X': 2}"
INV-ZZ-4592881,SCH-ZZ-2790389,ZZ,ZZ20240514GAUPNQ3723.0,3723.0,Boeing 717,05/14/2024,2024-05-14 01:26:00,2024-05-14 20:43:00,GAU,PNQ,100.0,112,59,-41,53,10,20,30,40,12,6,4,6,23,12,8,11,34,18,12,16,48,25,15,23,"{'F': 6, 'P': 4}","{'C': 8, 'J': 6, 'Z': 6}","{'Q': 9, 'R': 6, 'S': 3, 'T': 3, 'H': 6, 'M': 3}","{'Y': 3, 'A': 3, 'B': 2, 'D': 2, 'E': 2, 'G': 3, 'I': 2, 'K': 3, 'L': 2, 'N': 2, 'O': 2, 'U': 3, 'V': 2, 'W': 2, 'X': 2}"
INV-ZZ-9373766,SCH-ZZ-2790389,ZZ,ZZ20240517GAUPNQ3723.0,3723.0,Boeing 717,05/17/2024,2024-05-17 01:26:00,2024-05-17 20:43:00,GAU,PNQ,100.0,115,60,-40,55,10,20,30,40,12,6,4,6,23,12,8,11,33,17,13,16,46,24,16,22,"{'F': 6, 'P': 4}","{'C': 8, 'J': 6, 'Z': 6}","{'Q': 9, 'R': 6, 'S': 3, 'T': 3, 'H': 6, 'M': 3}","{'Y': 3, 'A': 3, 'B': 2, 'D': 2, 'E': 2, 'G': 3, 'I': 2, 'K': 3, 'L': 2, 'N': 2, 'O': 2, 'U': 3, 'V': 2, 'W': 2, 'X': 2}"
INV-ZZ-5116443,SCH-ZZ-2790389,ZZ,ZZ20240521GAUPNQ3723.0,3723.0,Boeing 717,05/21/2024,2024-05-21 01:26:00,2024-05-21 20:43:00,GAU,PNQ,100.0,119,64,-36,55,10,20,30,40,11,6,4,5,24,13,7,11,34,18,12,16,46,25,15,21,"{'F': 6, 'P': 4}","{'C': 8, 'J': 6, 'Z': 6}","{'Q': 9, 'R': 6, 'S': 3, 'T': 3, 'H': 6, 'M': 3}","{'Y': 3, 'A': 3, 'B': 2, 'D': 2, 'E': 2, 'G': 3, 'I': 2, 'K': 3, 'L': 2, 'N': 2, 'O': 2, 'U': 3, 'V': 2, 'W': 2, 'X': 2}"
INV-ZZ-8763917,SCH-ZZ-2790389,ZZ,ZZ20240524GAUPNQ3723.0,3723.0,Boeing 717,05/24/2024,2024-05-24 01:26:00,2024-05-24 20:43:00,GAU,PNQ,100.0,115,60,-40,55,10,20,30,40,12,6,4,6,22,11,9,11,34,18,12,16,46,24,16,22,"{'F': 6, 'P': 4}","{'C': 8, 'J': 6, 'Z': 6}","{'Q': 9, 'R': 6, 'S': 3, 'T': 3, 'H': 6, 'M': 3}","{'Y': 3, 'A': 3, 'B': 2, 'D': 2, 'E': 2, 'G': 3, 'I': 2, 'K': 3, 'L': 2, 'N': 2, 'O': 2, 'U': 3, 'V': 2, 'W': 2, 'X': 2}"
INV-ZZ-6606395,SCH-ZZ-2790389,ZZ,ZZ20240528GAUPNQ3723.0,3723.0,Boeing 717,05/28/2024,2024-05-28 01:26:00,2024-05-28 20:43:00,GAU,PNQ,100.0,110,52,-48,58,10,20,30,40,11,5,5,6,23,11,9,12,34,16,14,18,44,21,19,23,"{'F': 6, 'P': 4}","{'C': 8, 'J': 6, 'Z': 6}","{'Q': 9, 'R': 6, 'S': 3, 'T': 3, 'H': 6, 'M': 3}","{'Y': 3, 'A': 3, 'B': 2, 'D': 2, 'E': 2, 'G': 3, 'I': 2, 'K': 3, 'L': 2, 'N': 2, 'O': 2, 'U': 3, 'V': 2, 'W': 2, 'X': 2}"
INV-ZZ-2749749,SCH-ZZ-2790389,ZZ,ZZ20240531GAUPNQ3723.0,3723.0,Boeing 717,05/31/2024,2024-05-31 01:26:00,2024-05-31 20:43:00,GAU,PNQ,100.0,112,57,-43,55,10,20,30,40,11,6,4,5,23,12,8,11,34,17,13,17,46,23,17,23,"{'F': 6, 'P': 4}","{'C': 8, 'J': 6, 'Z': 6}","{'Q': 9, 'R': 6, 'S': 3, 'T': 3, 'H': 6, 'M': 3}","{'Y': 3, 'A': 3, 'B': 2, 'D': 2, 'E': 2, 'G': 3, 'I': 2, 'K': 3, 'L': 2, 'N': 2, 'O': 2, 'U': 3, 'V': 2, 'W': 2, 'X': 2}"
INV-ZZ-3952774,SCH-ZZ-2790389,ZZ,ZZ20240604GAUPNQ3723.0,3723.0,Boeing 717,06/04/2024,2024-06-04 01:26:00,2024-06-04 20:43:00,GAU,PNQ,100.0,110,51,-49,59,10,20,30,40,11,5,5,6,22,10,10,12,35,16,14,19,44,20,20,24,"{'F': 6, 'P': 4}","{'C': 8, 'J': 6, 'Z': 6}","{'Q': 9, 'R': 6, 'S': 3, 'T': 3, 'H': 6, 'M': 3}","{'Y': 3, 'A': 3, 'B': 2, 'D': 2, 'E': 2, 'G': 3, 'I': 2, 'K': 3, 'L': 2, 'N': 2, 'O': 2, 'U': 3, 'V': 2, 'W': 2, 'X': 2}"
INV-ZZ-4772145,SCH-ZZ-9762124,ZZ,ZZ20240510GAUPNQ3440.0,3440.0,Boeing 757,05/10/2024,2024-05-10 15:57:00,2024-05-11 05:13:00,GAU,PNQ,209.0,236,136,-73,100,20,41,62,83,24,14,6,10,48,28,13,20,74,43,19,31,97,56,27,41,"{'F': 12, 'P': 8}","{'C': 16, 'J': 12, 'Z': 12}","{'Q': 19, 'R': 12, 'S': 6, 'T': 6, 'H': 12, 'M': 6}","{'Y': 6, 'A': 6, 'B': 3, 'D': 3, 'E': 3, 'G': 6, 'I': 3, 'K': 6, 'L': 3, 'N': 3, 'O': 3, 'U': 6, 'V': 3, 'W': 3, 'X': 3}"
INV-ZZ-9306373,SCH-ZZ-9762124,ZZ,ZZ20240512GAUPNQ3440.0,3440.0,Boeing 757,05/12/2024,2024-05-12 15:57:00,2024-05-13 05:13:00,GAU,PNQ,209.0,243,131,-78,112,20,41,62,83,22,12,8,10,48,26,15,22,73,39,23,34,97,52,31,45,"{'F': 12, 'P': 8}","{'C': 16, 'J': 12, 'Z': 12}","{'Q': 19, 'R': 12, 'S': 6, 'T': 6, 'H': 12, 'M': 6}","{'Y': 6, 'A': 6, 'B': 3, 'D': 3, 'E': 3, 'G': 6, 'I': 3, 'K': 6, 'L': 3, 'N': 3, 'O': 3, 'U': 6, 'V': 3, 'W': 3, 'X': 3}"
INV-ZZ-6867790,SCH-ZZ-9762124,ZZ,ZZ20240513GAUPNQ3440.0,3440.0,Boeing 757,05/13/2024,2024-05-13 15:57:00,2024-05-14 05:13:00,GAU,PNQ,209.0,250,133,-76,117,20,41,62,83,23,12,8,11,48,26,15,22,74,39,23,35,99,53,30,46,"{'F': 12, 'P': 8}","{'C': 16, 'J': 12, 'Z': 12}","{'Q': 19, 'R': 12, 'S': 6, 'T': 6, 'H': 12, 'M': 6}","{'Y': 6, 'A': 6, 'B': 3, 'D': 3, 'E': 3, 'G': 6, 'I': 3, 'K': 6, 'L': 3, 'N': 3, 'O': 3, 'U': 6, 'V': 3, 'W': 3, 'X': 3}"
INV-ZZ-5012703,SCH-ZZ-9762124,ZZ,ZZ20240516GAUPNQ3440.0,3440.0,Boeing 757,05/16/2024,2024-05-16 15:57:00,2024-05-17 05:13:00,GAU,PNQ,209.0,236,122,-87,114,20,41,62,83,23,12,8,11,45,23,18,22,70,36,26,34,94,48,35,46,"{'F': 12, 'P': 8}","{'C': 16, 'J': 12, 'Z': 12}","{'Q': 19, 'R': 12, 'S': 6, 'T': 6, 'H': 12, 'M': 6}","{'Y': 6, 'A': 6, 'B': 3, 'D': 3, 'E': 3, 'G': 6, 'I': 3, 'K': 6, 'L': 3, 'N': 3, 'O': 3, 'U': 6, 'V': 3, 'W': 3, 'X': 3}"
INV-ZZ-8806642,SCH-ZZ-9762124,ZZ,ZZ20240517GAUPNQ3440.0,3440.0,Boeing 757,05/17/2024,2024-05-17 15:57:00,2024-05-18 05:13:00,GAU,PNQ,209.0,243,132,-77,111,20,41,62,83,22,12,8,10,47,25,16,22,74,40,22,34,94,51,32,43,"{'F': 12, 'P': 8}","{'C': 16, 'J': 12, 'Z': 12}","{'Q': 19, 'R': 12, 'S': 6, 'T': 6, 'H': 12, 'M': 6}","{'Y': 6, 'A': 6, 'B': 3, 'D': 3, 'E': 3, 'G': 6, 'I': 3, 'K': 6, 'L': 3, 'N': 3, 'O': 3, 'U': 6, 'V': 3, 'W': 3, 'X': 3}"
INV-ZZ-5246500,SCH-ZZ-9762124,ZZ,ZZ20240519GAUPNQ3440.0,3440.0,Boeing 757,05/19/2024,2024-05-19 15:57:00,2024-05-20 05:13:00,GAU,PNQ,209.0,246,126,-83,120,20,41,62,83,23,12,8,11,49,25,16,24,69,35,27,34,94,48,35,46,"{'F': 12, 'P': 8}","{'C': 16, 'J': 12, 'Z': 12}","{'Q': 19, 'R': 12, 'S': 6, 'T': 6, 'H': 12, 'M': 6}","{'Y': 6, 'A': 6, 'B': 3, 'D': 3, 'E': 3, 'G': 6, 'I': 3, 'K': 6, 'L': 3, 'N': 3, 'O': 3, 'U': 6, 'V': 3, 'W': 3, 'X': 3}"
INV-ZZ-5240579,SCH-ZZ-9762124,ZZ,ZZ20240520GAUPNQ3440.0,3440.0,Boeing 757,05/20/2024,2024-05-20 15:57:00,2024-05-21 05:13:00,GAU,PNQ,209.0,240,116,-93,124,20,41,62,83,23,11,9,12,46,22,19,24,70,34,28,36,92,45,38,47,"{'F': 12, 'P': 8}","{'C': 16, 'J': 12, 'Z': 12}","{'Q': 19, 'R': 12, 'S': 6, 'T': 6, 'H': 12, 'M': 6}","{'Y': 6, 'A': 6, 'B': 3, 'D': 3, 'E': 3, 'G': 6, 'I': 3, 'K': 6, 'L': 3, 'N': 3, 'O': 3, 'U': 6, 'V': 3, 'W': 3, 'X': 3}"
INV-ZZ-2776516,SCH-ZZ-9762124,ZZ,ZZ20240523GAUPNQ3440.0,3440.0,Boeing 757,05/23/2024,2024-05-23 15:57:00,2024-05-24 05:13:00,GAU,PNQ,209.0,241,129,-80,112,20,41,62,83,23,12,8,11,48,26,15,22,72,38,24,34,97,52,31,45,"{'F': 12, 'P': 8}","{'C': 16, 'J': 12, 'Z': 12}","{'Q': 19, 'R': 12, 'S': 6, 'T': 6, 'H': 12, 'M': 6}","{'Y': 6, 'A': 6, 'B': 3, 'D': 3, 'E': 3, 'G': 6, 'I': 3, 'K': 6, 'L': 3, 'N': 3, 'O': 3, 'U': 6, 'V': 3, 'W': 3, 'X': 3}"
INV-ZZ-9698950,SCH-ZZ-9762124,ZZ,ZZ20240524GAUPNQ3440.0,3440.0,Boeing 757,05/24/2024,2024-05-24 15:57:00,2024-05-25 05:13:00,GAU,PNQ,209.0,239,111,-98,128,20,41,62,83,24,11,9,13,47,22,19,25,74,34,28,40,98,45,38,53,"{'F': 12, 'P': 8}","{'C': 16, 'J': 12, 'Z': 12}","{'Q': 19, 'R': 12, 'S': 6, 'T': 6, 'H': 12, 'M': 6}","{'Y': 6, 'A': 6, 'B': 3, 'D': 3, 'E': 3, 'G': 6, 'I': 3, 'K': 6, 'L': 3, 'N': 3, 'O': 3, 'U': 6, 'V': 3, 'W': 3, 'X': 3}"
INV-ZZ-6468190,SCH-ZZ-9762124,ZZ,ZZ20240526GAUPNQ3440.0,3440.0,Boeing 757,05/26/2024,2024-05-26 15:57:00,2024-05-27 05:13:00,GAU,PNQ,209.0,244,112,-97,132,20,41,62,83,23,11,9,12,47,22,19,25,69,32,30,37,98,45,38,53,"{'F': 12, 'P': 8}","{'C': 16, 'J': 12, 'Z': 12}","{'Q': 19, 'R': 12, 'S': 6, 'T': 6, 'H': 12, 'M': 6}","{'Y': 6, 'A': 6, 'B': 3, 'D': 3, 'E': 3, 'G': 6, 'I': 3, 'K': 6, 'L': 3, 'N': 3, 'O': 3, 'U': 6, 'V': 3, 'W': 3, 'X': 3}"
INV-ZZ-3764785,SCH-ZZ-9762124,ZZ,ZZ20240527GAUPNQ3440.0,3440.0,Boeing 757,05/27/2024,2024-05-27 15:57:00,2024-05-28 05:13:00,GAU,PNQ,209.0,249,130,-79,119,20,41,62,83,22,12,8,10,47,25,16,22,71,37,25,34,98,51,32,47,"{'F': 12, 'P': 8}","{'C': 16, 'J': 12, 'Z': 12}","{'Q': 19, 'R': 12, 'S': 6, 'T': 6, 'H': 12, 'M': 6}","{'Y': 6, 'A': 6, 'B': 3, 'D': 3, 'E': 3, 'G': 6, 'I': 3, 'K': 6, 'L': 3, 'N': 3, 'O': 3, 'U': 6, 'V': 3, 'W': 3, 'X': 3}"
INV-ZZ-1895211,SCH-ZZ-9762124,ZZ,ZZ20240530GAUPNQ3440.0,3440.0,Boeing 757,05/30/2024,2024-05-30 15:57:00,2024-05-31 05:13:00,GAU,PNQ,209.0,243,116,-93,127,20,41,62,83,22,10,10,12,46,22,19,24,73,35,27,38,97,46,37,51,"{'F': 12, 'P': 8}","{'C': 16, 'J': 12, 'Z': 12}","{'Q': 19, 'R': 12, 'S': 6, 'T': 6, 'H': 12, 'M': 6}","{'Y': 6, 'A': 6, 'B': 3, 'D': 3, 'E': 3, 'G': 6, 'I': 3, 'K': 6, 'L': 3, 'N': 3, 'O': 3, 'U': 6, 'V': 3, 'W': 3, 'X': 3}"
INV-ZZ-2825995,SCH-ZZ-9762124,ZZ,ZZ20240531GAUPNQ3440.0,3440.0,Boeing 757,05/31/2024,2024-05-31 15:57:00,2024-06-01 05:13:00,GAU,PNQ,209.0,230,118,-91,112,20,41,62,83,24,12,8,12,49,25,16,24,70,36,26,34,94,48,35,46,"{'F': 12, 'P': 8}","{'C': 16, 'J': 12, 'Z': 12}","{'Q': 19, 'R': 12, 'S': 6, 'T': 6, 'H': 12, 'M': 6}","{'Y': 6, 'A': 6, 'B': 3, 'D': 3, 'E': 3, 'G': 6, 'I': 3, 'K': 6, 'L': 3, 'N': 3, 'O': 3, 'U': 6, 'V': 3, 'W': 3, 'X': 3}"
INV-ZZ-6365856,SCH-ZZ-9762124,ZZ,ZZ20240602GAUPNQ3440.0,3440.0,Boeing 757,06/02/2024,2024-06-02 15:57:00,2024-06-03 05:13:00,GAU,PNQ,209.0,245,126,-83,119,20,41,62,83,23,12,8,11,49,25,16,24,70,36,26,34,96,49,34,47,"{'F': 12, 'P': 8}","{'C': 16, 'J': 12, 'Z': 12}","{'Q': 19, 'R': 12, 'S': 6, 'T': 6, 'H': 12, 'M': 6}","{'Y': 6, 'A': 6, 'B': 3, 'D': 3, 'E': 3, 'G': 6, 'I': 3, 'K': 6, 'L': 3, 'N': 3, 'O': 3, 'U': 6, 'V': 3, 'W': 3, 'X': 3}"
INV-ZZ-4667192,SCH-ZZ-9762124,ZZ,ZZ20240603GAUPNQ3440.0,3440.0,Boeing 757,06/03/2024,2024-06-03 15:57:00,2024-06-04 05:13:00,GAU,PNQ,209.0,231,103,-106,128,20,41,62,83,22,10,10,12,49,22,19,27,68,30,32,38,96,43,40,53,"{'F': 12, 'P': 8}","{'C': 16, 'J': 12, 'Z': 12}","{'Q': 19, 'R': 12, 'S': 6, 'T': 6, 'H': 12, 'M': 6}","{'Y': 6, 'A': 6, 'B': 3, 'D': 3, 'E': 3, 'G': 6, 'I': 3, 'K': 6, 'L': 3, 'N': 3, 'O': 3, 'U': 6, 'V': 3, 'W': 3, 'X': 3}"
INV-ZZ-6470704,SCH-ZZ-9762124,ZZ,ZZ20240606GAUPNQ3440.0,3440.0,Boeing 757,06/06/2024,2024-06-06 15:57:00,2024-06-07 05:13:00,GAU,PNQ,209.0,236,116,-93,120,20,41,62,83,24,12,8,12,49,24,17,25,71,35,27,36,98,48,35,50,"{'F': 12, 'P': 8}","{'C': 16, 'J': 12, 'Z': 12}","{'Q': 19, 'R': 12, 'S': 6, 'T': 6, 'H': 12, 'M': 6}","{'Y': 6, 'A': 6, 'B': 3, 'D': 3, 'E': 3, 'G': 6, 'I': 3, 'K': 6, 'L': 3, 'N': 3, 'O': 3, 'U': 6, 'V': 3, 'W': 3, 'X': 3}"
INV-ZZ-4234084,SCH-ZZ-9762124,ZZ,ZZ20240607GAUPNQ3440.0,3440.0,Boeing 757,06/07/2024,2024-06-07 15:57:00,2024-06-08 05:13:00,GAU,PNQ,209.0,232,109,-100,123,20,41,62,83,23,11,9,12,48,23,18,25,70,33,29,37,100,47,36,53,"{'F': 12, 'P': 8}","{'C': 16, 'J': 12, 'Z': 12}","{'Q': 19, 'R': 12, 'S': 6, 'T': 6, 'H': 12, 'M': 6}","{'Y': 6, 'A': 6, 'B': 3, 'D': 3, 'E': 3, 'G': 6, 'I': 3, 'K': 6, 'L': 3, 'N': 3, 'O': 3, 'U': 6, 'V': 3, 'W': 3, 'X': 3}"
INV-ZZ-3733765,SCH-ZZ-9762124,ZZ,ZZ20240609GAUPNQ3440.0,3440.0,Boeing 757,06/09/2024,2024-06-09 15:57:00,2024-06-10 05:13:00,GAU,PNQ,209.0,241,111,-98,130,20,41,62,83,23,11,9,12,46,21,20,25,71,33,29,38,92,42,41,50,"{'F': 12, 'P': 8}","{'C': 16, 'J': 12, 'Z': 12}","{'Q': 19, 'R': 12, 'S': 6, 'T': 6, 'H': 12, 'M': 6}","{'Y': 6, 'A': 6, 'B': 3, 'D': 3, 'E': 3, 'G': 6, 'I': 3, 'K': 6, 'L': 3, 'N': 3, 'O': 3, 'U': 6, 'V': 3, 'W': 3, 'X': 3}"
INV-ZZ-2264723,SCH-ZZ-9762124,ZZ,ZZ20240610GAUPNQ3440.0,3440.0,Boeing 757,06/10/2024,2024-06-10 15:57:00,2024-06-11 05:13:00,GAU,PNQ,209.0,237,104,-105,133,20,41,62,83,22,10,10,12,49,21,20,28,73,32,30,41,99,43,40,56,"{'F': 12, 'P': 8}","{'C': 16, 'J': 12, 'Z': 12}","{'Q': 19, 'R': 12, 'S': 6, 'T': 6, 'H': 12, 'M': 6}","{'Y': 6, 'A': 6, 'B': 3, 'D': 3, 'E': 3, 'G': 6, 'I': 3, 'K': 6, 'L': 3, 'N': 3, 'O': 3, 'U': 6, 'V': 3, 'W': 3, 'X': 3}"
INV-ZZ-8701163,SCH-ZZ-9762124,ZZ,ZZ20240613GAUPNQ3440.0,3440.0,Boeing 757,06/13/2024,2024-06-13 15:57:00,2024-06-14 05:13:00,GAU,PNQ,209.0,231,107,-102,124,20,41,62,83,23,11,9,12,45,21,20,24,73,34,28,39,95,44,39,51,"{'F': 12, 'P': 8}","{'C': 16, 'J': 12, 'Z': 12}","{'Q': 19, 'R': 12, 'S': 6, 'T': 6, 'H': 12, 'M': 6}","{'Y': 6, 'A': 6, 'B': 3, 'D': 3, 'E': 3, 'G': 6, 'I': 3, 'K': 6, 'L': 3, 'N': 3, 'O': 3, 'U': 6, 'V': 3, 'W': 3, 'X': 3}"
INV-ZZ-7624370,SCH-ZZ-9762124,ZZ,ZZ20240614GAUPNQ3440.0,3440.0,Boeing 757,06/14/2024,2024-06-14 15:57:00,2024-06-15 05:13:00,GAU,PNQ,209.0,241,115,-94,126,20,41,62,83,23,11,9,12,48,23,18,25,72,34,28,38,93,44,39,49,"{'F': 12, 'P': 8}","{'C': 16, 'J': 12, 'Z': 12}","{'Q': 19, 'R': 12, 'S': 6, 'T': 6, 'H': 12, 'M': 6}","{'Y': 6, 'A': 6, 'B': 3, 'D': 3, 'E': 3, 'G': 6, 'I': 3, 'K': 6, 'L': 3, 'N': 3, 'O': 3, 'U': 6, 'V': 3, 'W': 3, 'X': 3}"
INV-ZZ-3021106,SCH-ZZ-9762124,ZZ,ZZ20240616GAUPNQ3440.0,3440.0,Boeing 757,06/16/2024,2024-06-16 15:57:00,2024-06-17 05:13:00,GAU,PNQ,209.0,239,99,-110,140,20,41,62,83,23,10,10,13,45,19,22,26,70,29,33,41,97,40,43,57,"{'F': 12, 'P': 8}","{'C': 16, 'J': 12, 'Z': 12}","{'Q': 19, 'R': 12, 'S': 6, 'T': 6, 'H': 12, 'M': 6}","{'Y': 6, 'A': 6, 'B': 3, 'D': 3, 'E': 3, 'G': 6, 'I': 3, 'K': 6, 'L': 3, 'N': 3, 'O': 3, 'U': 6, 'V': 3, 'W': 3, 'X': 3}"
INV-ZZ-6129434,SCH-ZZ-9762124,ZZ,ZZ20240617GAUPNQ3440.0,3440.0,Boeing 757,06/17/2024,2024-06-17 15:57:00,2024-06-18 05:13:00,GAU,PNQ,209.0,236,111,-98,125,20,41,62,83,22,10,10,12,49,23,18,26,70,33,29,37,96,45,38,51,"{'F': 12, 'P': 8}","{'C': 16, 'J': 12, 'Z': 12}","{'Q': 19, 'R': 12, 'S': 6, 'T': 6, 'H': 12, 'M': 6}","{'Y': 6, 'A': 6, 'B': 3, 'D': 3, 'E': 3, 'G': 6, 'I': 3, 'K': 6, 'L': 3, 'N': 3, 'O': 3, 'U': 6, 'V': 3, 'W': 3, 'X': 3}"
INV-ZZ-2755720,SCH-ZZ-9762124,ZZ,ZZ20240620GAUPNQ3440.0,3440.0,Boeing 757,06/20/2024,2024-06-20 15:57:00,2024-06-21 05:13:00,GAU,PNQ,209.0,246,114,-95,132,20,41,62,83,23,11,9,12,46,21,20,25,72,33,29,39,93,43,40,50,"{'F': 12, 'P': 8}","{'C': 16, 'J': 12, 'Z': 12}","{'Q': 19, 'R': 12, 'S': 6, 'T': 6, 'H': 12, 'M': 6}","{'Y': 6, 'A': 6, 'B': 3, 'D': 3, 'E': 3, 'G': 6, 'I': 3, 'K': 6, 'L': 3, 'N': 3, 'O': 3, 'U': 6, 'V': 3, 'W': 3, 'X': 3}"
INV-ZZ-2707415,SCH-ZZ-9762124,ZZ,ZZ20240621GAUPNQ3440.0,3440.0,Boeing 757,06/21/2024,2024-06-21 15:57:00,2024-06-22 05:13:00,GAU,PNQ,209.0,241,104,-105,137,20,41,62,83,24,10,10,14,46,20,21,26,71,31,31,40,93,40,43,53,"{'F': 12, 'P': 8}","{'C': 16, 'J': 12, 'Z': 12}","{'Q': 19, 'R': 12, 'S': 6, 'T': 6, 'H': 12, 'M': 6}","{'Y': 6, 'A': 6, 'B': 3, 'D': 3, 'E': 3, 'G': 6, 'I': 3, 'K': 6, 'L': 3, 'N': 3, 'O': 3, 'U': 6, 'V': 3, 'W': 3, 'X': 3}"
INV-ZZ-1293533,SCH-ZZ-9762124,ZZ,ZZ20240623GAUPNQ3440.0,3440.0,Boeing 757,06/23/2024,2024-06-23 15:57:00,2024-06-24 05:13:00,GAU,PNQ,209.0,243,108,-101,135,20,41,62,83,22,10,10,12,47,21,20,26,74,33,29,41,98,43,40,55,"{'F': 12, 'P': 8}","{'C': 16, 'J': 12, 'Z': 12}","{'Q': 19, 'R': 12, 'S': 6, 'T': 6, 'H': 12, 'M': 6}","{'Y': 6, 'A': 6, 'B': 3, 'D': 3, 'E': 3, 'G': 6, 'I': 3, 'K': 6, 'L': 3, 'N': 3, 'O': 3, 'U': 6, 'V': 3, 'W': 3, 'X': 3}"
INV-ZZ-1560576,SCH-ZZ-9762124,ZZ,ZZ20240624GAUPNQ3440.0,3440.0,Boeing 757,06/24/2024,2024-06-24 15:57:00,2024-06-25 05:13:00,GAU,PNQ,209.0,239,95,-114,144,20,41,62,83,23,9,11,14,47,19,22,28,70,28,34,42,99,40,43,59,"{'F': 12, 'P': 8}","{'C': 16, 'J': 12, 'Z': 12}","{'Q': 19, 'R': 12, 'S': 6, 'T': 6, 'H': 12, 'M': 6}","{'Y': 6, 'A': 6, 'B': 3, 'D': 3, 'E': 3, 'G': 6, 'I': 3, 'K': 6, 'L': 3, 'N': 3, 'O': 3, 'U': 6, 'V': 3, 'W': 3, 'X': 3}"
